id	position	name	F635 Median	B635 Median	Intensity
B01R01C01	1-1-1	AlexaAntiMouseAb~N/A	39043	38	39005
B01R01C02	1-2-1	AlexaAntiMouseAb~N/A	34062	40	34022
B01R01C03	1-3-1	ERa~N/A	2416	38	2378
B01R01C04	1-4-1	ERa~N/A	1950	39	1911
B01R01C05	1-5-1	HumanIgG1~N/A	834	40	794
B01R01C06	1-6-1	HumanIgG1~N/A	1068	49	1019
B01R01C07	1-7-1	HumanIgG2~N/A	2728	37	2691
B01R01C08	1-8-1	HumanIgG2~N/A	3037	39	2998
B01R01C09	1-9-1	HumanIgG3~N/A	13933	39	13894
B01R01C10	1-10-1	HumanIgG3~N/A	14329	47	14282
B01R01C11	1-11-1	HumanIgG4~N/A	43446	59	43387
B01R01C12	1-12-1	HumanIgG4~N/A	48802	55	48747
B01R01C13	1-13-1	BiotinAb~N/A	319	54	265
B01R01C14	1-14-1	BiotinAb~N/A	358	56	302
B01R01C15	1-15-1	RanBP2deltaFG~N/A	265	57	208
B01R01C16	1-16-1	RanBP2deltaFG~N/A	171	64	107
B01R01C17	1-17-1	hMDM2~N/A	796	59	737
B01R01C18	1-18-1	hMDM2~N/A	813	58	755
B01R01C19	1-19-1	PKCeta~N/A	464	51	413
B01R01C20	1-20-1	PKCeta~N/A	479	51	428
B01R01C21	1-21-1	AlexaAntiMouseAb~N/A	47493	60	47433
B01R01C22	1-22-1	AlexaAntiMouseAb~N/A	47951	58	47893
B01R02C01	1-1-2	PKCeta~N/A	1159	37	1122
B01R02C02	1-2-2	PKCeta~N/A	78	46	32
B01R02C03	1-3-2	Buffer	249	64	185
B01R02C04	1-4-2	Buffer	71	43	28
B01R02C05	1-5-2	HumanIgA~N/A	18458	38	18420
B01R02C06	1-6-2	HumanIgA~N/A	18518	38	18480
B01R02C07	1-7-2	Buffer	81	38	43
B01R02C08	1-8-2	Buffer	81	37	44
B01R02C09	1-9-2	BSA~N/A	10959	37	10922
B01R02C10	1-10-2	BSA~N/A	11393	49	11344
B01R02C11	1-11-2	Hs~MGC:NM_175877.3~uORF:IOH22866	384	64	320
B01R02C12	1-12-2	Hs~MGC:NM_175877.3~uORF:IOH22866	407	63	344
B01R02C13	1-13-2	Hs~MGC:NM_152728.1~uORF:IOH21580	521	59	462
B01R02C14	1-14-2	Hs~MGC:NM_152728.1~uORF:IOH21580	482	56	426
B01R02C15	1-15-2	Hs~MGC:BC021174.1~uORF:IOH10706	49	52	-3
B01R02C16	1-16-2	Hs~MGC:BC021174.1~uORF:IOH10706	52	53	-1
B01R02C17	1-17-2	Hs~MGC:BC017901.1~uORF:IOH12549	575	55	520
B01R02C18	1-18-2	Hs~MGC:BC017901.1~uORF:IOH12549	543	54	489
B01R02C19	1-19-2	Hs~MGC:BC032499.1~uORF:IOH21893	705	52	653
B01R02C20	1-20-2	Hs~MGC:BC032499.1~uORF:IOH21893	739	55	684
B01R02C21	1-21-2	Hs~Ref:NM_006399.2~uORF:IOH21626	563	72	491
B01R02C22	1-22-2	Hs~Ref:NM_006399.2~uORF:IOH21626	485	71	414
B01R03C01	1-1-3	Hs~MGC:BC032302.1~uORF:IOH21655	393	41	352
B01R03C02	1-2-3	Hs~MGC:BC032302.1~uORF:IOH21655	332	49	283
B01R03C03	1-3-3	Hs~Ref:NM_007254.2~uORF:IOH21884	3876	73	3803
B01R03C04	1-4-3	Hs~Ref:NM_007254.2~uORF:IOH21884	4356	59	4297
B01R03C05	1-5-3	Hs~Ref:NM_000993.2~uORF:IOH14051	1723	39	1684
B01R03C06	1-6-3	Hs~Ref:NM_000993.2~uORF:IOH14051	1874	38	1836
B01R03C07	1-7-3	Hs~Ref:NM_002413.3~uORF:IOH13576	407	42	365
B01R03C08	1-8-3	Hs~Ref:NM_002413.3~uORF:IOH13576	439	37	402
B01R03C09	1-9-3	Hs~Ref:NM_004450.1~uORF:IOH14288	833	37	796
B01R03C10	1-10-3	Hs~Ref:NM_004450.1~uORF:IOH14288	1566	48	1518
B01R03C11	1-11-3	Hs~MGC:BC012766.1~uORF:IOH13844	192	60	132
B01R03C12	1-12-3	Hs~MGC:BC012766.1~uORF:IOH13844	196	61	135
B01R03C13	1-13-3	Hs~MGC:BC015883.1~uORF:IOH10061	325	60	265
B01R03C14	1-14-3	Hs~MGC:BC015883.1~uORF:IOH10061	309	55	254
B01R03C15	1-15-3	Hs~MGC:BC016295.1~uORF:IOH10091	672	52	620
B01R03C16	1-16-3	Hs~MGC:BC016295.1~uORF:IOH10091	626	50	576
B01R03C17	1-17-3	Hs~MGC:BC015803.1~uORF:IOH10126	2232	49	2183
B01R03C18	1-18-3	Hs~MGC:BC015803.1~uORF:IOH10126	2206	49	2157
B01R03C19	1-19-3	Hs~Ref:NM_004865.2~uORF:IOH10084	562	53	509
B01R03C20	1-20-3	Hs~Ref:NM_004865.2~uORF:IOH10084	588	57	531
B01R03C21	1-21-3	Hs~MGC:BC018732.1~uORF:IOH14058	1209	57	1152
B01R03C22	1-22-3	Hs~MGC:BC018732.1~uORF:IOH14058	1103	53	1050
B01R04C01	1-1-4	Hs~MGC:BC024281.1~uORF:IOH14073	552	44	508
B01R04C02	1-2-4	Hs~MGC:BC024281.1~uORF:IOH14073	693	63	630
B01R04C03	1-3-4	Hs~MGC:BC007658.1~uORF:IOH5956	2287	55	2232
B01R04C04	1-4-4	Hs~MGC:BC007658.1~uORF:IOH5956	2370	1632	738
B01R04C05	1-5-4	Hs~Ref:NM_145252.1~uORF:IOH9864	1291	731	560
B01R04C06	1-6-4	Hs~Ref:NM_145252.1~uORF:IOH9864	1382	366	1016
B01R04C07	1-7-4	Hs~MGC:BC011923.1~uORF:IOH13453	601	52	549
B01R04C08	1-8-4	Hs~MGC:BC011923.1~uORF:IOH13453	576	43	533
B01R04C09	1-9-4	Hs~Ref:NM_020530.2~uORF:IOH13456	994	43	951
B01R04C10	1-10-4	Hs~Ref:NM_020530.2~uORF:IOH13456	824	75	749
B01R04C11	1-11-4	Hs~Ref:NM_022720.2~uORF:IOH12840	433	80	353
B01R04C12	1-12-4	Hs~Ref:NM_022720.2~uORF:IOH12840	365	57	308
B01R04C13	1-13-4	Hs~Ref:NM_145042.1~uORF:IOH13383	746	55	691
B01R04C14	1-14-4	Hs~Ref:NM_145042.1~uORF:IOH13383	823	56	767
B01R04C15	1-15-4	Hs~Ref:NM_007173.3~uORF:IOH3271	230	85	145
B01R04C16	1-16-4	Hs~Ref:NM_007173.3~uORF:IOH3271	247	50	197
B01R04C17	1-17-4	Hs~Ref:NM_016034.2~uORF:IOH6982	511	50	461
B01R04C18	1-18-4	Hs~Ref:NM_016034.2~uORF:IOH6982	534	51	483
B01R04C19	1-19-4	Hs~Ref:NM_025083.2~uORF:IOH9818	536	51	485
B01R04C20	1-20-4	Hs~Ref:NM_025083.2~uORF:IOH9818	519	51	468
B01R04C21	1-21-4	Hs~MGC:BC011553.1~uORF:IOH12716	477	51	426
B01R04C22	1-22-4	Hs~MGC:BC011553.1~uORF:IOH12716	545	52	493
B01R05C01	1-1-5	Hs~Ref:NM_032306.2~uORF:IOH5568	1247	40	1207
B01R05C02	1-2-5	Hs~Ref:NM_032306.2~uORF:IOH5568	1197	65	1132
B01R05C03	1-3-5	Hs~MGC:BC039269.1~uORF:IOH27269	216	40	176
B01R05C04	1-4-5	Hs~MGC:BC039269.1~uORF:IOH27269	218	41	177
B01R05C05	1-5-5	Hs~Ref:NM_006528.2~uORF:IOH7275	323	41	282
B01R05C06	1-6-5	Hs~Ref:NM_006528.2~uORF:IOH7275	335	40	295
B01R05C07	1-7-5	Hs~Ref:NM_017634.1~uORF:IOH22919	152	41	111
B01R05C08	1-8-5	Hs~Ref:NM_017634.1~uORF:IOH22919	141	47	94
B01R05C09	1-9-5	Hs~Ref:NM_002358.2~uORF:IOH7559	260	235	25
B01R05C10	1-10-5	Hs~Ref:NM_002358.2~uORF:IOH7559	264	46	218
B01R05C11	1-11-5	Hs~Ref:NM_080916.1~uORF:IOH14211	700	54	646
B01R05C12	1-12-5	Hs~Ref:NM_080916.1~uORF:IOH14211	672	49	623
B01R05C13	1-13-5	Hs~MGC:BC013019.1~uORF:IOH14884	340	61	279
B01R05C14	1-14-5	Hs~MGC:BC013019.1~uORF:IOH14884	301	211	90
B01R05C15	1-15-5	Hs~Ref:NM_002082.1~N/A	199	79	120
B01R05C16	1-16-5	Hs~Ref:NM_002082.1~N/A	247	63	184
B01R05C17	1-17-5	Hs~Ref:NM_003516.2~uORF:IOH4867	768	50	718
B01R05C18	1-18-5	Hs~Ref:NM_003516.2~uORF:IOH4867	811	49	762
B01R05C19	1-19-5	Hs~MGC:BC043581.1~uORF:IOH26300	804	48	756
B01R05C20	1-20-5	Hs~MGC:BC043581.1~uORF:IOH26300	947	51	896
B01R05C21	1-21-5	Hs~Ref:NM_004148.2~uORF:IOH28049	711	51	660
B01R05C22	1-22-5	Hs~Ref:NM_004148.2~uORF:IOH28049	682	50	632
B01R06C01	1-1-6	Hs~Ref:NM_004718.2~uORF:IOH7545	1035	34	1001
B01R06C02	1-2-6	Hs~Ref:NM_004718.2~uORF:IOH7545	1166	37	1129
B01R06C03	1-3-6	Hs~Ref:NM_018097.1~uORF:IOH12063	186	38	148
B01R06C04	1-4-6	Hs~Ref:NM_018097.1~uORF:IOH12063	191	39	152
B01R06C05	1-5-6	Hs~Ref:NM_002370.2~uORF:IOH10502	1269	38	1231
B01R06C06	1-6-6	Hs~Ref:NM_002370.2~uORF:IOH10502	1313	36	1277
B01R06C07	1-7-6	Hs~Ref:NM_017812.1~uORF:IOH11162	342	38	304
B01R06C08	1-8-6	Hs~Ref:NM_017812.1~uORF:IOH11162	35	42	-7
B01R06C09	1-9-6	Hs~Ref:NM_002880.1~uORF:IOH10773	831	35	796
B01R06C10	1-10-6	Hs~Ref:NM_002880.1~uORF:IOH10773	835	35	800
B01R06C11	1-11-6	Hs~Ref:NM_001280.1~uORF:IOH2905	1245	45	1200
B01R06C12	1-12-6	Hs~Ref:NM_001280.1~uORF:IOH2905	901	51	850
B01R06C13	1-13-6	Hs~MGC:BC001304.1~uORF:IOH3065	322	103	219
B01R06C14	1-14-6	Hs~MGC:BC001304.1~uORF:IOH3065	102	86	16
B01R06C15	1-15-6	Hs~MGC:BC009048.1~uORF:IOH3342	500	56	444
B01R06C16	1-16-6	Hs~MGC:BC009048.1~uORF:IOH3342	569	113	456
B01R06C17	1-17-6	Hs~Ref:NM_014713.2~uORF:IOH3687	243	56	187
B01R06C18	1-18-6	Hs~Ref:NM_014713.2~uORF:IOH3687	519	55	464
B01R06C19	1-19-6	Hs~Ref:NM_005402.1~uORF:IOH26207	272	54	218
B01R06C20	1-20-6	Hs~Ref:NM_005402.1~uORF:IOH26207	295	59	236
B01R06C21	1-21-6	Hs~MGC:BC044587.1~uORF:IOH26741	269	75	194
B01R06C22	1-22-6	Hs~MGC:BC044587.1~uORF:IOH26741	258	55	203
B01R07C01	1-1-7	Hs~MGC:BC048099.1~uORF:IOH26742	684	35	649
B01R07C02	1-2-7	Hs~MGC:BC048099.1~uORF:IOH26742	758	36	722
B01R07C03	1-3-7	Hs~MGC:BC040036.1~uORF:IOH26343	153	42	111
B01R07C04	1-4-7	Hs~MGC:BC040036.1~uORF:IOH26343	408	65	343
B01R07C05	1-5-7	Hs~MGC:BC005955.1~uORF:IOH7485	596	39	557
B01R07C06	1-6-7	Hs~MGC:BC005955.1~uORF:IOH7485	725	35	690
B01R07C07	1-7-7	Hs~MGC:BC035217.1~uORF:IOH26791	359	37	322
B01R07C08	1-8-7	Hs~MGC:BC035217.1~uORF:IOH26791	345	40	305
B01R07C09	1-9-7	Hs~MGC:BC028366.1~uORF:IOH22335	494	38	456
B01R07C10	1-10-7	Hs~MGC:BC028366.1~uORF:IOH22335	559	36	523
B01R07C11	1-11-7	Hs~MGC:BC035492.1~uORF:IOH25729	1031	69	962
B01R07C12	1-12-7	Hs~MGC:BC035492.1~uORF:IOH25729	228	54	174
B01R07C13	1-13-7	Hs~Ref:XM_374188.3~uORF:IOH44541	735	68	667
B01R07C14	1-14-7	Hs~Ref:XM_374188.3~uORF:IOH44541	103	71	32
B01R07C15	1-15-7	Hs~Ref:NM_174925.1~uORF:IOH43618	643	56	587
B01R07C16	1-16-7	Hs~Ref:NM_174925.1~uORF:IOH43618	754	85	669
B01R07C17	1-17-7	Hs~Ref:NM_138640.1~uORF:IOH40942	810	83	727
B01R07C18	1-18-7	Hs~Ref:NM_138640.1~uORF:IOH40942	824	66	758
B01R07C19	1-19-7	Hs~Ref:NM_172014.1~uORF:IOH44426	831	58	773
B01R07C20	1-20-7	Hs~Ref:NM_172014.1~uORF:IOH44426	764	55	709
B01R07C21	1-21-7	Hs~MGC:BC000691.1~uORF:IOH4341	842	52	790
B01R07C22	1-22-7	Hs~MGC:BC000691.1~uORF:IOH4341	890	50	840
B01R08C01	1-1-8	Hs~Ref:NM_012117.1~uORF:IOH3162	1119	36	1083
B01R08C02	1-2-8	Hs~Ref:NM_012117.1~uORF:IOH3162	1046	39	1007
B01R08C03	1-3-8	Hs~Ref:NM_025133.3~uORF:IOH44015	50	50	0
B01R08C04	1-4-8	Hs~Ref:NM_025133.3~uORF:IOH44015	785	499	286
B01R08C05	1-5-8	Hs~Ref:NM_002346.1~uORF:IOH42082	1380	58	1322
B01R08C06	1-6-8	Hs~Ref:NM_002346.1~uORF:IOH42082	347	37	310
B01R08C07	1-7-8	Hs~MGC:BC019247.1~uORF:IOH11023	391	37	354
B01R08C08	1-8-8	Hs~MGC:BC019247.1~uORF:IOH11023	430	40	390
B01R08C09	1-9-8	Hs~Ref:NM_014214.1~uORF:IOH13690	476	36	440
B01R08C10	1-10-8	Hs~Ref:NM_014214.1~uORF:IOH13690	470	36	434
B01R08C11	1-11-8	Hs~Ref:NM_015343.1~uORF:IOH12711	273	44	229
B01R08C12	1-12-8	Hs~Ref:NM_015343.1~uORF:IOH12711	341	67	274
B01R08C13	1-13-8	Hs~Ref:NM_032929.1~uORF:IOH7540	9761	62	9699
B01R08C14	1-14-8	Hs~Ref:NM_032929.1~uORF:IOH7540	8202	57	8145
B01R08C15	1-15-8	Hs~MGC:BC037311.1~uORF:IOH27689	692	53	639
B01R08C16	1-16-8	Hs~MGC:BC037311.1~uORF:IOH27689	694	52	642
B01R08C17	1-17-8	Hs~MGC:BC042848.1~uORF:IOH27665	278	58	220
B01R08C18	1-18-8	Hs~MGC:BC042848.1~uORF:IOH27665	216	53	163
B01R08C19	1-19-8	Hs~Ref:NM_002884.1~uORF:IOH14475	242	60	182
B01R08C20	1-20-8	Hs~Ref:NM_002884.1~uORF:IOH14475	267	113	154
B01R08C21	1-21-8	Hs~MGC:BC024004.1~uORF:IOH11309	548	54	494
B01R08C22	1-22-8	Hs~MGC:BC024004.1~uORF:IOH11309	563	53	510
B01R09C01	1-1-9	Hs~Ref:NM_014420.2~uORF:IOH35309	596	36	560
B01R09C02	1-2-9	Hs~Ref:NM_014420.2~uORF:IOH35309	638	38	600
B01R09C03	1-3-9	Hs~Ref:NM_025057.1~uORF:IOH35314	507	74	433
B01R09C04	1-4-9	Hs~Ref:NM_025057.1~uORF:IOH35314	450	53	397
B01R09C05	1-5-9	Hs~Ref:NM_002169.1~uORF:IOH35227	639	42	597
B01R09C06	1-6-9	Hs~Ref:NM_002169.1~uORF:IOH35227	573	64	509
B01R09C07	1-7-9	Hs~Ref:NM_022573.1~uORF:IOH35467	325	119	206
B01R09C08	1-8-9	Hs~Ref:NM_022573.1~uORF:IOH35467	328	65	263
B01R09C09	1-9-9	Hs~Ref:NM_006749.2~uORF:IOH11684	113	45	68
B01R09C10	1-10-9	Hs~Ref:NM_006749.2~uORF:IOH11684	145	82	63
B01R09C11	1-11-9	Hs~MGC:BC027911.1~uORF:IOH11846	409	130	279
B01R09C12	1-12-9	Hs~MGC:BC027911.1~uORF:IOH11846	399	48	351
B01R09C13	1-13-9	Hs~MGC:BC021861.1~uORF:IOH11917	151	48	103
B01R09C14	1-14-9	Hs~MGC:BC021861.1~uORF:IOH11917	171	48	123
B01R09C15	1-15-9	Hs~Ref:NM_022091.2~uORF:IOH27060	69	53	16
B01R09C16	1-16-9	Hs~Ref:NM_022091.2~uORF:IOH27060	781	51	730
B01R09C17	1-17-9	Hs~MGC:BC036422.1~uORF:IOH27623	329	56	273
B01R09C18	1-18-9	Hs~MGC:BC036422.1~uORF:IOH27623	431	54	377
B01R09C19	1-19-9	Hs~MGC:BC055314.1~uORF:IOH29446	1730	54	1676
B01R09C20	1-20-9	Hs~MGC:BC055314.1~uORF:IOH29446	1598	56	1542
B01R09C21	1-21-9	Hs~MGC:BC051300.1~uORF:IOH29358	240	56	184
B01R09C22	1-22-9	Hs~MGC:BC051300.1~uORF:IOH29358	347	75	272
B01R10C01	1-1-10	Hs~MGC:BC014889.1~uORF:IOH10017	359	36	323
B01R10C02	1-2-10	Hs~MGC:BC014889.1~uORF:IOH10017	356	36	320
B01R10C03	1-3-10	Hs~MGC:BC007009.1~uORF:IOH7191	579	43	536
B01R10C04	1-4-10	Hs~MGC:BC007009.1~uORF:IOH7191	483	45	438
B01R10C05	1-5-10	Hs~Ref:NM_002539.1~uORF:IOH14694	419	40	379
B01R10C06	1-6-10	Hs~Ref:NM_002539.1~uORF:IOH14694	396	41	355
B01R10C07	1-7-10	Hs~MGC:BC012575.1~uORF:IOH12167	364	49	315
B01R10C08	1-8-10	Hs~MGC:BC012575.1~uORF:IOH12167	320	43	277
B01R10C09	1-9-10	Hs~MGC:NM_171998.1~uORF:IOH9931	372	42	330
B01R10C10	1-10-10	Hs~MGC:NM_171998.1~uORF:IOH9931	364	42	322
B01R10C11	1-11-10	GST1	36	34	2
B01R10C12	1-12-10	GST1	106	45	61
B01R10C13	1-13-10	GST2	56	50	6
B01R10C14	1-14-10	GST2	54	50	4
B01R10C15	1-15-10	GST3	56	54	2
B01R10C16	1-16-10	GST3	62	54	8
B01R10C17	1-17-10	GST4	65	51	14
B01R10C18	1-18-10	GST4	66	51	15
B01R10C19	1-19-10	Anti-HumanIgA1~N/A	9503	52	9451
B01R10C20	1-20-10	Anti-HumanIgA1~N/A	9378	51	9327
B01R10C21	1-21-10	Anti-HumanIgA2~N/A	18051	54	17997
B01R10C22	1-22-10	Anti-HumanIgA2~N/A	18543	53	18490
B01R11C01	1-1-11	AlexaAntiMouseAb~N/A	26187	37	26150
B01R11C02	1-2-11	AlexaAntiMouseAb~N/A	27172	37	27135
B01R11C03	1-3-11	MAPKAP~N/A	75	35	40
B01R11C04	1-4-11	MAPKAP~N/A	51	41	10
B01R11C05	1-5-11	Buffer	50	47	3
B01R11C06	1-6-11	Buffer	37	48	-11
B01R11C07	1-7-11	BSA~N/A	9029	37	8992
B01R11C08	1-8-11	BSA~N/A	8723	36	8687
B01R11C09	1-9-11	Anti-HumanIgG1~N/A	1596	34	1562
B01R11C10	1-10-11	Anti-HumanIgG1~N/A	1706	34	1672
B01R11C11	1-11-11	Anti-HumanIgG2~N/A	2952	34	2918
B01R11C12	1-12-11	Anti-HumanIgG2~N/A	3023	42	2981
B01R11C13	1-13-11	Anti-HumanIgG3~N/A	6070	55	6015
B01R11C14	1-14-11	Anti-HumanIgG3~N/A	7060	53	7007
B01R11C15	1-15-11	Anti-HumanIgG4~N/A	12451	53	12398
B01R11C16	1-16-11	Anti-HumanIgG4~N/A	13569	55	13514
B01R11C17	1-17-11	AntiBiotinAb~N/A	13427	53	13374
B01R11C18	1-18-11	AntiBiotinAb~N/A	13181	51	13130
B01R11C19	1-19-11	Buffer	51	54	-3
B01R11C20	1-20-11	Buffer	61	49	12
B01R11C21	1-21-11	Hs~MGC:BC035314.1~uORF:IOH22146	433	50	383
B01R11C22	1-22-11	Hs~MGC:BC035314.1~uORF:IOH22146	376	49	327
B01R12C01	1-1-12	Hs~MGC:BC016754.1~uORF:IOH13535	266	44	222
B01R12C02	1-2-12	Hs~MGC:BC016754.1~uORF:IOH13535	298	42	256
B01R12C03	1-3-12	Hs~MGC:BC020966.1~uORF:IOH10379	457	35	422
B01R12C04	1-4-12	Hs~MGC:BC020966.1~uORF:IOH10379	48	44	4
B01R12C05	1-5-12	Hs~MGC:BC003548.1~uORF:IOH4864	1668	50	1618
B01R12C06	1-6-12	Hs~MGC:BC003548.1~uORF:IOH4864	1517	46	1471
B01R12C07	1-7-12	Hs~MGC:BC023569.1~uORF:IOH27860	2875	43	2832
B01R12C08	1-8-12	Hs~MGC:BC023569.1~uORF:IOH27860	2878	40	2838
B01R12C09	1-9-12	Hs~MGC:BC053373.1~uORF:IOH28997	725	38	687
B01R12C10	1-10-12	Hs~MGC:BC053373.1~uORF:IOH28997	696	37	659
B01R12C11	1-11-12	Hs~MGC:BC042912.1~uORF:IOH28030	526	36	490
B01R12C12	1-12-12	Hs~MGC:BC042912.1~uORF:IOH28030	475	43	432
B01R12C13	1-13-12	Hs~MGC:BC030155.1~uORF:IOH23095	466	61	405
B01R12C14	1-14-12	Hs~MGC:BC030155.1~uORF:IOH23095	870	72	798
B01R12C15	1-15-12	Hs~Ref:NM_139162.2~uORF:IOH12829	97	49	48
B01R12C16	1-16-12	Hs~Ref:NM_139162.2~uORF:IOH12829	106	51	55
B01R12C17	1-17-12	Hs~Ref:NM_003764.2~uORF:IOH27407	223	86	137
B01R12C18	1-18-12	Hs~Ref:NM_003764.2~uORF:IOH27407	144	51	93
B01R12C19	1-19-12	Hs~MGC:BC005305.1~uORF:IOH7363	93	52	41
B01R12C20	1-20-12	Hs~MGC:BC005305.1~uORF:IOH7363	117	51	66
B01R12C21	1-21-12	Hs~Ref:NM_032514.2~uORF:IOH10043	136	53	83
B01R12C22	1-22-12	Hs~Ref:NM_032514.2~uORF:IOH10043	184	62	122
B01R13C01	1-1-13	Hs~MGC:BC023144.1~uORF:IOH10881	1673	47	1626
B01R13C02	1-2-13	Hs~MGC:BC023144.1~uORF:IOH10881	1704	41	1663
B01R13C03	1-3-13	Hs~Ref:NM_133490.2~uORF:IOH6166	444	36	408
B01R13C04	1-4-13	Hs~Ref:NM_133490.2~uORF:IOH6166	102	52	50
B01R13C05	1-5-13	Hs~Ref:NM_144671.2~uORF:IOH22844	331	69	262
B01R13C06	1-6-13	Hs~Ref:NM_144671.2~uORF:IOH22844	477	38	439
B01R13C07	1-7-13	Hs~Ref:NM_001397.1~uORF:IOH42625	635	35	600
B01R13C08	1-8-13	Hs~Ref:NM_001397.1~uORF:IOH42625	602	35	567
B01R13C09	1-9-13	Hs~MGC:BC070364.1~uORF:IOH62867	453	39	414
B01R13C10	1-10-13	Hs~MGC:BC070364.1~uORF:IOH62867	448	37	411
B01R13C11	1-11-13	Hs~Ref:NM_019854.3~uORF:IOH60863	295	35	260
B01R13C12	1-12-13	Hs~Ref:NM_019854.3~uORF:IOH60863	266	43	223
B01R13C13	1-13-13	Hs~MGC:BC069675.1~uORF:IOH61914	279	54	225
B01R13C14	1-14-13	Hs~MGC:BC069675.1~uORF:IOH61914	407	90	317
B01R13C15	1-15-13	Hs~MGC:BC022073.1~uORF:IOH62089	687	243	444
B01R13C16	1-16-13	Hs~MGC:BC022073.1~uORF:IOH62089	313	51	262
B01R13C17	1-17-13	Hs~MGC:BC014315.1~uORF:IOH13047	5432	54	5378
B01R13C18	1-18-13	Hs~MGC:BC014315.1~uORF:IOH13047	3851	55	3796
B01R13C19	1-19-13	Hs~Ref:NM_138784.1~uORF:IOH13439	118	53	65
B01R13C20	1-20-13	Hs~Ref:NM_138784.1~uORF:IOH13439	891	53	838
B01R13C21	1-21-13	Hs~Ref:NM_020367.2~uORF:IOH13091	664	58	606
B01R13C22	1-22-13	Hs~Ref:NM_020367.2~uORF:IOH13091	601	53	548
B01R14C01	1-1-14	Hs~MGC:BC014974.1~uORF:IOH12832	592	37	555
B01R14C02	1-2-14	Hs~MGC:BC014974.1~uORF:IOH12832	604	35	569
B01R14C03	1-3-14	Hs~Ref:NM_005621.1~uORF:IOH40815	496	35	461
B01R14C04	1-4-14	Hs~Ref:NM_005621.1~uORF:IOH40815	527	36	491
B01R14C05	1-5-14	Hs~MGC:BC003160.1~uORF:IOH5120	151	38	113
B01R14C06	1-6-14	Hs~MGC:BC003160.1~uORF:IOH5120	327	155	172
B01R14C07	1-7-14	Hs~MGC:BC032348.1~uORF:IOH21706	293	35	258
B01R14C08	1-8-14	Hs~MGC:BC032348.1~uORF:IOH21706	318	36	282
B01R14C09	1-9-14	Hs~Ref:NM_145183.1~uORF:IOH5614	399	39	360
B01R14C10	1-10-14	Hs~Ref:NM_145183.1~uORF:IOH5614	345	38	307
B01R14C11	1-11-14	Hs~Ref:NM_018431.3~uORF:IOH42147	327	34	293
B01R14C12	1-12-14	Hs~Ref:NM_018431.3~uORF:IOH42147	444	39	405
B01R14C13	1-13-14	Hs~Ref:NM_152721.2~uORF:IOH42262	518	44	474
B01R14C14	1-14-14	Hs~Ref:NM_152721.2~uORF:IOH42262	600	103	497
B01R14C15	1-15-14	Hs~Ref:NM_172175.1~uORF:IOH42096	214	64	150
B01R14C16	1-16-14	Hs~Ref:NM_172175.1~uORF:IOH42096	264	137	127
B01R14C17	1-17-14	Hs~Ref:NM_198483.1~uORF:IOH42754	846	55	791
B01R14C18	1-18-14	Hs~Ref:NM_198483.1~uORF:IOH42754	895	57	838
B01R14C19	1-19-14	Hs~MGC:BC034236.1~uORF:IOH21619	447	101	346
B01R14C20	1-20-14	Hs~MGC:BC034236.1~uORF:IOH21619	441	52	389
B01R14C21	1-21-14	Hs~Ref:NM_005092.2~uORF:IOH34742	279	51	228
B01R14C22	1-22-14	Hs~Ref:NM_005092.2~uORF:IOH34742	201	52	149
B01R15C01	1-1-15	Hs~Ref:NM_005142.2~uORF:IOH26056	258	37	221
B01R15C02	1-2-15	Hs~Ref:NM_005142.2~uORF:IOH26056	256	35	221
B01R15C03	1-3-15	Hs~Ref:NM_018376.2~uORF:IOH7251	314	35	279
B01R15C04	1-4-15	Hs~Ref:NM_018376.2~uORF:IOH7251	342	35	307
B01R15C05	1-5-15	Hs~Ref:NM_153378.1~uORF:IOH45483	529	37	492
B01R15C06	1-6-15	Hs~Ref:NM_153378.1~uORF:IOH45483	548	36	512
B01R15C07	1-7-15	Hs~Ref:NM_004058.2~uORF:IOH45954	289	37	252
B01R15C08	1-8-15	Hs~Ref:NM_004058.2~uORF:IOH45954	329	38	291
B01R15C09	1-9-15	Hs~Ref:NM_181462.1~uORF:IOH45485	1387	40	1347
B01R15C10	1-10-15	Hs~Ref:NM_181462.1~uORF:IOH45485	1353	37	1316
B01R15C11	1-11-15	Hs~Ref:NM_017828.2~uORF:IOH45931	446	35	411
B01R15C12	1-12-15	Hs~Ref:NM_017828.2~uORF:IOH45931	478	35	443
B01R15C13	1-13-15	Hs~IVGN:PM_2149~Ext:thyroglobulin~N/A	164	42	122
B01R15C14	1-14-15	Hs~IVGN:PM_2149~Ext:thyroglobulin~N/A	56	45	11
B01R15C15	1-15-15	Hs~Ref:NM_002739.1~CAT:P2228	248	61	187
B01R15C16	1-16-15	Hs~Ref:NM_002739.1~CAT:P2228	374	67	307
B01R15C17	1-17-15	Hs~Ref:NM_003137.2~CAT:PV4215	108	50	58
B01R15C18	1-18-15	Hs~Ref:NM_003137.2~CAT:PV4215	114	67	47
B01R15C19	1-19-15	Hs~Ref:NM_031988.1~CAT:PV3293	132	58	74
B01R15C20	1-20-15	Hs~Ref:NM_031988.1~CAT:PV3293	276	123	153
B01R15C21	1-21-15	Hs~Ref:NM_002737.1~CAT:P2227	61	56	5
B01R15C22	1-22-15	Hs~Ref:NM_002737.1~CAT:P2227	63	62	1
B01R16C01	1-1-16	Hs~Ref:NM_002648.1~CAT:PV3503	150	38	112
B01R16C02	1-2-16	Hs~Ref:NM_002648.1~CAT:PV3503	162	36	126
B01R16C03	1-3-16	Hs~Ref:NM_015375.1~CAT:PV4678	143	54	89
B01R16C04	1-4-16	Hs~Ref:NM_015375.1~CAT:PV4678	88	35	53
B01R16C05	1-5-16	Hs~Ref:NM_014826.1~CAT:PV4398	68	38	30
B01R16C06	1-6-16	Hs~Ref:NM_014826.1~CAT:PV4398	63	35	28
B01R16C07	1-7-16	Hs~Ref:NM_017692.1~uORF:IOH4894	150	48	102
B01R16C08	1-8-16	Hs~Ref:NM_017692.1~uORF:IOH4894	212	35	177
B01R16C09	1-9-16	Hs~MGC:NM_173547.2~uORF:IOH11612	71	47	24
B01R16C10	1-10-16	Hs~MGC:NM_173547.2~uORF:IOH11612	78	35	43
B01R16C11	1-11-16	Hs~Ref:NM_002475.2~uORF:IOH14814	330	37	293
B01R16C12	1-12-16	Hs~Ref:NM_002475.2~uORF:IOH14814	327	38	289
B01R16C13	1-13-16	Hs~Ref:NM_006466.1~uORF:IOH14273	271	43	228
B01R16C14	1-14-16	Hs~Ref:NM_006466.1~uORF:IOH14273	90	47	43
B01R16C15	1-15-16	Hs~Ref:NM_001641.2~uORF:IOH5081	507	58	449
B01R16C16	1-16-16	Hs~Ref:NM_001641.2~uORF:IOH5081	640	68	572
B01R16C17	1-17-16	Hs~Ref:NM_005740.1~uORF:IOH4940	472	66	406
B01R16C18	1-18-16	Hs~Ref:NM_005740.1~uORF:IOH4940	447	65	382
B01R16C19	1-19-16	Hs~Ref:NM_019070.1~uORF:IOH5264	649	64	585
B01R16C20	1-20-16	Hs~Ref:NM_019070.1~uORF:IOH5264	1378	64	1314
B01R16C21	1-21-16	Hs~Ref:NM_001696.2~uORF:IOH5034	559	66	493
B01R16C22	1-22-16	Hs~Ref:NM_001696.2~uORF:IOH5034	572	249	323
B01R17C01	1-1-17	Hs~MGC:BC012485.1~uORF:IOH10861	576	37	539
B01R17C02	1-2-17	Hs~MGC:BC012485.1~uORF:IOH10861	601	36	565
B01R17C03	1-3-17	Hs~Ref:NM_003978.2~uORF:IOH3303	445	35	410
B01R17C04	1-4-17	Hs~Ref:NM_003978.2~uORF:IOH3303	446	35	411
B01R17C05	1-5-17	Hs~Ref:NM_005793.3~uORF:IOH3852	481	37	444
B01R17C06	1-6-17	Hs~Ref:NM_005793.3~uORF:IOH3852	472	35	437
B01R17C07	1-7-17	Hs~Ref:NM_002135.3~uORF:IOH10133	414	34	380
B01R17C08	1-8-17	Hs~Ref:NM_002135.3~uORF:IOH10133	410	35	375
B01R17C09	1-9-17	Hs~MGC:BC063110.1~uORF:IOH40721	831	35	796
B01R17C10	1-10-17	Hs~MGC:BC063110.1~uORF:IOH40721	810	35	775
B01R17C11	1-11-17	Hs~Ref:NM_033185.2~uORF:IOH40389	427	35	392
B01R17C12	1-12-17	Hs~Ref:NM_033185.2~uORF:IOH40389	448	37	411
B01R17C13	1-13-17	Hs~MGC:BC040529.1~uORF:IOH27481	847	145	702
B01R17C14	1-14-17	Hs~MGC:BC040529.1~uORF:IOH27481	691	244	447
B01R17C15	1-15-17	Hs~Ref:NM_174899.3~uORF:IOH25862	533	49	484
B01R17C16	1-16-17	Hs~Ref:NM_174899.3~uORF:IOH25862	531	161	370
B01R17C17	1-17-17	Hs~Ref:NM_002686.2~uORF:IOH27402	764	83	681
B01R17C18	1-18-17	Hs~Ref:NM_002686.2~uORF:IOH27402	572	62	510
B01R17C19	1-19-17	Hs~MGC:BC041009.2~uORF:IOH25834	1700	58	1642
B01R17C20	1-20-17	Hs~MGC:BC041009.2~uORF:IOH25834	1617	54	1563
B01R17C21	1-21-17	Hs~MGC:BC036075.1~uORF:IOH27252	610	57	553
B01R17C22	1-22-17	Hs~MGC:BC036075.1~uORF:IOH27252	566	54	512
B01R18C01	1-1-18	Hs~Ref:NM_002061.1~uORF:IOH25898	520	37	483
B01R18C02	1-2-18	Hs~Ref:NM_002061.1~uORF:IOH25898	503	36	467
B01R18C03	1-3-18	Hs~MGC:BC064834.1~uORF:IOH40742	436	34	402
B01R18C04	1-4-18	Hs~MGC:BC064834.1~uORF:IOH40742	422	35	387
B01R18C05	1-5-18	Hs~Ref:NM_173518.2~uORF:IOH40744	433	37	396
B01R18C06	1-6-18	Hs~Ref:NM_173518.2~uORF:IOH40744	419	35	384
B01R18C07	1-7-18	Hs~MGC:BC001105.1~uORF:IOH3794	375	35	340
B01R18C08	1-8-18	Hs~MGC:BC001105.1~uORF:IOH3794	368	35	333
B01R18C09	1-9-18	Hs~MGC:BC025389.1~uORF:IOH11380	294	35	259
B01R18C10	1-10-18	Hs~MGC:BC025389.1~uORF:IOH11380	275	37	238
B01R18C11	1-11-18	Hs~Ref:NM_004952.3~uORF:IOH11980	427	34	393
B01R18C12	1-12-18	Hs~Ref:NM_004952.3~uORF:IOH11980	417	34	383
B01R18C13	1-13-18	Hs~Ref:NM_000865.1~uORF:IOH39590	408	42	366
B01R18C14	1-14-18	Hs~Ref:NM_000865.1~uORF:IOH39590	285	43	242
B01R18C15	1-15-18	Hs~Ref:NM_005400.1~N/A	180	79	101
B01R18C16	1-16-18	Hs~Ref:NM_005400.1~N/A	332	76	256
B01R18C17	1-17-18	Hs~MGC:BC008838.1~N/A	133	63	70
B01R18C18	1-18-18	Hs~MGC:BC008838.1~N/A	316	74	242
B01R18C19	1-19-18	Hs~Ref:NM_018649.1~uORF:IOH10067	367	60	307
B01R18C20	1-20-18	Hs~Ref:NM_018649.1~uORF:IOH10067	418	58	360
B01R18C21	1-21-18	Hs~Ref:NM_018014.2~uORF:IOH12520	661	58	603
B01R18C22	1-22-18	Hs~Ref:NM_018014.2~uORF:IOH12520	494	58	436
B01R19C01	1-1-19	Hs~Ref:NM_017841.1~uORF:IOH5201	392	39	353
B01R19C02	1-2-19	Hs~Ref:NM_017841.1~uORF:IOH5201	416	38	378
B01R19C03	1-3-19	Hs~Ref:NM_017510.1~uORF:IOH3866	483	34	449
B01R19C04	1-4-19	Hs~Ref:NM_017510.1~uORF:IOH3866	510	35	475
B01R19C05	1-5-19	Hs~MGC:BC014194.1~uORF:IOH12800	235	82	153
B01R19C06	1-6-19	Hs~MGC:BC014194.1~uORF:IOH12800	339	35	304
B01R19C07	1-7-19	Hs~Ref:NM_021245.2~uORF:IOH11059	324	34	290
B01R19C08	1-8-19	Hs~Ref:NM_021245.2~uORF:IOH11059	339	34	305
B01R19C09	1-9-19	Hs~MGC:BC012472.1~uORF:IOH11069	350	34	316
B01R19C10	1-10-19	Hs~MGC:BC012472.1~uORF:IOH11069	362	35	327
B01R19C11	1-11-19	Hs~MGC:BC002794.1~uORF:IOH5309	200	61	139
B01R19C12	1-12-19	Hs~MGC:BC002794.1~uORF:IOH5309	204	37	167
B01R19C13	1-13-19	Hs~MGC:BC036092.1~uORF:IOH27277	149	35	114
B01R19C14	1-14-19	Hs~MGC:BC036092.1~uORF:IOH27277	182	39	143
B01R19C15	1-15-19	Hs~Ref:NM_198173.1~uORF:IOH44757	868	50	818
B01R19C16	1-16-19	Hs~Ref:NM_198173.1~uORF:IOH44757	836	53	783
B01R19C17	1-17-19	Hs~Ref:NM_145641.1~uORF:IOH44125	432	66	366
B01R19C18	1-18-19	Hs~Ref:NM_145641.1~uORF:IOH44125	998	131	867
B01R19C19	1-19-19	Hs~Ref:NM_144620.1~uORF:IOH13940	609	77	532
B01R19C20	1-20-19	Hs~Ref:NM_144620.1~uORF:IOH13940	665	210	455
B01R19C21	1-21-19	Hs~MGC:BC028227.1~uORF:IOH21543	464	289	175
B01R19C22	1-22-19	Hs~MGC:BC028227.1~uORF:IOH21543	420	64	356
B01R20C01	1-1-20	Hs~Ref:NM_031950.1~uORF:IOH10917	677	41	636
B01R20C02	1-2-20	Hs~Ref:NM_031950.1~uORF:IOH10917	699	37	662
B01R20C03	1-3-20	Hs~Ref:NM_016535.1~uORF:IOH4783	415	34	381
B01R20C04	1-4-20	Hs~Ref:NM_016535.1~uORF:IOH4783	391	36	355
B01R20C05	1-5-20	Hs~Ref:NM_016475.2~uORF:IOH14293	316	40	276
B01R20C06	1-6-20	Hs~Ref:NM_016475.2~uORF:IOH14293	305	38	267
B01R20C07	1-7-20	Hs~Ref:NM_013257.3~uORF:IOH41642	321	35	286
B01R20C08	1-8-20	Hs~Ref:NM_013257.3~uORF:IOH41642	344	35	309
B01R20C09	1-9-20	Hs~MGC:BC006769.1~uORF:IOH3146	817	35	782
B01R20C10	1-10-20	Hs~MGC:BC006769.1~uORF:IOH3146	837	35	802
B01R20C11	1-11-20	Hs~MGC:BC004301.1~uORF:IOH5532	637	35	602
B01R20C12	1-12-20	Hs~MGC:BC004301.1~uORF:IOH5532	660	35	625
B01R20C13	1-13-20	Hs~MGC:BC008825.2~uORF:IOH6387	357	43	314
B01R20C14	1-14-20	Hs~MGC:BC008825.2~uORF:IOH6387	257	40	217
B01R20C15	1-15-20	Hs~Ref:NM_145230.1~uORF:IOH50139	648	49	599
B01R20C16	1-16-20	Hs~Ref:NM_145230.1~uORF:IOH50139	600	48	552
B01R20C17	1-17-20	Hs~Ref:NM_133430.1~uORF:IOH50108	3966	66	3900
B01R20C18	1-18-20	Hs~Ref:NM_133430.1~uORF:IOH50108	3822	78	3744
B01R20C19	1-19-20	Hs~Ref:XM_003960444.1~uORF:IOH50171	9855	85	9770
B01R20C20	1-20-20	Hs~Ref:XM_003960444.1~uORF:IOH50171	10118	63	10055
B01R20C21	1-21-20	Hs~Ref:NM_001009551.1~uORF:IOH50086	886	54	832
B01R20C22	1-22-20	Hs~Ref:NM_001009551.1~uORF:IOH50086	958	52	906
B01R21C01	1-1-21	Hs~Ref:NM_001123366.1~uORF:IOH42412	167	37	130
B01R21C02	1-2-21	Hs~Ref:NM_001123366.1~uORF:IOH42412	205	49	156
B01R21C03	1-3-21	Hs~Ref:NM_021814.3~uORF:IOH41608	386	35	351
B01R21C04	1-4-21	Hs~Ref:NM_021814.3~uORF:IOH41608	359	36	323
B01R21C05	1-5-21	Hs~Ref:ENST00000548232~uORF:IOH41442	731	38	693
B01R21C06	1-6-21	Hs~Ref:ENST00000548232~uORF:IOH41442	713	36	677
B01R21C07	1-7-21	Hs~Ref:NM_003409.2~uORF:IOH41226	345	35	310
B01R21C08	1-8-21	Hs~Ref:NM_003409.2~uORF:IOH41226	337	34	303
B01R21C09	1-9-21	Hs~Ref:NP_002294.2~CAT_10322-H08H-25	32	34	-2
B01R21C10	1-10-21	Hs~Ref:NP_002294.2~CAT_10322-H08H-25	32	34	-2
B01R21C11	1-11-21	Internal_1007209	35	34	1
B01R21C12	1-12-21	Internal_1007209	35	33	2
B01R21C13	1-13-21	Hs~Ref:NP_005067.1~CAT_10457-H08H-25	33	34	-1
B01R21C14	1-14-21	Hs~Ref:NP_005067.1~CAT_10457-H08H-25	34	34	0
B01R21C15	1-15-21	Internal_1007209	165	42	123
B01R21C16	1-16-21	Internal_1007209	47	42	5
B01R21C17	1-17-21	Hs~Ref:NP_065923.1~CAT_10174-H08H-25	41	42	-1
B01R21C18	1-18-21	Hs~Ref:NP_065923.1~CAT_10174-H08H-25	43	44	-1
B01R21C19	1-19-21	Internal_1007209	93	56	37
B01R21C20	1-20-21	Internal_1007209	78	61	17
B01R21C21	1-21-21	Hs~IVGN:Fibronectin_Native~CAT_PHE0023~N/A	694	61	633
B01R21C22	1-22-21	Hs~IVGN:Fibronectin_Native~CAT_PHE0023~N/A	444	85	359
B01R22C01	1-1-22	ERa~N/A	2781	34	2747
B01R22C02	1-2-22	ERa~N/A	2889	34	2855
B01R22C03	1-3-22	PKCeta~N/A	248	37	211
B01R22C04	1-4-22	PKCeta~N/A	237	38	199
B01R22C05	1-5-22	Calmodulin~N/A	52	33	19
B01R22C06	1-6-22	Calmodulin~N/A	93	35	58
B01R22C07	1-7-22	V5control5~N/A	276	33	243
B01R22C08	1-8-22	V5control5~N/A	259	34	225
B01R22C09	1-9-22	V5control4~N/A	153	40	113
B01R22C10	1-10-22	V5control4~N/A	110	35	75
B01R22C11	1-11-22	V5control3~N/A	52	34	18
B01R22C12	1-12-22	V5control3~N/A	90	41	49
B01R22C13	1-13-22	V5control2~N/A	50	43	7
B01R22C14	1-14-22	V5control2~N/A	56	34	22
B01R22C15	1-15-22	V5control1~N/A	59	39	20
B01R22C16	1-16-22	V5control1~N/A	47	47	0
B01R22C17	1-17-22	CMK2A~N/A	115	46	69
B01R22C18	1-18-22	CMK2A~N/A	168	45	123
B01R22C19	1-19-22	ERa~N/A	2160	47	2113
B01R22C20	1-20-22	ERa~N/A	2193	54	2139
B01R22C21	1-21-22	AlexaAntiMouseAb~N/A	13309	53	13256
B01R22C22	1-22-22	AlexaAntiMouseAb~N/A	12876	50	12826
B02R01C01	2-1-1	AlexaAntiMouseAb~N/A	46538	56	46482
B02R01C02	2-2-1	AlexaAntiMouseAb~N/A	44503	58	44445
B02R01C03	2-3-1	ERa~N/A	2457	54	2403
B02R01C04	2-4-1	ERa~N/A	2322	48	2274
B02R01C05	2-5-1	HumanIgG1~N/A	1447	48	1399
B02R01C06	2-6-1	HumanIgG1~N/A	1541	49	1492
B02R01C07	2-7-1	HumanIgG2~N/A	4341	49	4292
B02R01C08	2-8-1	HumanIgG2~N/A	3925	51	3874
B02R01C09	2-9-1	HumanIgG3~N/A	19682	63	19619
B02R01C10	2-10-1	HumanIgG3~N/A	21035	62	20973
B02R01C11	2-11-1	HumanIgG4~N/A	60595	53	60542
B02R01C12	2-12-1	HumanIgG4~N/A	63978	45	63933
B02R01C13	2-13-1	BiotinAb~N/A	381	39	342
B02R01C14	2-14-1	BiotinAb~N/A	367	39	328
B02R01C15	2-15-1	RanBP2deltaFG~N/A	240	38	202
B02R01C16	2-16-1	RanBP2deltaFG~N/A	717	42	675
B02R01C17	2-17-1	hMDM2~N/A	936	52	884
B02R01C18	2-18-1	hMDM2~N/A	864	44	820
B02R01C19	2-19-1	PKCeta~N/A	370	39	331
B02R01C20	2-20-1	PKCeta~N/A	412	38	374
B02R01C21	2-21-1	AlexaAntiMouseAb~N/A	31639	38	31601
B02R01C22	2-22-1	AlexaAntiMouseAb~N/A	36657	39	36618
B02R02C01	2-1-2	PKCeta~N/A	1852	57	1795
B02R02C02	2-2-2	PKCeta~N/A	1832	58	1774
B02R02C03	2-3-2	Buffer	269	64	205
B02R02C04	2-4-2	Buffer	196	53	143
B02R02C05	2-5-2	HumanIgA~N/A	24367	51	24316
B02R02C06	2-6-2	HumanIgA~N/A	24414	51	24363
B02R02C07	2-7-2	Buffer	173	83	90
B02R02C08	2-8-2	Buffer	135	53	82
B02R02C09	2-9-2	BSA~N/A	13965	58	13907
B02R02C10	2-10-2	BSA~N/A	14064	63	14001
B02R02C11	2-11-2	Hs~MGC:BC031053.1~uORF:IOH22523	3329	60	3269
B02R02C12	2-12-2	Hs~MGC:BC031053.1~uORF:IOH22523	3075	57	3018
B02R02C13	2-13-2	Hs~Ref:NM_032630.2~uORF:IOH4256	194	53	141
B02R02C14	2-14-2	Hs~Ref:NM_032630.2~uORF:IOH4256	223	52	171
B02R02C15	2-15-2	Hs~Ref:NM_032316.1~uORF:IOH6534	1572	44	1528
B02R02C16	2-16-2	Hs~Ref:NM_032316.1~uORF:IOH6534	1716	63	1653
B02R02C17	2-17-2	Hs~Ref:NM_032846.2~uORF:IOH13473	357	322	35
B02R02C18	2-18-2	Hs~Ref:NM_032846.2~uORF:IOH13473	341	177	164
B02R02C19	2-19-2	Hs~MGC:BC000208.1~uORF:IOH4373	556	46	510
B02R02C20	2-20-2	Hs~MGC:BC000208.1~uORF:IOH4373	499	43	456
B02R02C21	2-21-2	Hs~MGC:BC008095.1~uORF:IOH3312	478	44	434
B02R02C22	2-22-2	Hs~MGC:BC008095.1~uORF:IOH3312	473	42	431
B02R03C01	2-1-3	Hs~MGC:BC008686.1~uORF:IOH3381	516	82	434
B02R03C02	2-2-3	Hs~MGC:BC008686.1~uORF:IOH3381	450	85	365
B02R03C03	2-3-3	Hs~Ref:NM_004832.1~uORF:IOH4381	737	67	670
B02R03C04	2-4-3	Hs~Ref:NM_004832.1~uORF:IOH4381	658	61	597
B02R03C05	2-5-3	Hs~Ref:NM_181555.1~uORF:IOH45913	306	56	250
B02R03C06	2-6-3	Hs~Ref:NM_181555.1~uORF:IOH45913	348	55	293
B02R03C07	2-7-3	Hs~Ref:NM_182513.1~uORF:IOH44731	362	95	267
B02R03C08	2-8-3	Hs~Ref:NM_182513.1~uORF:IOH44731	198	57	141
B02R03C09	2-9-3	Hs~Ref:NM_015607.2~uORF:IOH41553	2583	58	2525
B02R03C10	2-10-3	Hs~Ref:NM_015607.2~uORF:IOH41553	2756	59	2697
B02R03C11	2-11-3	Hs~Ref:NM_139249.2~uORF:IOH36785	293	59	234
B02R03C12	2-12-3	Hs~Ref:NM_139249.2~uORF:IOH36785	466	141	325
B02R03C13	2-13-3	Hs~Ref:NM_001283.2~uORF:IOH42182	327	56	271
B02R03C14	2-14-3	Hs~Ref:NM_001283.2~uORF:IOH42182	104	67	37
B02R03C15	2-15-3	Hs~Ref:XM_371769.2~uORF:IOH43123	138	79	59
B02R03C16	2-16-3	Hs~Ref:XM_371769.2~uORF:IOH43123	201	85	116
B02R03C17	2-17-3	Hs~Ref:NM_201403.1~uORF:IOH42184	12833	256	12577
B02R03C18	2-18-3	Hs~Ref:NM_201403.1~uORF:IOH42184	13048	186	12862
B02R03C19	2-19-3	Hs~Ref:NM_014280.1~uORF:IOH42939	2525	54	2471
B02R03C20	2-20-3	Hs~Ref:NM_014280.1~uORF:IOH42939	2283	51	2232
B02R03C21	2-21-3	Hs~MGC:BC010889.1~uORF:IOH12754	218	111	107
B02R03C22	2-22-3	Hs~MGC:BC010889.1~uORF:IOH12754	874	94	780
B02R04C01	2-1-4	Hs~Ref:NM_015646.1~uORF:IOH2916	283	132	151
B02R04C02	2-2-4	Hs~Ref:NM_015646.1~uORF:IOH2916	129	95	34
B02R04C03	2-3-4	Hs~MGC:BC010078.1~uORF:IOH13024	653	57	596
B02R04C04	2-4-4	Hs~MGC:BC010078.1~uORF:IOH13024	409	67	342
B02R04C05	2-5-4	Hs~Ref:NM_020980.2~uORF:IOH14443	522	72	450
B02R04C06	2-6-4	Hs~Ref:NM_020980.2~uORF:IOH14443	470	68	402
B02R04C07	2-7-4	Hs~MGC:BC007724.1~uORF:IOH6498	136	64	72
B02R04C08	2-8-4	Hs~MGC:BC007724.1~uORF:IOH6498	136	62	74
B02R04C09	2-9-4	Hs~Ref:NM_001269.2~uORF:IOH6933	572	59	513
B02R04C10	2-10-4	Hs~Ref:NM_001269.2~uORF:IOH6933	358	58	300
B02R04C11	2-11-4	Hs~Ref:NM_001790.2~uORF:IOH14569	505	61	444
B02R04C12	2-12-4	Hs~Ref:NM_001790.2~uORF:IOH14569	665	247	418
B02R04C13	2-13-4	Hs~Ref:NM_000602.1~uORF:IOH9882	510	60	450
B02R04C14	2-14-4	Hs~Ref:NM_000602.1~uORF:IOH9882	474	64	410
B02R04C15	2-15-4	Hs~Ref:NM_003223.1~uORF:IOH9646	908	90	818
B02R04C16	2-16-4	Hs~Ref:NM_003223.1~uORF:IOH9646	881	79	802
B02R04C17	2-17-4	Hs~Ref:NM_000754.2~uORF:IOH14417	173	71	102
B02R04C18	2-18-4	Hs~Ref:NM_000754.2~uORF:IOH14417	227	67	160
B02R04C19	2-19-4	Hs~MGC:BC016789.1~uORF:IOH13602	311	50	261
B02R04C20	2-20-4	Hs~MGC:BC016789.1~uORF:IOH13602	432	53	379
B02R04C21	2-21-4	Hs~MGC:BC009771.1~uORF:IOH12849	458	49	409
B02R04C22	2-22-4	Hs~MGC:BC009771.1~uORF:IOH12849	457	43	414
B02R05C01	2-1-5	Hs~Ref:NM_025218.2~uORF:IOH43182	103	67	36
B02R05C02	2-2-5	Hs~Ref:NM_025218.2~uORF:IOH43182	67	82	-15
B02R05C03	2-3-5	Hs~Ref:XM_379657.2~uORF:IOH43323	173	54	119
B02R05C04	2-4-5	Hs~Ref:XM_379657.2~uORF:IOH43323	241	109	132
B02R05C05	2-5-5	Hs~Ref:NM_015415.1~uORF:IOH41193	223	88	135
B02R05C06	2-6-5	Hs~Ref:NM_015415.1~uORF:IOH41193	308	88	220
B02R05C07	2-7-5	Hs~Ref:NM_006431.2~uORF:IOH41691	533	88	445
B02R05C08	2-8-5	Hs~Ref:NM_006431.2~uORF:IOH41691	462	153	309
B02R05C09	2-9-5	Hs~MGC:BC067773.1~uORF:IOH40125	1070	55	1015
B02R05C10	2-10-5	Hs~MGC:BC067773.1~uORF:IOH40125	1075	57	1018
B02R05C11	2-11-5	Hs~MGC:BC039318.1~uORF:IOH40224	912	85	827
B02R05C12	2-12-5	Hs~MGC:BC039318.1~uORF:IOH40224	630	69	561
B02R05C13	2-13-5	Hs~MGC:BC066340.1~uORF:IOH40104	379	76	303
B02R05C14	2-14-5	Hs~MGC:BC066340.1~uORF:IOH40104	407	263	144
B02R05C15	2-15-5	Hs~Ref:NM_000590.1~uORF:IOH40159	426	70	356
B02R05C16	2-16-5	Hs~Ref:NM_000590.1~uORF:IOH40159	504	67	437
B02R05C17	2-17-5	Hs~Ref:NM_080832.1~uORF:IOH40754	1047	57	990
B02R05C18	2-18-5	Hs~Ref:NM_080832.1~uORF:IOH40754	1022	85	937
B02R05C19	2-19-5	Hs~Ref:NM_006837.2~uORF:IOH6870	385	71	314
B02R05C20	2-20-5	Hs~Ref:NM_006837.2~uORF:IOH6870	322	71	251
B02R05C21	2-21-5	Hs~Ref:NM_152295.3~uORF:IOH40824	999	45	954
B02R05C22	2-22-5	Hs~Ref:NM_152295.3~uORF:IOH40824	890	38	852
B02R06C01	2-1-6	Hs~Ref:NM_152260.1~uORF:IOH40870	1396	61	1335
B02R06C02	2-2-6	Hs~Ref:NM_152260.1~uORF:IOH40870	1208	64	1144
B02R06C03	2-3-6	Hs~Ref:NM_207430.1~uORF:IOH59509	867	56	811
B02R06C04	2-4-6	Hs~Ref:NM_207430.1~uORF:IOH59509	885	61	824
B02R06C05	2-5-6	Hs~Ref:NM_198219.1~uORF:IOH59467	1279	86	1193
B02R06C06	2-6-6	Hs~Ref:NM_198219.1~uORF:IOH59467	1115	80	1035
B02R06C07	2-7-6	Hs~Ref:NM_001014279.1~uORF:IOH54743	180	67	113
B02R06C08	2-8-6	Hs~Ref:NM_001014279.1~uORF:IOH54743	153	61	92
B02R06C09	2-9-6	Hs~Ref:NM_015471.2~uORF:IOH59202	397	61	336
B02R06C10	2-10-6	Hs~Ref:NM_015471.2~uORF:IOH59202	356	62	294
B02R06C11	2-11-6	Hs~Ref:NM_144578.1~uORF:IOH12842	342	88	254
B02R06C12	2-12-6	Hs~Ref:NM_144578.1~uORF:IOH12842	363	116	247
B02R06C13	2-13-6	Hs~Ref:NM_032641.1~uORF:IOH4981	3274	93	3181
B02R06C14	2-14-6	Hs~Ref:NM_032641.1~uORF:IOH4981	3183	66	3117
B02R06C15	2-15-6	Hs~Ref:NM_019895.1~uORF:IOH11450	560	58	502
B02R06C16	2-16-6	Hs~Ref:NM_019895.1~uORF:IOH11450	586	91	495
B02R06C17	2-17-6	Hs~Ref:NM_015399.1~uORF:IOH12808	889	107	782
B02R06C18	2-18-6	Hs~Ref:NM_015399.1~uORF:IOH12808	707	96	611
B02R06C19	2-19-6	Hs~Ref:NM_001861.2~uORF:IOH6832	531	71	460
B02R06C20	2-20-6	Hs~Ref:NM_001861.2~uORF:IOH6832	52	85	-33
B02R06C21	2-21-6	Hs~MGC:BC001351.1~uORF:IOH3711	625	51	574
B02R06C22	2-22-6	Hs~MGC:BC001351.1~uORF:IOH3711	1158	41	1117
B02R07C01	2-1-7	Hs~Ref:NM_002150.1~uORF:IOH14718	945	63	882
B02R07C02	2-2-7	Hs~Ref:NM_002150.1~uORF:IOH14718	859	60	799
B02R07C03	2-3-7	Hs~Ref:NM_004374.2~uORF:IOH4367	460	58	402
B02R07C04	2-4-7	Hs~Ref:NM_004374.2~uORF:IOH4367	529	62	467
B02R07C05	2-5-7	Hs~Ref:NM_015039.2~uORF:IOH41247	1150	56	1094
B02R07C06	2-6-7	Hs~Ref:NM_015039.2~uORF:IOH41247	1134	54	1080
B02R07C07	2-7-7	Hs~Ref:NM_032988.1~uORF:IOH41250	167	61	106
B02R07C08	2-8-7	Hs~Ref:NM_032988.1~uORF:IOH41250	154	60	94
B02R07C09	2-9-7	Hs~Ref:NM_206855.1~uORF:IOH41478	376	205	171
B02R07C10	2-10-7	Hs~Ref:NM_206855.1~uORF:IOH41478	317	71	246
B02R07C11	2-11-7	Hs~Ref:XM_293034.2~uORF:IOH41557	428	79	349
B02R07C12	2-12-7	Hs~Ref:XM_293034.2~uORF:IOH41557	407	67	340
B02R07C13	2-13-7	Hs~MGC:BC017941.1~uORF:IOH13654	526	289	237
B02R07C14	2-14-7	Hs~MGC:BC017941.1~uORF:IOH13654	446	72	374
B02R07C15	2-15-7	Hs~MGC:BC026251.1~uORF:IOH13720	88	96	-8
B02R07C16	2-16-7	Hs~MGC:BC026251.1~uORF:IOH13720	793	76	717
B02R07C17	2-17-7	Hs~MGC:BC009571.1~uORF:IOH13826	1003	103	900
B02R07C18	2-18-7	Hs~MGC:BC009571.1~uORF:IOH13826	951	108	843
B02R07C19	2-19-7	Hs~MGC:BC025963.1~uORF:IOH14668	378	72	306
B02R07C20	2-20-7	Hs~MGC:BC025963.1~uORF:IOH14668	385	65	320
B02R07C21	2-21-7	Hs~MGC:BC095489.1~uORF:IOH63168	23434	67	23367
B02R07C22	2-22-7	Hs~MGC:BC095489.1~uORF:IOH63168	20658	46	20612
B02R08C01	2-1-8	Hs~MGC:BC071890.1~uORF:IOH63068	2729	53	2676
B02R08C02	2-2-8	Hs~MGC:BC071890.1~uORF:IOH63068	2504	53	2451
B02R08C03	2-3-8	Hs~MGC:BC069020.1~uORF:IOH62997	37999	58	37941
B02R08C04	2-4-8	Hs~MGC:BC069020.1~uORF:IOH62997	38353	59	38294
B02R08C05	2-5-8	Hs~MGC:BC078663.1~uORF:IOH63026	309	55	254
B02R08C06	2-6-8	Hs~MGC:BC078663.1~uORF:IOH63026	314	57	257
B02R08C07	2-7-8	Hs~MGC:BC021101.1~uORF:IOH12547	601	68	533
B02R08C08	2-8-8	Hs~MGC:BC021101.1~uORF:IOH12547	454	67	387
B02R08C09	2-9-8	Hs~MGC:NM_020531.2~uORF:IOH5450	286	153	133
B02R08C10	2-10-8	Hs~MGC:NM_020531.2~uORF:IOH5450	202	90	112
B02R08C11	2-11-8	Hs~Ref:NM_032775.1~uORF:IOH12694	506	60	446
B02R08C12	2-12-8	Hs~Ref:NM_032775.1~uORF:IOH12694	654	69	585
B02R08C13	2-13-8	Hs~Ref:NM_002708.1~uORF:IOH4976	715	90	625
B02R08C14	2-14-8	Hs~Ref:NM_002708.1~uORF:IOH4976	673	61	612
B02R08C15	2-15-8	Hs~Ref:NM_017503.2~uORF:IOH12519	3067	69	2998
B02R08C16	2-16-8	Hs~Ref:NM_017503.2~uORF:IOH12519	3166	64	3102
B02R08C17	2-17-8	Hs~MGC:BC009873.1~uORF:IOH12548	382	71	311
B02R08C18	2-18-8	Hs~MGC:BC009873.1~uORF:IOH12548	376	96	280
B02R08C19	2-19-8	Hs~Ref:NM_130777.1~uORF:IOH13230	1138	84	1054
B02R08C20	2-20-8	Hs~Ref:NM_130777.1~uORF:IOH13230	964	82	882
B02R08C21	2-21-8	Hs~MGC:BC009230.2~uORF:IOH12659	252	74	178
B02R08C22	2-22-8	Hs~MGC:BC009230.2~uORF:IOH12659	259	66	193
B02R09C01	2-1-9	Hs~MGC:BC068094.1~uORF:IOH40788	2903	51	2852
B02R09C02	2-2-9	Hs~MGC:BC068094.1~uORF:IOH40788	2449	53	2396
B02R09C03	2-3-9	Hs~MGC:BC070290.1~uORF:IOH40799	175	56	119
B02R09C04	2-4-9	Hs~MGC:BC070290.1~uORF:IOH40799	188	59	129
B02R09C05	2-5-9	Hs~MGC:BC069023.1~uORF:IOH40776	312	69	243
B02R09C06	2-6-9	Hs~MGC:BC069023.1~uORF:IOH40776	345	127	218
B02R09C07	2-7-9	Hs~Ref:NM_004278.2~uORF:IOH57310	331	155	176
B02R09C08	2-8-9	Hs~Ref:NM_004278.2~uORF:IOH57310	266	91	175
B02R09C09	2-9-9	Hs~MGC:BC039577.1~uORF:IOH26185	204	59	145
B02R09C10	2-10-9	Hs~MGC:BC039577.1~uORF:IOH26185	209	59	150
B02R09C11	2-11-9	Hs~MGC:BC040721.1~uORF:IOH26408	262	58	204
B02R09C12	2-12-9	Hs~MGC:BC040721.1~uORF:IOH26408	126	65	61
B02R09C13	2-13-9	Hs~MGC:NM_198282.1~uORF:IOH26670	187	55	132
B02R09C14	2-14-9	Hs~MGC:NM_198282.1~uORF:IOH26670	188	53	135
B02R09C15	2-15-9	Hs~MGC:BC047722.1~uORF:IOH26651	380	54	326
B02R09C16	2-16-9	Hs~MGC:BC047722.1~uORF:IOH26651	307	57	250
B02R09C17	2-17-9	Hs~MGC:BC011576.1~uORF:IOH13248	630	546	84
B02R09C18	2-18-9	Hs~MGC:BC011576.1~uORF:IOH13248	823	92	731
B02R09C19	2-19-9	Hs~MGC:BC014218.2~uORF:IOH12802	657	93	564
B02R09C20	2-20-9	Hs~MGC:BC014218.2~uORF:IOH12802	806	93	713
B02R09C21	2-21-9	Hs~MGC:BC026325.1~uORF:IOH11158	644	134	510
B02R09C22	2-22-9	Hs~MGC:BC026325.1~uORF:IOH11158	490	162	328
B02R10C01	2-1-10	Hs~MGC:BC018063.1~uORF:IOH10722	1444	53	1391
B02R10C02	2-2-10	Hs~MGC:BC018063.1~uORF:IOH10722	1811	55	1756
B02R10C03	2-3-10	Hs~MGC:BC058003.1~uORF:IOH29430	272	62	210
B02R10C04	2-4-10	Hs~MGC:BC058003.1~uORF:IOH29430	245	211	34
B02R10C05	2-5-10	Hs~MGC:BC051291.1~uORF:IOH29356	102	70	32
B02R10C06	2-6-10	Hs~MGC:BC051291.1~uORF:IOH29356	181	60	121
B02R10C07	2-7-10	Hs~MGC:BC057840.1~uORF:IOH29244	734	64	670
B02R10C08	2-8-10	Hs~MGC:BC057840.1~uORF:IOH29244	680	72	608
B02R10C09	2-9-10	Hs~MGC:BC060824.1~uORF:IOH29189	195	67	128
B02R10C10	2-10-10	Hs~MGC:BC060824.1~uORF:IOH29189	192	68	124
B02R10C11	2-11-10	GST1	62	58	4
B02R10C12	2-12-10	GST1	53	55	-2
B02R10C13	2-13-10	GST2	54	49	5
B02R10C14	2-14-10	GST2	52	48	4
B02R10C15	2-15-10	GST3	55	50	5
B02R10C16	2-16-10	GST3	50	52	-2
B02R10C17	2-17-10	GST4	59	75	-16
B02R10C18	2-18-10	GST4	75	63	12
B02R10C19	2-19-10	Anti-HumanIgA1~N/A	10814	59	10755
B02R10C20	2-20-10	Anti-HumanIgA1~N/A	10999	56	10943
B02R10C21	2-21-10	Anti-HumanIgA2~N/A	19558	63	19495
B02R10C22	2-22-10	Anti-HumanIgA2~N/A	19074	60	19014
B02R11C01	2-1-11	AlexaAntiMouseAb~N/A	30256	68	30188
B02R11C02	2-2-11	AlexaAntiMouseAb~N/A	29877	65	29812
B02R11C03	2-3-11	MAPKAP~N/A	105	52	53
B02R11C04	2-4-11	MAPKAP~N/A	108	55	53
B02R11C05	2-5-11	Buffer	293	54	239
B02R11C06	2-6-11	Buffer	259	55	204
B02R11C07	2-7-11	BSA~N/A	12805	56	12749
B02R11C08	2-8-11	BSA~N/A	11961	58	11903
B02R11C09	2-9-11	Anti-HumanIgG1~N/A	2542	54	2488
B02R11C10	2-10-11	Anti-HumanIgG1~N/A	2619	58	2561
B02R11C11	2-11-11	Anti-HumanIgG2~N/A	5070	62	5008
B02R11C12	2-12-11	Anti-HumanIgG2~N/A	4575	56	4519
B02R11C13	2-13-11	Anti-HumanIgG3~N/A	8131	53	8078
B02R11C14	2-14-11	Anti-HumanIgG3~N/A	7288	50	7238
B02R11C15	2-15-11	Anti-HumanIgG4~N/A	15867	54	15813
B02R11C16	2-16-11	Anti-HumanIgG4~N/A	15844	56	15788
B02R11C17	2-17-11	AntiBiotinAb~N/A	15321	62	15259
B02R11C18	2-18-11	AntiBiotinAb~N/A	15594	63	15531
B02R11C19	2-19-11	Buffer	82	65	17
B02R11C20	2-20-11	Buffer	58	56	2
B02R11C21	2-21-11	Hs~MGC:BC058915.1~uORF:IOH29066	279	53	226
B02R11C22	2-22-11	Hs~MGC:BC058915.1~uORF:IOH29066	293	51	242
B02R12C01	2-1-12	Hs~MGC:BC002387.1~uORF:IOH3693	231	125	106
B02R12C02	2-2-12	Hs~MGC:BC002387.1~uORF:IOH3693	292	170	122
B02R12C03	2-3-12	Hs~MGC:BC060838.1~uORF:IOH29287	307	101	206
B02R12C04	2-4-12	Hs~MGC:BC060838.1~uORF:IOH29287	375	76	299
B02R12C05	2-5-12	Hs~MGC:BC058287.1~uORF:IOH29442	703	71	632
B02R12C06	2-6-12	Hs~MGC:BC058287.1~uORF:IOH29442	728	66	662
B02R12C07	2-7-12	Hs~Ref:NM_152332.2~uORF:IOH27272	670	58	612
B02R12C08	2-8-12	Hs~Ref:NM_152332.2~uORF:IOH27272	787	62	725
B02R12C09	2-9-12	Hs~Ref:NM_001910.2~uORF:IOH27398	670	108	562
B02R12C10	2-10-12	Hs~Ref:NM_001910.2~uORF:IOH27398	669	381	288
B02R12C11	2-11-12	Hs~Ref:NM_002435.1~uORF:IOH26367	353	230	123
B02R12C12	2-12-12	Hs~Ref:NM_002435.1~uORF:IOH26367	251	74	177
B02R12C13	2-13-12	Hs~Ref:NM_005014.1~uORF:IOH26340	876	213	663
B02R12C14	2-14-12	Hs~Ref:NM_005014.1~uORF:IOH26340	760	58	702
B02R12C15	2-15-12	Hs~MGC:NM_178034.1~uORF:IOH21503	436	60	376
B02R12C16	2-16-12	Hs~MGC:NM_178034.1~uORF:IOH21503	509	109	400
B02R12C17	2-17-12	Hs~Ref:NM_000737.2~uORF:IOH6333	226	67	159
B02R12C18	2-18-12	Hs~Ref:NM_000737.2~uORF:IOH6333	358	190	168
B02R12C19	2-19-12	Hs~MGC:BC002421.1~uORF:IOH4166	460	62	398
B02R12C20	2-20-12	Hs~MGC:BC002421.1~uORF:IOH4166	445	62	383
B02R12C21	2-21-12	Hs~Ref:NM_001611.2~uORF:IOH14225	238	58	180
B02R12C22	2-22-12	Hs~Ref:NM_001611.2~uORF:IOH14225	161	52	109
B02R13C01	2-1-13	Hs~Ref:NM_002103.3~uORF:IOH6268	5421	63	5358
B02R13C02	2-2-13	Hs~Ref:NM_002103.3~uORF:IOH6268	6466	82	6384
B02R13C03	2-3-13	Hs~MGC:BC096184.3~uORF:IOH63211	232	106	126
B02R13C04	2-4-13	Hs~MGC:BC096184.3~uORF:IOH63211	388	142	246
B02R13C05	2-5-13	Hs~Ref:NM_004602.2~uORF:IOH62672	1330	65	1265
B02R13C06	2-6-13	Hs~Ref:NM_004602.2~uORF:IOH62672	1267	59	1208
B02R13C07	2-7-13	Hs~MGC:BC096708.1~uORF:IOH63336	1427	56	1371
B02R13C08	2-8-13	Hs~MGC:BC096708.1~uORF:IOH63336	1257	58	1199
B02R13C09	2-9-13	Hs~MGC:BC008298.1~uORF:IOH6949	230	67	163
B02R13C10	2-10-13	Hs~MGC:BC008298.1~uORF:IOH6949	709	171	538
B02R13C11	2-11-13	Hs~Ref:NM_017761.2~uORF:IOH4866	114	67	47
B02R13C12	2-12-13	Hs~Ref:NM_017761.2~uORF:IOH4866	116	67	49
B02R13C13	2-13-13	Hs~Ref:NM_031477.1~uORF:IOH5588	187	81	106
B02R13C14	2-14-13	Hs~Ref:NM_031477.1~uORF:IOH5588	144	63	81
B02R13C15	2-15-13	Hs~Ref:NM_030574.1~uORF:IOH5593	129	63	66
B02R13C16	2-16-13	Hs~Ref:NM_030574.1~uORF:IOH5593	130	61	69
B02R13C17	2-17-13	Hs~MGC:BC022996.1~uORF:IOH10666	247	72	175
B02R13C18	2-18-13	Hs~MGC:BC022996.1~uORF:IOH10666	245	73	172
B02R13C19	2-19-13	Hs~MGC:BC030027.2~uORF:IOH45985	273	62	211
B02R13C20	2-20-13	Hs~MGC:BC030027.2~uORF:IOH45985	271	74	197
B02R13C21	2-21-13	Hs~MGC:BC066922.1~uORF:IOH40100	300	104	196
B02R13C22	2-22-13	Hs~MGC:BC066922.1~uORF:IOH40100	373	88	285
B02R14C01	2-1-14	Hs~Ref:NM_199346.1~uORF:IOH22561	507	63	444
B02R14C02	2-2-14	Hs~Ref:NM_199346.1~uORF:IOH22561	551	188	363
B02R14C03	2-3-14	Hs~Ref:NM_001007025.1~uORF:IOH59792	969	111	858
B02R14C04	2-4-14	Hs~Ref:NM_001007025.1~uORF:IOH59792	918	89	829
B02R14C05	2-5-14	Hs~Ref:NM_001002031.2~uORF:IOH59964	208	65	143
B02R14C06	2-6-14	Hs~Ref:NM_001002031.2~uORF:IOH59964	209	57	152
B02R14C07	2-7-14	Hs~Ref:NM_002596.2~uORF:IOH53507	1650	59	1591
B02R14C08	2-8-14	Hs~Ref:NM_002596.2~uORF:IOH53507	1625	60	1565
B02R14C09	2-9-14	Hs~Ref:NM_021808.2~uORF:IOH59749	252	69	183
B02R14C10	2-10-14	Hs~Ref:NM_021808.2~uORF:IOH59749	223	58	165
B02R14C11	2-11-14	Hs~Ref:NM_003010.1~N/A	81	62	19
B02R14C12	2-12-14	Hs~Ref:NM_003010.1~N/A	86	71	15
B02R14C13	2-13-14	Hs~Ref:NM_005923.3~N/A	89	54	35
B02R14C14	2-14-14	Hs~Ref:NM_005923.3~N/A	85	54	31
B02R14C15	2-15-14	Hs~Ref:NM_032520.3~uORF:IOH59295	441	133	308
B02R14C16	2-16-14	Hs~Ref:NM_032520.3~uORF:IOH59295	483	77	406
B02R14C17	2-17-14	Hs~Ref:NM_138571.3~uORF:IOH54716	151	79	72
B02R14C18	2-18-14	Hs~Ref:NM_138571.3~uORF:IOH54716	175	69	106
B02R14C19	2-19-14	Hs~MGC:BC012040.1~uORF:IOH9723	627	63	564
B02R14C20	2-20-14	Hs~MGC:BC012040.1~uORF:IOH9723	600	65	535
B02R14C21	2-21-14	Hs~Ref:NM_014665.1~uORF:IOH9697	289	230	59
B02R14C22	2-22-14	Hs~Ref:NM_014665.1~uORF:IOH9697	308	250	58
B02R15C01	2-1-15	Hs~MGC:BC043247.2~uORF:IOH28730	653	66	587
B02R15C02	2-2-15	Hs~MGC:BC043247.2~uORF:IOH28730	772	71	701
B02R15C03	2-3-15	Hs~Ref:NM_182826.1~uORF:IOH29144	403	71	332
B02R15C04	2-4-15	Hs~Ref:NM_182826.1~uORF:IOH29144	376	63	313
B02R15C05	2-5-15	Hs~MGC:BC022231.1~uORF:IOH10619	844	67	777
B02R15C06	2-6-15	Hs~MGC:BC022231.1~uORF:IOH10619	598	62	536
B02R15C07	2-7-15	Hs~MGC:BC039306.1~uORF:IOH27482	180	112	68
B02R15C08	2-8-15	Hs~MGC:BC039306.1~uORF:IOH27482	499	337	162
B02R15C09	2-9-15	Hs~Ref:NM_021962.1~uORF:IOH20993	1128	72	1056
B02R15C10	2-10-15	Hs~Ref:NM_021962.1~uORF:IOH20993	975	70	905
B02R15C11	2-11-15	Hs~Ref:NM_052841.2~uORF:IOH27376	349	73	276
B02R15C12	2-12-15	Hs~Ref:NM_052841.2~uORF:IOH27376	361	132	229
B02R15C13	2-13-15	Hs~IVGN:PM_2134~Ext:dsDNA_plasmid~N/A	53	54	-1
B02R15C14	2-14-15	Hs~IVGN:PM_2134~Ext:dsDNA_plasmid~N/A	98	52	46
B02R15C15	2-15-15	Hs~MGC:NM_182493.1~CAT:PV3835	142	51	91
B02R15C16	2-16-15	Hs~MGC:NM_182493.1~CAT:PV3835	154	51	103
B02R15C17	2-17-15	Hs~Ref:NM_020126.3~CAT:PV5216	169	58	111
B02R15C18	2-18-15	Hs~Ref:NM_020126.3~CAT:PV5216	183	57	126
B02R15C19	2-19-15	Hs~Ref:NM_005204.2~CAT:PV4313	389	53	336
B02R15C20	2-20-15	Hs~Ref:NM_005204.2~CAT:PV4313	494	157	337
B02R15C21	2-21-15	Hs~Ref:NM_014840.2~CAT:PV4127	1045	47	998
B02R15C22	2-22-15	Hs~Ref:NM_014840.2~CAT:PV4127	1042	49	993
B02R16C01	2-1-16	Hs~IVGN:NM_000585~CAT_PHC9151~N/A	774	93	681
B02R16C02	2-2-16	Hs~IVGN:NM_000585~CAT_PHC9151~N/A	50	61	-11
B02R16C03	2-3-16	Hs~Ref:NM_000584.2~CAT_PHC0884	55	53	2
B02R16C04	2-4-16	Hs~Ref:NM_000584.2~CAT_PHC0884	57	51	6
B02R16C05	2-5-16	Hs~Ref:NM_199168.2~CAT_PHC1346	69	55	14
B02R16C06	2-6-16	Hs~Ref:NM_199168.2~CAT_PHC1346	71	58	13
B02R16C07	2-7-16	Hs~Ref:NM_015000.1~uORF:IOH11742	264	76	188
B02R16C08	2-8-16	Hs~Ref:NM_015000.1~uORF:IOH11742	327	62	265
B02R16C09	2-9-16	Hs~Ref:NM_031939.2~uORF:IOH54858	241	68	173
B02R16C10	2-10-16	Hs~Ref:NM_031939.2~uORF:IOH54858	376	107	269
B02R16C11	2-11-16	Hs~Ref:NM_002315.1~uORF:IOH58985	401	61	340
B02R16C12	2-12-16	Hs~Ref:NM_002315.1~uORF:IOH58985	408	61	347
B02R16C13	2-13-16	Hs~Ref:NM_198098.1~uORF:IOH54894	350	156	194
B02R16C14	2-14-16	Hs~Ref:NM_198098.1~uORF:IOH54894	374	119	255
B02R16C15	2-15-16	Hs~Ref:NM_015929.2~uORF:IOH7138	498	60	438
B02R16C16	2-16-16	Hs~Ref:NM_015929.2~uORF:IOH7138	445	59	386
B02R16C17	2-17-16	Hs~Ref:NM_014628.2~uORF:IOH5724	115	75	40
B02R16C18	2-18-16	Hs~Ref:NM_014628.2~uORF:IOH5724	194	71	123
B02R16C19	2-19-16	Hs~Ref:NM_207647.1~uORF:IOH21757	629	64	565
B02R16C20	2-20-16	Hs~Ref:NM_207647.1~uORF:IOH21757	677	65	612
B02R16C21	2-21-16	Hs~Ref:NM_016070.2~uORF:IOH4356	462	63	399
B02R16C22	2-22-16	Hs~Ref:NM_016070.2~uORF:IOH4356	409	94	315
B02R17C01	2-1-17	Hs~MGC:BC008250.1~uORF:IOH3397	117	55	62
B02R17C02	2-2-17	Hs~MGC:BC008250.1~uORF:IOH3397	188	64	124
B02R17C03	2-3-17	Hs~Ref:NM_005332.2~uORF:IOH11347	122	57	65
B02R17C04	2-4-17	Hs~Ref:NM_005332.2~uORF:IOH11347	128	90	38
B02R17C05	2-5-17	Hs~Ref:NM_002164.1~uORF:IOH11462	188	65	123
B02R17C06	2-6-17	Hs~Ref:NM_002164.1~uORF:IOH11462	181	125	56
B02R17C07	2-7-17	Hs~MGC:BC012423.1~uORF:IOH11557	278	62	216
B02R17C08	2-8-17	Hs~MGC:BC012423.1~uORF:IOH11557	304	60	244
B02R17C09	2-9-17	Hs~Ref:NM_032330.1~uORF:IOH7236	130	50	80
B02R17C10	2-10-17	Hs~Ref:NM_032330.1~uORF:IOH7236	51	53	-2
B02R17C11	2-11-17	Hs~MGC:BC006142.2~uORF:IOH6636	51	53	-2
B02R17C12	2-12-17	Hs~MGC:BC006142.2~uORF:IOH6636	51	52	-1
B02R17C13	2-13-17	Hs~Ref:NM_032882.1~uORF:IOH6958	76	56	20
B02R17C14	2-14-17	Hs~Ref:NM_032882.1~uORF:IOH6958	77	57	20
B02R17C15	2-15-17	Hs~Ref:NM_001056.1~uORF:IOH7147	226	63	163
B02R17C16	2-16-17	Hs~Ref:NM_001056.1~uORF:IOH7147	218	65	153
B02R17C17	2-17-17	Hs~MGC:BC100888.1~uORF:IOH63431	181	90	91
B02R17C18	2-18-17	Hs~MGC:BC100888.1~uORF:IOH63431	170	75	95
B02R17C19	2-19-17	Hs~Ref:NM_020134.2~uORF:IOH5686	490	79	411
B02R17C20	2-20-17	Hs~Ref:NM_020134.2~uORF:IOH5686	592	396	196
B02R17C21	2-21-17	Hs~MGC:BC009681.1~uORF:IOH9846	211	62	149
B02R17C22	2-22-17	Hs~MGC:BC009681.1~uORF:IOH9846	181	56	125
B02R18C01	2-1-18	Hs~Ref:NM_012427.3~uORF:IOH5874	49	51	-2
B02R18C02	2-2-18	Hs~Ref:NM_012427.3~uORF:IOH5874	46	51	-5
B02R18C03	2-3-18	Hs~MGC:BC100017.1~uORF:IOH62781	489	60	429
B02R18C04	2-4-18	Hs~MGC:BC100017.1~uORF:IOH62781	515	150	365
B02R18C05	2-5-18	Hs~MGC:BC094767.1~uORF:IOH62635	197	73	124
B02R18C06	2-6-18	Hs~MGC:BC094767.1~uORF:IOH62635	197	61	136
B02R18C07	2-7-18	Hs~MGC:BC063681.1~uORF:IOH61524	158	62	96
B02R18C08	2-8-18	Hs~MGC:BC063681.1~uORF:IOH61524	146	61	85
B02R18C09	2-9-18	Hs~MGC:BC066265.1~uORF:IOH61828	123	56	67
B02R18C10	2-10-18	Hs~MGC:BC066265.1~uORF:IOH61828	139	59	80
B02R18C11	2-11-18	Hs~Ref:NM_005432.2~uORF:IOH4056	691	229	462
B02R18C12	2-12-18	Hs~Ref:NM_005432.2~uORF:IOH4056	729	246	483
B02R18C13	2-13-18	Hs~Ref:NM_002617.3~uORF:IOH11620	605	129	476
B02R18C14	2-14-18	Hs~Ref:NM_002617.3~uORF:IOH11620	489	59	430
B02R18C15	2-15-18	Hs~Ref:NM_014263.2~uORF:IOH14600	626	73	553
B02R18C16	2-16-18	Hs~Ref:NM_014263.2~uORF:IOH14600	796	72	724
B02R18C17	2-17-18	Hs~MGC:BC030783.1~uORF:IOH22247	815	372	443
B02R18C18	2-18-18	Hs~MGC:BC030783.1~uORF:IOH22247	151	138	13
B02R18C19	2-19-18	Hs~MGC:BC067873.1~uORF:IOH62500	53	110	-57
B02R18C20	2-20-18	Hs~MGC:BC067873.1~uORF:IOH62500	428	148	280
B02R18C21	2-21-18	Hs~Ref:NM_001025100.1~uORF:IOH61586	1140	280	860
B02R18C22	2-22-18	Hs~Ref:NM_001025100.1~uORF:IOH61586	610	78	532
B02R19C01	2-1-19	Hs~MGC:BC064806.1~uORF:IOH61514	281	57	224
B02R19C02	2-2-19	Hs~MGC:BC064806.1~uORF:IOH61514	311	58	253
B02R19C03	2-3-19	Hs~MGC:BC063390.1~uORF:IOH61531	940	358	582
B02R19C04	2-4-19	Hs~MGC:BC063390.1~uORF:IOH61531	841	78	763
B02R19C05	2-5-19	Hs~MGC:BC032654.1~uORF:IOH21978	190	110	80
B02R19C06	2-6-19	Hs~MGC:BC032654.1~uORF:IOH21978	135	57	78
B02R19C07	2-7-19	Hs~Ref:NM_006067.3~uORF:IOH3988	94	66	28
B02R19C08	2-8-19	Hs~Ref:NM_006067.3~uORF:IOH3988	88	64	24
B02R19C09	2-9-19	Hs~Ref:NM_020381.2~uORF:IOH26178	1238	62	1176
B02R19C10	2-10-19	Hs~Ref:NM_020381.2~uORF:IOH26178	1282	64	1218
B02R19C11	2-11-19	Hs~Ref:NM_203454.1~uORF:IOH10788	130	58	72
B02R19C12	2-12-19	Hs~Ref:NM_203454.1~uORF:IOH10788	123	61	62
B02R19C13	2-13-19	Hs~Ref:NM_181314.1~uORF:IOH58938	444	221	223
B02R19C14	2-14-19	Hs~Ref:NM_181314.1~uORF:IOH58938	309	60	249
B02R19C15	2-15-19	Hs~Ref:NM_001966.2~uORF:IOH62346	1459	63	1396
B02R19C16	2-16-19	Hs~Ref:NM_001966.2~uORF:IOH62346	1612	66	1546
B02R19C17	2-17-19	Hs~MGC:BC066904.1~uORF:IOH61475	525	114	411
B02R19C18	2-18-19	Hs~MGC:BC066904.1~uORF:IOH61475	376	75	301
B02R19C19	2-19-19	Hs~MGC:BC085196.1~uORF:IOH63112	376	59	317
B02R19C20	2-20-19	Hs~MGC:BC085196.1~uORF:IOH63112	418	138	280
B02R19C21	2-21-19	Hs~Ref:NM_002870.1~uORF:IOH3059	45	49	-4
B02R19C22	2-22-19	Hs~Ref:NM_002870.1~uORF:IOH3059	44	47	-3
B02R20C01	2-1-20	Hs~Ref:NM_024047.2~uORF:IOH4171	242	207	35
B02R20C02	2-2-20	Hs~Ref:NM_024047.2~uORF:IOH4171	296	67	229
B02R20C03	2-3-20	Hs~MGC:BC000937.2~uORF:IOH3025	214	66	148
B02R20C04	2-4-20	Hs~MGC:BC000937.2~uORF:IOH3025	213	97	116
B02R20C05	2-5-20	Hs~Ref:NM_003792.1~uORF:IOH10852	513	230	283
B02R20C06	2-6-20	Hs~Ref:NM_003792.1~uORF:IOH10852	345	62	283
B02R20C07	2-7-20	Hs~MGC:BC033495.1~uORF:IOH27372	700	359	341
B02R20C08	2-8-20	Hs~MGC:BC033495.1~uORF:IOH27372	502	542	-40
B02R20C09	2-9-20	Hs~MGC:BC050709.1~uORF:IOH27039	53	61	-8
B02R20C10	2-10-20	Hs~MGC:BC050709.1~uORF:IOH27039	50	53	-3
B02R20C11	2-11-20	Hs~Ref:NM_002064.1~uORF:IOH58942	50	52	-2
B02R20C12	2-12-20	Hs~Ref:NM_002064.1~uORF:IOH58942	51	52	-1
B02R20C13	2-13-20	Hs~MGC:BC070058.1~uORF:IOH61671	75	59	16
B02R20C14	2-14-20	Hs~MGC:BC070058.1~uORF:IOH61671	82	54	28
B02R20C15	2-15-20	Hs~Ref:NM_020663.2~uORF:IOH45625	180	54	126
B02R20C16	2-16-20	Hs~Ref:NM_020663.2~uORF:IOH45625	218	182	36
B02R20C17	2-17-20	Hs~Ref:XM_373498.1~uORF:IOH44580	245	94	151
B02R20C18	2-18-20	Hs~Ref:XM_373498.1~uORF:IOH44580	225	103	122
B02R20C19	2-19-20	Hs~Ref:Q14695~uORF:IOH44407	455	62	393
B02R20C20	2-20-20	Hs~Ref:Q14695~uORF:IOH44407	556	232	324
B02R20C21	2-21-20	Hs~Ref:NM_014458.3~uORF:IOH45628	143	53	90
B02R20C22	2-22-20	Hs~Ref:NM_014458.3~uORF:IOH45628	199	142	57
B02R21C01	2-1-21	Hs~Ref:ENST00000369196~uORF:IOH50129	1116	57	1059
B02R21C02	2-2-21	Hs~Ref:ENST00000369196~uORF:IOH50129	1098	52	1046
B02R21C03	2-3-21	Hs~Ref:NM_181289.1~uORF:IOH50104	1254	57	1197
B02R21C04	2-4-21	Hs~Ref:NM_181289.1~uORF:IOH50104	1230	58	1172
B02R21C05	2-5-21	Hs~Ref:ENST00000394142~uORF:IOH50088	622	64	558
B02R21C06	2-6-21	Hs~Ref:ENST00000394142~uORF:IOH50088	641	74	567
B02R21C07	2-7-21	Hs~Ref:ENST00000305614~uORF:IOH50136	952	523	429
B02R21C08	2-8-21	Hs~Ref:ENST00000305614~uORF:IOH50136	733	449	284
B02R21C09	2-9-21	Hs~Ref:NP_056295.1~CAT_10852-H08H-25	49	54	-5
B02R21C10	2-10-21	Hs~Ref:NP_056295.1~CAT_10852-H08H-25	49	50	-1
B02R21C11	2-11-21	Internal_1007209	68	58	10
B02R21C12	2-12-21	Internal_1007209	108	53	55
B02R21C13	2-13-21	Hs~Ref:NP_003010.4~CAT_11041-H08H-25	65	51	14
B02R21C14	2-14-21	Hs~Ref:NP_003010.4~CAT_11041-H08H-25	60	46	14
B02R21C15	2-15-21	Internal_1007209	385	67	318
B02R21C16	2-16-21	Internal_1007209	325	83	242
B02R21C17	2-17-21	Hs~Ref:NP_001183.2~CAT_10620-H03H-25	20815	96	20719
B02R21C18	2-18-21	Hs~Ref:NP_001183.2~CAT_10620-H03H-25	18951	98	18853
B02R21C19	2-19-21	Internal_1007209	65	62	3
B02R21C20	2-20-21	Internal_1007209	54	53	1
B02R21C21	2-21-21	Internal_1007209	53	49	4
B02R21C22	2-22-21	Internal_1007209	50	48	2
B02R22C01	2-1-22	ERa~N/A	2327	50	2277
B02R22C02	2-2-22	ERa~N/A	2279	47	2232
B02R22C03	2-3-22	PKCeta~N/A	410	69	341
B02R22C04	2-4-22	PKCeta~N/A	399	56	343
B02R22C05	2-5-22	Calmodulin~N/A	73	53	20
B02R22C06	2-6-22	Calmodulin~N/A	90	56	34
B02R22C07	2-7-22	V5control5~N/A	5319	54	5265
B02R22C08	2-8-22	V5control5~N/A	5995	54	5941
B02R22C09	2-9-22	V5control4~N/A	214	66	148
B02R22C10	2-10-22	V5control4~N/A	300	60	240
B02R22C11	2-11-22	V5control3~N/A	104	55	49
B02R22C12	2-12-22	V5control3~N/A	91	83	8
B02R22C13	2-13-22	V5control2~N/A	115	53	62
B02R22C14	2-14-22	V5control2~N/A	65	49	16
B02R22C15	2-15-22	V5control1~N/A	58	46	12
B02R22C16	2-16-22	V5control1~N/A	113	51	62
B02R22C17	2-17-22	CMK2A~N/A	292	67	225
B02R22C18	2-18-22	CMK2A~N/A	233	61	172
B02R22C19	2-19-22	ERa~N/A	1719	53	1666
B02R22C20	2-20-22	ERa~N/A	1728	52	1676
B02R22C21	2-21-22	AlexaAntiMouseAb~N/A	10054	50	10004
B02R22C22	2-22-22	AlexaAntiMouseAb~N/A	10594	47	10547
B03R01C01	3-1-1	AlexaAntiMouseAb~N/A	34873	38	34835
B03R01C02	3-2-1	AlexaAntiMouseAb~N/A	35331	39	35292
B03R01C03	3-3-1	ERa~N/A	1351	38	1313
B03R01C04	3-4-1	ERa~N/A	1231	38	1193
B03R01C05	3-5-1	HumanIgG1~N/A	1294	39	1255
B03R01C06	3-6-1	HumanIgG1~N/A	1136	39	1097
B03R01C07	3-7-1	HumanIgG2~N/A	3348	38	3310
B03R01C08	3-8-1	HumanIgG2~N/A	3264	40	3224
B03R01C09	3-9-1	HumanIgG3~N/A	13778	40	13738
B03R01C10	3-10-1	HumanIgG3~N/A	11936	41	11895
B03R01C11	3-11-1	HumanIgG4~N/A	39013	43	38970
B03R01C12	3-12-1	HumanIgG4~N/A	38328	43	38285
B03R01C13	3-13-1	BiotinAb~N/A	326	40	286
B03R01C14	3-14-1	BiotinAb~N/A	319	39	280
B03R01C15	3-15-1	RanBP2deltaFG~N/A	433	38	395
B03R01C16	3-16-1	RanBP2deltaFG~N/A	432	39	393
B03R01C17	3-17-1	hMDM2~N/A	934	40	894
B03R01C18	3-18-1	hMDM2~N/A	937	43	894
B03R01C19	3-19-1	PKCeta~N/A	424	47	377
B03R01C20	3-20-1	PKCeta~N/A	452	54	398
B03R01C21	3-21-1	AlexaAntiMouseAb~N/A	32639	44	32595
B03R01C22	3-22-1	AlexaAntiMouseAb~N/A	35000	44	34956
B03R02C01	3-1-2	PKCeta~N/A	724	37	687
B03R02C02	3-2-2	PKCeta~N/A	741	39	702
B03R02C03	3-3-2	Buffer	228	44	184
B03R02C04	3-4-2	Buffer	206	40	166
B03R02C05	3-5-2	HumanIgA~N/A	20007	39	19968
B03R02C06	3-6-2	HumanIgA~N/A	18275	40	18235
B03R02C07	3-7-2	Buffer	91	41	50
B03R02C08	3-8-2	Buffer	90	41	49
B03R02C09	3-9-2	BSA~N/A	11449	42	11407
B03R02C10	3-10-2	BSA~N/A	12233	42	12191
B03R02C11	3-11-2	Hs~MGC:BC034713.1~uORF:IOH22181	454	44	410
B03R02C12	3-12-2	Hs~MGC:BC034713.1~uORF:IOH22181	439	44	395
B03R02C13	3-13-2	Hs~Ref:NM_000905.1~uORF:IOH22539	396	42	354
B03R02C14	3-14-2	Hs~Ref:NM_000905.1~uORF:IOH22539	401	40	361
B03R02C15	3-15-2	Hs~Ref:NM_005031.2~uORF:IOH21828	468	40	428
B03R02C16	3-16-2	Hs~Ref:NM_005031.2~uORF:IOH21828	410	40	370
B03R02C17	3-17-2	Hs~MGC:BC029439.1~uORF:IOH23158	585	42	543
B03R02C18	3-18-2	Hs~MGC:BC029439.1~uORF:IOH23158	625	44	581
B03R02C19	3-19-2	Hs~MGC:BC033629.1~uORF:IOH21894	480	50	430
B03R02C20	3-20-2	Hs~MGC:BC033629.1~uORF:IOH21894	475	58	417
B03R02C21	3-21-2	Hs~MGC:BC030557.1~uORF:IOH21719	508	49	459
B03R02C22	3-22-2	Hs~MGC:BC030557.1~uORF:IOH21719	487	43	444
B03R03C01	3-1-3	Hs~MGC:BC030524.1~uORF:IOH21689	319	37	282
B03R03C02	3-2-3	Hs~MGC:BC030524.1~uORF:IOH21689	347	40	307
B03R03C03	3-3-3	Hs~MGC:BC033827.1~uORF:IOH21889	326	41	285
B03R03C04	3-4-3	Hs~MGC:BC033827.1~uORF:IOH21889	327	40	287
B03R03C05	3-5-3	Hs~Ref:NM_004475.1~uORF:IOH14024	357	40	317
B03R03C06	3-6-3	Hs~Ref:NM_004475.1~uORF:IOH14024	346	41	305
B03R03C07	3-7-3	Hs~Ref:NM_003192.1~uORF:IOH14757	646	42	604
B03R03C08	3-8-3	Hs~Ref:NM_003192.1~uORF:IOH14757	638	43	595
B03R03C09	3-9-3	Hs~Ref:NM_001124.1~uORF:IOH13846	527	46	481
B03R03C10	3-10-3	Hs~Ref:NM_001124.1~uORF:IOH13846	426	44	382
B03R03C11	3-11-3	Hs~MGC:BC013352.1~uORF:IOH14736	936	44	892
B03R03C12	3-12-3	Hs~MGC:BC013352.1~uORF:IOH14736	986	43	943
B03R03C13	3-13-3	Hs~Ref:NM_003562.2~uORF:IOH10089	405	42	363
B03R03C14	3-14-3	Hs~Ref:NM_003562.2~uORF:IOH10089	429	40	389
B03R03C15	3-15-3	Hs~MGC:BC014928.1~uORF:IOH10102	568	39	529
B03R03C16	3-16-3	Hs~MGC:BC014928.1~uORF:IOH10102	587	41	546
B03R03C17	3-17-3	Hs~Ref:NM_003776.1~uORF:IOH9812	465	49	416
B03R03C18	3-18-3	Hs~Ref:NM_003776.1~uORF:IOH9812	481	49	432
B03R03C19	3-19-3	Hs~Ref:NM_002796.1~uORF:IOH6865	597	43	554
B03R03C20	3-20-3	Hs~Ref:NM_002796.1~uORF:IOH6865	574	41	533
B03R03C21	3-21-3	Hs~Ref:NM_138787.1~uORF:IOH9947	445	44	401
B03R03C22	3-22-3	Hs~Ref:NM_138787.1~uORF:IOH9947	482	44	438
B03R04C01	3-1-4	Hs~MGC:BC007654.1~uORF:IOH5936	833	38	795
B03R04C02	3-2-4	Hs~MGC:BC007654.1~uORF:IOH5936	847	43	804
B03R04C03	3-3-4	Hs~Ref:NM_006460.1~uORF:IOH5964	671	44	627
B03R04C04	3-4-4	Hs~Ref:NM_006460.1~uORF:IOH5964	647	41	606
B03R04C05	3-5-4	Hs~MGC:BC010850.1~uORF:IOH9969	727	40	687
B03R04C06	3-6-4	Hs~MGC:BC010850.1~uORF:IOH9969	757	44	713
B03R04C07	3-7-4	Hs~MGC:BC011924.1~uORF:IOH12682	10367	46	10321
B03R04C08	3-8-4	Hs~MGC:BC011924.1~uORF:IOH12682	9163	44	9119
B03R04C09	3-9-4	Hs~Ref:NM_004838.2~uORF:IOH12410	1106	44	1062
B03R04C10	3-10-4	Hs~Ref:NM_004838.2~uORF:IOH12410	1020	42	978
B03R04C11	3-11-4	Hs~Ref:NM_030815.1~uORF:IOH12796	503	40	463
B03R04C12	3-12-4	Hs~Ref:NM_030815.1~uORF:IOH12796	502	41	461
B03R04C13	3-13-4	Hs~Ref:NM_016836.1~uORF:IOH12909	1138	42	1096
B03R04C14	3-14-4	Hs~Ref:NM_016836.1~uORF:IOH12909	1173	42	1131
B03R04C15	3-15-4	Hs~Ref:NM_021117.1~uORF:IOH27709	464	40	424
B03R04C16	3-16-4	Hs~Ref:NM_021117.1~uORF:IOH27709	451	40	411
B03R04C17	3-17-4	Hs~MGC:BC031689.1~uORF:IOH21504	296	44	252
B03R04C18	3-18-4	Hs~MGC:BC031689.1~uORF:IOH21504	328	44	284
B03R04C19	3-19-4	Hs~Ref:NM_021925.1~uORF:IOH13298	224	42	182
B03R04C20	3-20-4	Hs~Ref:NM_021925.1~uORF:IOH13298	207	43	164
B03R04C21	3-21-4	Hs~Ref:NM_016150.3~uORF:IOH21720	367	53	314
B03R04C22	3-22-4	Hs~Ref:NM_016150.3~uORF:IOH21720	373	66	307
B03R05C01	3-1-5	Hs~MGC:BC012266.2~uORF:IOH10538	343	44	299
B03R05C02	3-2-5	Hs~MGC:BC012266.2~uORF:IOH10538	241	47	194
B03R05C03	3-3-5	Hs~Ref:NM_003621.1~uORF:IOH10784	1247	45	1202
B03R05C04	3-4-5	Hs~Ref:NM_003621.1~uORF:IOH10784	1171	42	1129
B03R05C05	3-5-5	Hs~MGC:BC035031.1~uORF:IOH27140	148	44	104
B03R05C06	3-6-5	Hs~MGC:BC035031.1~uORF:IOH27140	152	51	101
B03R05C07	3-7-5	Hs~Ref:NM_001022.3~uORF:IOH4572	3070	47	3023
B03R05C08	3-8-5	Hs~Ref:NM_001022.3~uORF:IOH4572	2861	41	2820
B03R05C09	3-9-5	Hs~Ref:NM_032331.1~uORF:IOH10505	532	39	493
B03R05C10	3-10-5	Hs~Ref:NM_032331.1~uORF:IOH10505	508	38	470
B03R05C11	3-11-5	Hs~MGC:BC021578.1~uORF:IOH13563	695	38	657
B03R05C12	3-12-5	Hs~MGC:BC021578.1~uORF:IOH13563	751	40	711
B03R05C13	3-13-5	Hs~Ref:NM_001002256.1~uORF:IOH41094	287	43	244
B03R05C14	3-14-5	Hs~Ref:NM_001002256.1~uORF:IOH41094	271	43	228
B03R05C15	3-15-5	Hs~MGC:BC024267.1~uORF:IOH13225	237	41	196
B03R05C16	3-16-5	Hs~MGC:BC024267.1~uORF:IOH13225	282	46	236
B03R05C17	3-17-5	Hs~MGC:NM_182715.1~uORF:IOH11372	1016	40	976
B03R05C18	3-18-5	Hs~MGC:NM_182715.1~uORF:IOH11372	1037	40	997
B03R05C19	3-19-5	Hs~MGC:NM_182621.1~uORF:IOH28035	844	39	805
B03R05C20	3-20-5	Hs~MGC:NM_182621.1~uORF:IOH28035	826	40	786
B03R05C21	3-21-5	Hs~Ref:NM_017614.3~uORF:IOH12877	1948	50	1898
B03R05C22	3-22-5	Hs~Ref:NM_017614.3~uORF:IOH12877	1800	47	1753
B03R06C01	3-1-6	Hs~MGC:BC031821.1~uORF:IOH22188	753	38	715
B03R06C02	3-2-6	Hs~MGC:BC031821.1~uORF:IOH22188	747	39	708
B03R06C03	3-3-6	Hs~MGC:BC017020.1~uORF:IOH10629	3683	39	3644
B03R06C04	3-4-6	Hs~MGC:BC017020.1~uORF:IOH10629	3504	40	3464
B03R06C05	3-5-6	Hs~Ref:NM_006805.2~uORF:IOH10215	414	43	371
B03R06C06	3-6-6	Hs~Ref:NM_006805.2~uORF:IOH10215	456	43	413
B03R06C07	3-7-6	Hs~MGC:NM_015161.1~uORF:IOH11244	433	38	395
B03R06C08	3-8-6	Hs~MGC:NM_015161.1~uORF:IOH11244	407	38	369
B03R06C09	3-9-6	Hs~Ref:NM_003630.1~uORF:IOH10847	308	38	270
B03R06C10	3-10-6	Hs~Ref:NM_003630.1~uORF:IOH10847	296	38	258
B03R06C11	3-11-6	Hs~Ref:NM_002128.2~uORF:IOH2937	441	38	403
B03R06C12	3-12-6	Hs~Ref:NM_002128.2~uORF:IOH2937	377	40	337
B03R06C13	3-13-6	Hs~Ref:NM_080598.2~uORF:IOH3681	485	41	444
B03R06C14	3-14-6	Hs~Ref:NM_080598.2~uORF:IOH3681	465	41	424
B03R06C15	3-15-6	Hs~Ref:NM_020200.3~uORF:IOH3385	387	40	347
B03R06C16	3-16-6	Hs~Ref:NM_020200.3~uORF:IOH3385	372	41	331
B03R06C17	3-17-6	Hs~Ref:NM_001568.1~uORF:IOH3799	427	42	385
B03R06C18	3-18-6	Hs~Ref:NM_001568.1~uORF:IOH3799	410	41	369
B03R06C19	3-19-6	Hs~Ref:NM_003372.3~uORF:IOH26968	648	39	609
B03R06C20	3-20-6	Hs~Ref:NM_003372.3~uORF:IOH26968	692	39	653
B03R06C21	3-21-6	Hs~MGC:BC046131.1~uORF:IOH26912	294	42	252
B03R06C22	3-22-6	Hs~MGC:BC046131.1~uORF:IOH26912	284	41	243
B03R07C01	3-1-7	Hs~MGC:BC041668.1~uORF:IOH26143	245	38	207
B03R07C02	3-2-7	Hs~MGC:BC041668.1~uORF:IOH26143	350	42	308
B03R07C03	3-3-7	Hs~MGC:BC048095.1~uORF:IOH26751	448	39	409
B03R07C04	3-4-7	Hs~MGC:BC048095.1~uORF:IOH26751	419	43	376
B03R07C05	3-5-7	Hs~MGC:BC011418.1~uORF:IOH9706	346	114	232
B03R07C06	3-6-7	Hs~MGC:BC011418.1~uORF:IOH9706	362	54	308
B03R07C07	3-7-7	Hs~MGC:BC023006.1~uORF:IOH22358	382	42	340
B03R07C08	3-8-7	Hs~MGC:BC023006.1~uORF:IOH22358	375	40	335
B03R07C09	3-9-7	Hs~MGC:BC016312.1~uORF:IOH27887	391	39	352
B03R07C10	3-10-7	Hs~MGC:BC016312.1~uORF:IOH27887	418	39	379
B03R07C11	3-11-7	Hs~MGC:BC032108.1~uORF:IOH23020	369	39	330
B03R07C12	3-12-7	Hs~MGC:BC032108.1~uORF:IOH23020	356	40	316
B03R07C13	3-13-7	Hs~Ref:NM_005876.3~uORF:IOH42566	1765	44	1721
B03R07C14	3-14-7	Hs~Ref:NM_005876.3~uORF:IOH42566	1740	45	1695
B03R07C15	3-15-7	Hs~Ref:NM_017542.3~uORF:IOH43680	575	42	533
B03R07C16	3-16-7	Hs~Ref:NM_017542.3~uORF:IOH43680	572	40	532
B03R07C17	3-17-7	Hs~Ref:NM_139068.1~uORF:IOH42152	713	41	672
B03R07C18	3-18-7	Hs~Ref:NM_139068.1~uORF:IOH42152	714	41	673
B03R07C19	3-19-7	Hs~Ref:XM_372169.2~uORF:IOH44624	1293	41	1252
B03R07C20	3-20-7	Hs~Ref:XM_372169.2~uORF:IOH44624	1247	41	1206
B03R07C21	3-21-7	Hs~Ref:NM_016077.1~uORF:IOH3153	1431	41	1390
B03R07C22	3-22-7	Hs~Ref:NM_016077.1~uORF:IOH3153	1419	40	1379
B03R08C01	3-1-8	Hs~Ref:NM_031469.1~uORF:IOH43495	841	54	787
B03R08C02	3-2-8	Hs~Ref:NM_031469.1~uORF:IOH43495	781	51	730
B03R08C03	3-3-8	Hs~Ref:NM_000609.3~uORF:IOH40945	557	39	518
B03R08C04	3-4-8	Hs~Ref:NM_000609.3~uORF:IOH40945	600	40	560
B03R08C05	3-5-8	Hs~Ref:NM_003868.1~uORF:IOH42157	10596	55	10541
B03R08C06	3-6-8	Hs~Ref:NM_003868.1~uORF:IOH42157	10923	61	10862
B03R08C07	3-7-8	Hs~MGC:BC026070.2~uORF:IOH11290	848	55	793
B03R08C08	3-8-8	Hs~MGC:BC026070.2~uORF:IOH11290	776	51	725
B03R08C09	3-9-8	Hs~MGC:BC007742.1~uORF:IOH6517	679	43	636
B03R08C10	3-10-8	Hs~MGC:BC007742.1~uORF:IOH6517	661	40	621
B03R08C11	3-11-8	Hs~Ref:NM_006142.1~uORF:IOH2986	665	39	626
B03R08C12	3-12-8	Hs~Ref:NM_006142.1~uORF:IOH2986	672	40	632
B03R08C13	3-13-8	Hs~MGC:BC008364.1~uORF:IOH5969	649	43	606
B03R08C14	3-14-8	Hs~MGC:BC008364.1~uORF:IOH5969	645	44	601
B03R08C15	3-15-8	Hs~MGC:BC033795.1~uORF:IOH21810	369	44	325
B03R08C16	3-16-8	Hs~MGC:BC033795.1~uORF:IOH21810	388	41	347
B03R08C17	3-17-8	Hs~MGC:BC033740.1~uORF:IOH21832	330	41	289
B03R08C18	3-18-8	Hs~MGC:BC033740.1~uORF:IOH21832	324	40	284
B03R08C19	3-19-8	Hs~Ref:NM_002070.1~uORF:IOH14604	256	42	214
B03R08C20	3-20-8	Hs~Ref:NM_002070.1~uORF:IOH14604	266	44	222
B03R08C21	3-21-8	Hs~Ref:NM_006822.1~uORF:IOH1937	518	42	476
B03R08C22	3-22-8	Hs~Ref:NM_006822.1~uORF:IOH1937	508	40	468
B03R09C01	3-1-9	Hs~Ref:NM_015004.2~uORF:IOH12658	557	59	498
B03R09C02	3-2-9	Hs~Ref:NM_015004.2~uORF:IOH12658	441	56	385
B03R09C03	3-3-9	Hs~Ref:NM_194310.1~uORF:IOH35456	498	45	453
B03R09C04	3-4-9	Hs~Ref:NM_194310.1~uORF:IOH35456	506	44	462
B03R09C05	3-5-9	Hs~Ref:NM_033348.1~uORF:IOH35365	1255	40	1215
B03R09C06	3-6-9	Hs~Ref:NM_033348.1~uORF:IOH35365	1274	42	1232
B03R09C07	3-7-9	Hs~Ref:NM_002625.1~uORF:IOH29862	14413	61	14352
B03R09C08	3-8-9	Hs~Ref:NM_002625.1~uORF:IOH29862	13568	56	13512
B03R09C09	3-9-9	Hs~MGC:BC025697.1~uORF:IOH11332	261	43	218
B03R09C10	3-10-9	Hs~MGC:BC025697.1~uORF:IOH11332	248	41	207
B03R09C11	3-11-9	Hs~Ref:NM_024679.1~uORF:IOH11353	325	40	285
B03R09C12	3-12-9	Hs~Ref:NM_024679.1~uORF:IOH11353	307	40	267
B03R09C13	3-13-9	Hs~Ref:NM_021175.1~uORF:IOH13487	596	40	556
B03R09C14	3-14-9	Hs~Ref:NM_021175.1~uORF:IOH13487	638	39	599
B03R09C15	3-15-9	Hs~Ref:NM_001862.2~uORF:IOH6269	835	39	796
B03R09C16	3-16-9	Hs~Ref:NM_001862.2~uORF:IOH6269	825	39	786
B03R09C17	3-17-9	Hs~MGC:BC047865.1~uORF:IOH26933	371	41	330
B03R09C18	3-18-9	Hs~MGC:BC047865.1~uORF:IOH26933	373	42	331
B03R09C19	3-19-9	Hs~MGC:BC060809.1~uORF:IOH29275	376	45	331
B03R09C20	3-20-9	Hs~MGC:BC060809.1~uORF:IOH29275	399	46	353
B03R09C21	3-21-9	Hs~MGC:BC040656.1~uORF:IOH27626	301	44	257
B03R09C22	3-22-9	Hs~MGC:BC040656.1~uORF:IOH27626	277	44	233
B03R10C01	3-1-10	Hs~MGC:BC017018.1~uORF:IOH11265	864	57	807
B03R10C02	3-2-10	Hs~MGC:BC017018.1~uORF:IOH11265	869	59	810
B03R10C03	3-3-10	Hs~MGC:BC001669.1~uORF:IOH3770	815	252	563
B03R10C04	3-4-10	Hs~MGC:BC001669.1~uORF:IOH3770	615	43	572
B03R10C05	3-5-10	Hs~MGC:BC013051.1~uORF:IOH10509	371	42	329
B03R10C06	3-6-10	Hs~MGC:BC013051.1~uORF:IOH10509	502	43	459
B03R10C07	3-7-10	Hs~MGC:BC004247.1~uORF:IOH5472	439	54	385
B03R10C08	3-8-10	Hs~MGC:BC004247.1~uORF:IOH5472	487	50	437
B03R10C09	3-9-10	Hs~MGC:BC025404.1~uORF:IOH11756	633	40	593
B03R10C10	3-10-10	Hs~MGC:BC025404.1~uORF:IOH11756	687	39	648
B03R10C11	3-11-10	GST1	40	38	2
B03R10C12	3-12-10	GST1	40	38	2
B03R10C13	3-13-10	GST2	43	38	5
B03R10C14	3-14-10	GST2	44	39	5
B03R10C15	3-15-10	GST3	49	39	10
B03R10C16	3-16-10	GST3	47	40	7
B03R10C17	3-17-10	GST4	110	45	65
B03R10C18	3-18-10	GST4	74	48	26
B03R10C19	3-19-10	Anti-HumanIgA1~N/A	9286	42	9244
B03R10C20	3-20-10	Anti-HumanIgA1~N/A	9413	41	9372
B03R10C21	3-21-10	Anti-HumanIgA2~N/A	16591	43	16548
B03R10C22	3-22-10	Anti-HumanIgA2~N/A	16197	43	16154
B03R11C01	3-1-11	AlexaAntiMouseAb~N/A	29997	50	29947
B03R11C02	3-2-11	AlexaAntiMouseAb~N/A	28190	51	28139
B03R11C03	3-3-11	MAPKAP~N/A	76	45	31
B03R11C04	3-4-11	MAPKAP~N/A	93	41	52
B03R11C05	3-5-11	Buffer	159	41	118
B03R11C06	3-6-11	Buffer	157	40	117
B03R11C07	3-7-11	BSA~N/A	11505	44	11461
B03R11C08	3-8-11	BSA~N/A	10082	41	10041
B03R11C09	3-9-11	Anti-HumanIgG1~N/A	1847	39	1808
B03R11C10	3-10-11	Anti-HumanIgG1~N/A	1648	39	1609
B03R11C11	3-11-11	Anti-HumanIgG2~N/A	3768	40	3728
B03R11C12	3-12-11	Anti-HumanIgG2~N/A	3859	40	3819
B03R11C13	3-13-11	Anti-HumanIgG3~N/A	6341	40	6301
B03R11C14	3-14-11	Anti-HumanIgG3~N/A	6409	41	6368
B03R11C15	3-15-11	Anti-HumanIgG4~N/A	11034	42	10992
B03R11C16	3-16-11	Anti-HumanIgG4~N/A	11102	42	11060
B03R11C17	3-17-11	AntiBiotinAb~N/A	11901	42	11859
B03R11C18	3-18-11	AntiBiotinAb~N/A	11313	42	11271
B03R11C19	3-19-11	Buffer	69	40	29
B03R11C20	3-20-11	Buffer	73	39	34
B03R11C21	3-21-11	Hs~MGC:BC010642.1~uORF:IOH9701	483	42	441
B03R11C22	3-22-11	Hs~MGC:BC010642.1~uORF:IOH9701	443	41	402
B03R12C01	3-1-12	Hs~Ref:NM_006685.2~uORF:IOH11229	268	55	213
B03R12C02	3-2-12	Hs~Ref:NM_006685.2~uORF:IOH11229	223	68	155
B03R12C03	3-3-12	Hs~Ref:NM_024812.1~uORF:IOH9655	1623	51	1572
B03R12C04	3-4-12	Hs~Ref:NM_024812.1~uORF:IOH9655	1397	45	1352
B03R12C05	3-5-12	Hs~MGC:BC004407.1~uORF:IOH5570	304	45	259
B03R12C06	3-6-12	Hs~MGC:BC004407.1~uORF:IOH5570	448	46	402
B03R12C07	3-7-12	Hs~MGC:BC041082.1~uORF:IOH29352	419	55	364
B03R12C08	3-8-12	Hs~MGC:BC041082.1~uORF:IOH29352	579	45	534
B03R12C09	3-9-12	Hs~MGC:BC032539.1~uORF:IOH21974	615	45	570
B03R12C10	3-10-12	Hs~MGC:BC032539.1~uORF:IOH21974	741	46	695
B03R12C11	3-11-12	Hs~Ref:NM_000061.1~uORF:IOH21063	617	47	570
B03R12C12	3-12-12	Hs~Ref:NM_000061.1~uORF:IOH21063	563	44	519
B03R12C13	3-13-12	Hs~MGC:BC006318.1~uORF:IOH6433	1266	44	1222
B03R12C14	3-14-12	Hs~MGC:BC006318.1~uORF:IOH6433	1254	45	1209
B03R12C15	3-15-12	Hs~Ref:NM_003739.4~uORF:IOH13880	134	42	92
B03R12C16	3-16-12	Hs~Ref:NM_003739.4~uORF:IOH13880	129	45	84
B03R12C17	3-17-12	Hs~Ref:NM_020150.3~uORF:IOH5222	138	51	87
B03R12C18	3-18-12	Hs~Ref:NM_020150.3~uORF:IOH5222	41	49	-8
B03R12C19	3-19-12	Hs~Ref:NM_002813.4~uORF:IOH3657	1276	44	1232
B03R12C20	3-20-12	Hs~Ref:NM_002813.4~uORF:IOH3657	1154	41	1113
B03R12C21	3-21-12	Hs~Ref:NM_004485.2~uORF:IOH11159	200	44	156
B03R12C22	3-22-12	Hs~Ref:NM_004485.2~uORF:IOH11159	195	46	149
B03R13C01	3-1-13	Hs~Ref:NM_024313.1~uORF:IOH5392	1228	595	633
B03R13C02	3-2-13	Hs~Ref:NM_024313.1~uORF:IOH5392	817	63	754
B03R13C03	3-3-13	Hs~Ref:NM_023938.4~uORF:IOH3759	1465	52	1413
B03R13C04	3-4-13	Hs~Ref:NM_023938.4~uORF:IOH3759	1431	51	1380
B03R13C05	3-5-13	Hs~Ref:NM_018204.2~uORF:IOH41837	740	47	693
B03R13C06	3-6-13	Hs~Ref:NM_018204.2~uORF:IOH41837	489	48	441
B03R13C07	3-7-13	Hs~MGC:BC020550.1~uORF:IOH10324	711	53	658
B03R13C08	3-8-13	Hs~MGC:BC020550.1~uORF:IOH10324	882	434	448
B03R13C09	3-9-13	Hs~MGC:BC038300.1~uORF:IOH62120	142	55	87
B03R13C10	3-10-13	Hs~MGC:BC038300.1~uORF:IOH62120	198	48	150
B03R13C11	3-11-13	Hs~MGC:BC031224.1~uORF:IOH62167	251	68	183
B03R13C12	3-12-13	Hs~MGC:BC031224.1~uORF:IOH62167	451	69	382
B03R13C13	3-13-13	Hs~MGC:BC069697.1~uORF:IOH61909	405	155	250
B03R13C14	3-14-13	Hs~MGC:BC069697.1~uORF:IOH61909	416	51	365
B03R13C15	3-15-13	Hs~MGC:BC040197.1~uORF:IOH62215	504	43	461
B03R13C16	3-16-13	Hs~MGC:BC040197.1~uORF:IOH62215	540	42	498
B03R13C17	3-17-13	Hs~MGC:NM_152729.2~uORF:IOH13044	44526	45	44481
B03R13C18	3-18-13	Hs~MGC:NM_152729.2~uORF:IOH13044	43087	48	43039
B03R13C19	3-19-13	Hs~Ref:NM_005151.2~uORF:IOH5002	65535	48	65487
B03R13C20	3-20-13	Hs~Ref:NM_005151.2~uORF:IOH5002	60833	49	60784
B03R13C21	3-21-13	Hs~MGC:NM_021227.2~uORF:IOH12645	917	44	873
B03R13C22	3-22-13	Hs~MGC:NM_021227.2~uORF:IOH12645	888	42	846
B03R14C01	3-1-14	Hs~MGC:BC007340.1~uORF:IOH5890	890	50	840
B03R14C02	3-2-14	Hs~MGC:BC007340.1~uORF:IOH5890	867	51	816
B03R14C03	3-3-14	Hs~Ref:NM_152734.2~uORF:IOH40907	128	52	76
B03R14C04	3-4-14	Hs~Ref:NM_152734.2~uORF:IOH40907	73	55	18
B03R14C05	3-5-14	Hs~Ref:NM_000732.3~uORF:IOH40817	98	56	42
B03R14C06	3-6-14	Hs~Ref:NM_000732.3~uORF:IOH40817	259	52	207
B03R14C07	3-7-14	Hs~Ref:NM_001767.2~uORF:IOH22609	498	55	443
B03R14C08	3-8-14	Hs~Ref:NM_001767.2~uORF:IOH22609	185	51	134
B03R14C09	3-9-14	Hs~Ref:NM_031300.2~uORF:IOH3726	613	107	506
B03R14C10	3-10-14	Hs~Ref:NM_031300.2~uORF:IOH3726	381	54	327
B03R14C11	3-11-14	Hs~Ref:NM_017772.2~uORF:IOH42187	4180	77	4103
B03R14C12	3-12-14	Hs~Ref:NM_017772.2~uORF:IOH42187	3952	65	3887
B03R14C13	3-13-14	Hs~Ref:NM_152571.2~uORF:IOH42384	1024	52	972
B03R14C14	3-14-14	Hs~Ref:NM_152571.2~uORF:IOH42384	976	46	930
B03R14C15	3-15-14	Hs~Ref:XM_379668.2~uORF:IOH42266	381	58	323
B03R14C16	3-16-14	Hs~Ref:XM_379668.2~uORF:IOH42266	374	43	331
B03R14C17	3-17-14	Hs~Ref:NM_152243.1~uORF:IOH42102	1524	42	1482
B03R14C18	3-18-14	Hs~Ref:NM_152243.1~uORF:IOH42102	1507	42	1465
B03R14C19	3-19-14	Hs~MGC:BC000819.1~uORF:IOH3103	181	57	124
B03R14C20	3-20-14	Hs~MGC:BC000819.1~uORF:IOH3103	238	51	187
B03R14C21	3-21-14	Hs~MGC:BC044584.1~uORF:IOH26743	780	49	731
B03R14C22	3-22-14	Hs~MGC:BC044584.1~uORF:IOH26743	535	45	490
B03R15C01	3-1-15	Hs~Ref:NM_002995.1~uORF:IOH34717	303	51	252
B03R15C02	3-2-15	Hs~Ref:NM_002995.1~uORF:IOH34717	291	202	89
B03R15C03	3-3-15	Hs~MGC:BC005085.1~uORF:IOH6621	317	72	245
B03R15C04	3-4-15	Hs~MGC:BC005085.1~uORF:IOH6621	232	50	182
B03R15C05	3-5-15	Hs~Ref:NM_052887.2~uORF:IOH45532	220	57	163
B03R15C06	3-6-15	Hs~Ref:NM_052887.2~uORF:IOH45532	543	281	262
B03R15C07	3-7-15	Hs~Ref:NM_032131.3~uORF:IOH45465	535	51	484
B03R15C08	3-8-15	Hs~Ref:NM_032131.3~uORF:IOH45465	850	312	538
B03R15C09	3-9-15	Hs~Ref:NM_198183.1~uORF:IOH45533	325	46	279
B03R15C10	3-10-15	Hs~Ref:NM_198183.1~uORF:IOH45533	87	72	15
B03R15C11	3-11-15	Hs~Ref:NM_032588.2~uORF:IOH45956	925	294	631
B03R15C12	3-12-15	Hs~Ref:NM_032588.2~uORF:IOH45956	305	45	260
B03R15C13	3-13-15	Hs~Ref:NM_212535.1~CAT:P2281	222	42	180
B03R15C14	3-14-15	Hs~Ref:NM_212535.1~CAT:P2281	232	43	189
B03R15C15	3-15-15	Hs~Ref:NM_001619.2~CAT:PV3361	177	144	33
B03R15C16	3-16-15	Hs~Ref:NM_001619.2~CAT:PV3361	587	48	539
B03R15C17	3-17-15	Hs~Ref:NM_004119.1~CAT:PV3182	212	42	170
B03R15C18	3-18-15	Hs~Ref:NM_004119.1~CAT:PV3182	189	42	147
B03R15C19	3-19-15	Hs~Ref:NM_000459.1~CAT:PV3628	430	44	386
B03R15C20	3-20-15	Hs~Ref:NM_000459.1~CAT:PV3628	354	44	310
B03R15C21	3-21-15	Hs~Ref:NM_003821.2~CAT:PV4213	69	50	19
B03R15C22	3-22-15	Hs~Ref:NM_003821.2~CAT:PV4213	43	52	-9
B03R16C01	3-1-16	Hs~Ref:NM_024800.2~CAT:PV4647	339	48	291
B03R16C02	3-2-16	Hs~Ref:NM_024800.2~CAT:PV4647	352	59	293
B03R16C03	3-3-16	Hs~Ref:NM_033116.2~CAT:PV4653	306	74	232
B03R16C04	3-4-16	Hs~Ref:NM_033116.2~CAT:PV4653	242	48	194
B03R16C05	3-5-16	Hs~Ref:NM_000575.1~CAT_PHC0017	132	48	84
B03R16C06	3-6-16	Hs~Ref:NM_000575.1~CAT_PHC0017	67	55	12
B03R16C07	3-7-16	Hs~Ref:NM_004935.1~uORF:IOH4873	240	46	194
B03R16C08	3-8-16	Hs~Ref:NM_004935.1~uORF:IOH4873	329	68	261
B03R16C09	3-9-16	Hs~Ref:NM_032731.2~uORF:IOH6754	73	51	22
B03R16C10	3-10-16	Hs~Ref:NM_032731.2~uORF:IOH6754	106	45	61
B03R16C11	3-11-16	Hs~MGC:BC007863.1~uORF:IOH6769	67	49	18
B03R16C12	3-12-16	Hs~MGC:BC007863.1~uORF:IOH6769	170	47	123
B03R16C13	3-13-16	Hs~MGC:BC010662.1~uORF:IOH9725	135	45	90
B03R16C14	3-14-16	Hs~MGC:BC010662.1~uORF:IOH9725	100	46	54
B03R16C15	3-15-16	Hs~Ref:NM_001946.1~uORF:IOH5003	672	50	622
B03R16C16	3-16-16	Hs~Ref:NM_001946.1~uORF:IOH5003	663	78	585
B03R16C17	3-17-16	Hs~MGC:BC005177.1~uORF:IOH4713	965	67	898
B03R16C18	3-18-16	Hs~MGC:BC005177.1~uORF:IOH4713	889	58	831
B03R16C19	3-19-16	Hs~Ref:NM_002695.2~uORF:IOH5025	366	51	315
B03R16C20	3-20-16	Hs~Ref:NM_002695.2~uORF:IOH5025	45	69	-24
B03R16C21	3-21-16	Hs~Ref:NM_057180.1~uORF:IOH3232	870	58	812
B03R16C22	3-22-16	Hs~Ref:NM_057180.1~uORF:IOH3232	982	48	934
B03R17C01	3-1-17	Hs~Ref:NM_003344.2~uORF:IOH6283	557	47	510
B03R17C02	3-2-17	Hs~Ref:NM_003344.2~uORF:IOH6283	577	51	526
B03R17C03	3-3-17	Hs~MGC:BC005807.2~uORF:IOH6261	835	49	786
B03R17C04	3-4-17	Hs~MGC:BC005807.2~uORF:IOH6261	788	48	740
B03R17C05	3-5-17	Hs~Ref:NM_199191.1~uORF:IOH3115	594	50	544
B03R17C06	3-6-17	Hs~Ref:NM_199191.1~uORF:IOH3115	677	57	620
B03R17C07	3-7-17	Hs~MGC:BC013630.1~uORF:IOH10193	544	60	484
B03R17C08	3-8-17	Hs~MGC:BC013630.1~uORF:IOH10193	716	52	664
B03R17C09	3-9-17	Hs~Ref:NM_020438.3~uORF:IOH40220	667	126	541
B03R17C10	3-10-17	Hs~Ref:NM_020438.3~uORF:IOH40220	256	62	194
B03R17C11	3-11-17	Hs~Ref:NM_022789.2~uORF:IOH40292	676	49	627
B03R17C12	3-12-17	Hs~Ref:NM_022789.2~uORF:IOH40292	800	50	750
B03R17C13	3-13-17	Hs~Ref:NM_012145.2~uORF:IOH5195	313	51	262
B03R17C14	3-14-17	Hs~Ref:NM_012145.2~uORF:IOH5195	335	54	281
B03R17C15	3-15-17	Hs~MGC:BC006195.1~uORF:IOH5808	314	270	44
B03R17C16	3-16-17	Hs~MGC:BC006195.1~uORF:IOH5808	317	53	264
B03R17C17	3-17-17	Hs~Ref:NM_003362.2~uORF:IOH11675	103	62	41
B03R17C18	3-18-17	Hs~Ref:NM_003362.2~uORF:IOH11675	615	52	563
B03R17C19	3-19-17	Hs~Ref:NM_173468.2~uORF:IOH27138	912	55	857
B03R17C20	3-20-17	Hs~Ref:NM_173468.2~uORF:IOH27138	327	66	261
B03R17C21	3-21-17	Hs~Ref:NM_153345.1~uORF:IOH27468	666	51	615
B03R17C22	3-22-17	Hs~Ref:NM_153345.1~uORF:IOH27468	623	49	574
B03R18C01	3-1-18	Hs~Ref:NM_013322.2~uORF:IOH27109	675	46	629
B03R18C02	3-2-18	Hs~Ref:NM_013322.2~uORF:IOH27109	663	49	614
B03R18C03	3-3-18	Hs~MGC:BC062696.1~uORF:IOH40720	415	53	362
B03R18C04	3-4-18	Hs~MGC:BC062696.1~uORF:IOH40720	453	201	252
B03R18C05	3-5-18	Hs~Ref:NM_020425.3~uORF:IOH40803	499	55	444
B03R18C06	3-6-18	Hs~Ref:NM_020425.3~uORF:IOH40803	511	57	454
B03R18C07	3-7-18	Hs~MGC:BC022309.1~uORF:IOH14497	371	60	311
B03R18C08	3-8-18	Hs~MGC:BC022309.1~uORF:IOH14497	62	63	-1
B03R18C09	3-9-18	Hs~MGC:BC020517.1~uORF:IOH10694	220	51	169
B03R18C10	3-10-18	Hs~MGC:BC020517.1~uORF:IOH10694	74	62	12
B03R18C11	3-11-18	Hs~Ref:NM_000764.2~uORF:IOH39393	296	52	244
B03R18C12	3-12-18	Hs~Ref:NM_000764.2~uORF:IOH39393	2729	53	2676
B03R18C13	3-13-18	Hs~Ref:NM_147204.1~uORF:IOH39618	71	56	15
B03R18C14	3-14-18	Hs~Ref:NM_147204.1~uORF:IOH39618	71	59	12
B03R18C15	3-15-18	Hs~Ref:NM_004755.1~N/A	273	117	156
B03R18C16	3-16-18	Hs~Ref:NM_004755.1~N/A	106	53	53
B03R18C17	3-17-18	Hs~Ref:NM_017988.1~N/A	145	56	89
B03R18C18	3-18-18	Hs~Ref:NM_017988.1~N/A	197	61	136
B03R18C19	3-19-18	Hs~MGC:BC033766.1~uORF:IOH21750	820	50	770
B03R18C20	3-20-18	Hs~MGC:BC033766.1~uORF:IOH21750	830	57	773
B03R18C21	3-21-18	Hs~MGC:NM_173554.1~uORF:IOH25890	417	53	364
B03R18C22	3-22-18	Hs~MGC:NM_173554.1~uORF:IOH25890	483	55	428
B03R19C01	3-1-19	Hs~Ref:NM_002709.1~uORF:IOH5281	408	48	360
B03R19C02	3-2-19	Hs~Ref:NM_002709.1~uORF:IOH5281	438	50	388
B03R19C03	3-3-19	Hs~MGC:BC009415.1~uORF:IOH14115	592	63	529
B03R19C04	3-4-19	Hs~MGC:BC009415.1~uORF:IOH14115	591	315	276
B03R19C05	3-5-19	Hs~Ref:NM_145047.1~uORF:IOH10837	258	54	204
B03R19C06	3-6-19	Hs~Ref:NM_145047.1~uORF:IOH10837	358	58	300
B03R19C07	3-7-19	Hs~Ref:NM_030780.2~uORF:IOH10844	180	52	128
B03R19C08	3-8-19	Hs~Ref:NM_030780.2~uORF:IOH10844	106	63	43
B03R19C09	3-9-19	Hs~MGC:BC033025.1~uORF:IOH22485	165	46	119
B03R19C10	3-10-19	Hs~MGC:BC033025.1~uORF:IOH22485	268	167	101
B03R19C11	3-11-19	Hs~Ref:NM_018983.2~uORF:IOH3041	301	56	245
B03R19C12	3-12-19	Hs~Ref:NM_018983.2~uORF:IOH3041	484	50	434
B03R19C13	3-13-19	Hs~Ref:NM_144686.1~uORF:IOH12593	186	50	136
B03R19C14	3-14-19	Hs~Ref:NM_144686.1~uORF:IOH12593	68	57	11
B03R19C15	3-15-19	Hs~Ref:NM_004503.2~uORF:IOH42979	5874	54	5820
B03R19C16	3-16-19	Hs~Ref:NM_004503.2~uORF:IOH42979	5718	54	5664
B03R19C17	3-17-19	Hs~Ref:NM_181656.1~uORF:IOH41475	787	59	728
B03R19C18	3-18-19	Hs~Ref:NM_181656.1~uORF:IOH41475	848	390	458
B03R19C19	3-19-19	Hs~Ref:NM_153764.1~uORF:IOH45724	522	53	469
B03R19C20	3-20-19	Hs~Ref:NM_153764.1~uORF:IOH45724	327	150	177
B03R19C21	3-21-19	Hs~Ref:NM_031492.1~uORF:IOH5506	136	73	63
B03R19C22	3-22-19	Hs~Ref:NM_031492.1~uORF:IOH5506	52	75	-23
B03R20C01	3-1-20	Hs~MGC:BC025263.1~uORF:IOH13964	445	48	397
B03R20C02	3-2-20	Hs~MGC:BC025263.1~uORF:IOH13964	461	50	411
B03R20C03	3-3-20	Hs~Ref:NM_133325.1~uORF:IOH10336	260	161	99
B03R20C04	3-4-20	Hs~Ref:NM_133325.1~uORF:IOH10336	192	52	140
B03R20C05	3-5-20	Hs~Ref:NM_002104.1~uORF:IOH26030	296	52	244
B03R20C06	3-6-20	Hs~Ref:NM_002104.1~uORF:IOH26030	354	140	214
B03R20C07	3-7-20	Hs~MGC:BC012001.1~uORF:IOH10862	929	50	879
B03R20C08	3-8-20	Hs~MGC:BC012001.1~uORF:IOH10862	867	48	819
B03R20C09	3-9-20	Hs~MGC:BC018929.1~uORF:IOH22929	25015	44	24971
B03R20C10	3-10-20	Hs~MGC:BC018929.1~uORF:IOH22929	25914	44	25870
B03R20C11	3-11-20	Hs~Ref:NM_003002.1~uORF:IOH7395	219	106	113
B03R20C12	3-12-20	Hs~Ref:NM_003002.1~uORF:IOH7395	189	44	145
B03R20C13	3-13-20	Hs~Ref:NM_003049.1~uORF:IOH40375	169	59	110
B03R20C14	3-14-20	Hs~Ref:NM_003049.1~uORF:IOH40375	281	120	161
B03R20C15	3-15-20	Hs~Ref:NM_198573.2~uORF:IOH50130	547	51	496
B03R20C16	3-16-20	Hs~Ref:NM_198573.2~uORF:IOH50130	516	52	464
B03R20C17	3-17-20	Hs~Ref:NM_152855.1~uORF:IOH50148	514	53	461
B03R20C18	3-18-20	Hs~Ref:NM_152855.1~uORF:IOH50148	559	53	506
B03R20C19	3-19-20	Hs~Ref:NM_181704.1~uORF:IOH50065	403	250	153
B03R20C20	3-20-20	Hs~Ref:NM_181704.1~uORF:IOH50065	190	90	100
B03R20C21	3-21-20	Hs~Ref:NM_001009616.1~uORF:IOH50117	996	175	821
B03R20C22	3-22-20	Hs~Ref:NM_001009616.1~uORF:IOH50117	1381	85	1296
B03R21C01	3-1-21	Hs~Ref:NM_032276.2~uORF:IOH41392	218	88	130
B03R21C02	3-2-21	Hs~Ref:NM_032276.2~uORF:IOH41392	317	50	267
B03R21C03	3-3-21	Hs~Ref:NM_012214.1~uORF:IOH41693	172	45	127
B03R21C04	3-4-21	Hs~Ref:NM_012214.1~uORF:IOH41693	169	44	125
B03R21C05	3-5-21	Hs~Ref:NM_198057.2~uORF:IOH41632	878	45	833
B03R21C06	3-6-21	Hs~Ref:NM_198057.2~uORF:IOH41632	852	46	806
B03R21C07	3-7-21	Hs~Ref:NM_014426.2~uORF:IOH41447	264	74	190
B03R21C08	3-8-21	Hs~Ref:NM_014426.2~uORF:IOH41447	221	186	35
B03R21C09	3-9-21	Hs~Ref:NP_001486.4~CAT_10331-H08H-25	38	42	-4
B03R21C10	3-10-21	Hs~Ref:NP_001486.4~CAT_10331-H08H-25	37	39	-2
B03R21C11	3-11-21	Internal_1007209	42	41	1
B03R21C12	3-12-21	Internal_1007209	42	40	2
B03R21C13	3-13-21	Hs~Ref:NP_940986.1~CAT_10461-H08E-25	531	39	492
B03R21C14	3-14-21	Hs~Ref:NP_940986.1~CAT_10461-H08E-25	46	41	5
B03R21C15	3-15-21	Internal_1007209	53	42	11
B03R21C16	3-16-21	Internal_1007209	55	42	13
B03R21C17	3-17-21	Hs~Ref:NP_003844.1~CAT_10176-H08H-25	1731	42	1689
B03R21C18	3-18-21	Hs~Ref:NP_003844.1~CAT_10176-H08H-25	42	41	1
B03R21C19	3-19-21	Internal_1007209	44	43	1
B03R21C20	3-20-21	Internal_1007209	88	44	44
B03R21C21	3-21-21	Internal_1007209	307	48	259
B03R21C22	3-22-21	Internal_1007209	144	53	91
B03R22C01	3-1-22	ERa~N/A	2093	43	2050
B03R22C02	3-2-22	ERa~N/A	1959	41	1918
B03R22C03	3-3-22	PKCeta~N/A	316	44	272
B03R22C04	3-4-22	PKCeta~N/A	304	60	244
B03R22C05	3-5-22	Calmodulin~N/A	67	38	29
B03R22C06	3-6-22	Calmodulin~N/A	78	52	26
B03R22C07	3-7-22	V5control5~N/A	318	42	276
B03R22C08	3-8-22	V5control5~N/A	308	58	250
B03R22C09	3-9-22	V5control4~N/A	38	39	-1
B03R22C10	3-10-22	V5control4~N/A	39	38	1
B03R22C11	3-11-22	V5control3~N/A	61	44	17
B03R22C12	3-12-22	V5control3~N/A	73	41	32
B03R22C13	3-13-22	V5control2~N/A	63	41	22
B03R22C14	3-14-22	V5control2~N/A	52	41	11
B03R22C15	3-15-22	V5control1~N/A	369	42	327
B03R22C16	3-16-22	V5control1~N/A	53	42	11
B03R22C17	3-17-22	CMK2A~N/A	161	43	118
B03R22C18	3-18-22	CMK2A~N/A	146	45	101
B03R22C19	3-19-22	ERa~N/A	1702	45	1657
B03R22C20	3-20-22	ERa~N/A	2290	54	2236
B03R22C21	3-21-22	AlexaAntiMouseAb~N/A	2919	47	2872
B03R22C22	3-22-22	AlexaAntiMouseAb~N/A	9581	46	9535
B04R01C01	4-1-1	AlexaAntiMouseAb~N/A	33108	41	33067
B04R01C02	4-2-1	AlexaAntiMouseAb~N/A	31823	41	31782
B04R01C03	4-3-1	ERa~N/A	2340	42	2298
B04R01C04	4-4-1	ERa~N/A	2293	45	2248
B04R01C05	4-5-1	HumanIgG1~N/A	120	48	72
B04R01C06	4-6-1	HumanIgG1~N/A	578	60	518
B04R01C07	4-7-1	HumanIgG2~N/A	2736	52	2684
B04R01C08	4-8-1	HumanIgG2~N/A	2527	193	2334
B04R01C09	4-9-1	HumanIgG3~N/A	13006	55	12951
B04R01C10	4-10-1	HumanIgG3~N/A	10763	55	10708
B04R01C11	4-11-1	HumanIgG4~N/A	44677	54	44623
B04R01C12	4-12-1	HumanIgG4~N/A	47549	56	47493
B04R01C13	4-13-1	BiotinAb~N/A	86	68	18
B04R01C14	4-14-1	BiotinAb~N/A	202	59	143
B04R01C15	4-15-1	RanBP2deltaFG~N/A	282	54	228
B04R01C16	4-16-1	RanBP2deltaFG~N/A	260	55	205
B04R01C17	4-17-1	hMDM2~N/A	1047	53	994
B04R01C18	4-18-1	hMDM2~N/A	57	63	-6
B04R01C19	4-19-1	PKCeta~N/A	125	62	63
B04R01C20	4-20-1	PKCeta~N/A	213	65	148
B04R01C21	4-21-1	AlexaAntiMouseAb~N/A	26571	62	26509
B04R01C22	4-22-1	AlexaAntiMouseAb~N/A	31070	60	31010
B04R02C01	4-1-2	PKCeta~N/A	878	42	836
B04R02C02	4-2-2	PKCeta~N/A	806	43	763
B04R02C03	4-3-2	Buffer	94	44	50
B04R02C04	4-4-2	Buffer	105	54	51
B04R02C05	4-5-2	HumanIgA~N/A	19498	47	19451
B04R02C06	4-6-2	HumanIgA~N/A	16645	58	16587
B04R02C07	4-7-2	Buffer	64	56	8
B04R02C08	4-8-2	Buffer	87	48	39
B04R02C09	4-9-2	BSA~N/A	13251	52	13199
B04R02C10	4-10-2	BSA~N/A	12037	58	11979
B04R02C11	4-11-2	Hs~Ref:NM_000850.2~uORF:IOH9886	4186	53	4133
B04R02C12	4-12-2	Hs~Ref:NM_000850.2~uORF:IOH9886	4012	54	3958
B04R02C13	4-13-2	Hs~Ref:NM_003551.1~uORF:IOH10879	77	83	-6
B04R02C14	4-14-2	Hs~Ref:NM_003551.1~uORF:IOH10879	2147	88	2059
B04R02C15	4-15-2	Hs~MGC:BC016380.1~uORF:IOH23077	60064	60	60004
B04R02C16	4-16-2	Hs~MGC:BC016380.1~uORF:IOH23077	52704	59	52645
B04R02C17	4-17-2	Hs~MGC:NM_025196.2~uORF:IOH10877	287	56	231
B04R02C18	4-18-2	Hs~MGC:NM_025196.2~uORF:IOH10877	48	91	-43
B04R02C19	4-19-2	Hs~MGC:BC000452.1~uORF:IOH3518	234	93	141
B04R02C20	4-20-2	Hs~MGC:BC000452.1~uORF:IOH3518	256	167	89
B04R02C21	4-21-2	Hs~Ref:NM_016497.2~uORF:IOH4360	82	102	-20
B04R02C22	4-22-2	Hs~Ref:NM_016497.2~uORF:IOH4360	113	91	22
B04R03C01	4-1-3	Hs~MGC:BC008641.1~uORF:IOH3164	502	42	460
B04R03C02	4-2-3	Hs~MGC:BC008641.1~uORF:IOH3164	515	44	471
B04R03C03	4-3-3	Hs~Ref:NM_000190.2~uORF:IOH3306	676	44	632
B04R03C04	4-4-3	Hs~Ref:NM_000190.2~uORF:IOH3306	602	49	553
B04R03C05	4-5-3	Hs~Ref:NM_002991.2~uORF:IOH34716	394	172	222
B04R03C06	4-6-3	Hs~Ref:NM_002991.2~uORF:IOH34716	71	57	14
B04R03C07	4-7-3	Hs~Ref:NM_000562.1~uORF:IOH44369	45	73	-28
B04R03C08	4-8-3	Hs~Ref:NM_000562.1~uORF:IOH44369	46	64	-18
B04R03C09	4-9-3	Hs~Ref:NM_212461.1~uORF:IOH45870	45	75	-30
B04R03C10	4-10-3	Hs~Ref:NM_212461.1~uORF:IOH45870	64	75	-11
B04R03C11	4-11-3	Hs~Ref:XM_379195.2~uORF:IOH44735	68	72	-4
B04R03C12	4-12-3	Hs~Ref:XM_379195.2~uORF:IOH44735	60	73	-13
B04R03C13	4-13-3	Hs~Ref:NM_020348.1~uORF:IOH42100	177	165	12
B04R03C14	4-14-3	Hs~Ref:NM_020348.1~uORF:IOH42100	67	220	-153
B04R03C15	4-15-3	Hs~Ref:NM_181718.3~uORF:IOH43722	65	87	-22
B04R03C16	4-16-3	Hs~Ref:NM_181718.3~uORF:IOH43722	73	88	-15
B04R03C17	4-17-3	Hs~Ref:NM_176823.2~uORF:IOH43135	59	84	-25
B04R03C18	4-18-3	Hs~Ref:NM_176823.2~uORF:IOH43135	49	145	-96
B04R03C19	4-19-3	Hs~Ref:NM_181892.1~uORF:IOH43701	42	179	-137
B04R03C20	4-20-3	Hs~Ref:NM_181892.1~uORF:IOH43701	43	166	-123
B04R03C21	4-21-3	Hs~MGC:NM_152267.2~uORF:IOH14506	49	221	-172
B04R03C22	4-22-3	Hs~MGC:NM_152267.2~uORF:IOH14506	58	207	-149
B04R04C01	4-1-4	Hs~Ref:NM_144593.1~uORF:IOH11628	547	41	506
B04R04C02	4-2-4	Hs~Ref:NM_144593.1~uORF:IOH11628	530	42	488
B04R04C03	4-3-4	Hs~MGC:BC029399.1~uORF:IOH23147	615	43	572
B04R04C04	4-4-4	Hs~MGC:BC029399.1~uORF:IOH23147	562	44	518
B04R04C05	4-5-4	Hs~MGC:NM_177552.1~uORF:IOH12788	365	48	317
B04R04C06	4-6-4	Hs~MGC:NM_177552.1~uORF:IOH12788	399	51	348
B04R04C07	4-7-4	Hs~MGC:BC027731.1~uORF:IOH14616	770	48	722
B04R04C08	4-8-4	Hs~MGC:BC027731.1~uORF:IOH14616	43	113	-70
B04R04C09	4-9-4	Hs~MGC:NM_152266.1~uORF:IOH13579	7619	103	7516
B04R04C10	4-10-4	Hs~MGC:NM_152266.1~uORF:IOH13579	7858	122	7736
B04R04C11	4-11-4	Hs~Ref:NM_013232.2~uORF:IOH10469	1778	115	1663
B04R04C12	4-12-4	Hs~Ref:NM_013232.2~uORF:IOH10469	98	212	-114
B04R04C13	4-13-4	Hs~MGC:BC017371.1~uORF:IOH14347	56	228	-172
B04R04C14	4-14-4	Hs~MGC:BC017371.1~uORF:IOH14347	54	223	-169
B04R04C15	4-15-4	Hs~Ref:NM_006351.1~uORF:IOH21740	47	148	-101
B04R04C16	4-16-4	Hs~Ref:NM_006351.1~uORF:IOH21740	56	142	-86
B04R04C17	4-17-4	Hs~MGC:BC008892.1~uORF:IOH6264	56	313	-257
B04R04C18	4-18-4	Hs~MGC:BC008892.1~uORF:IOH6264	47	180	-133
B04R04C19	4-19-4	Hs~MGC:BC013294.2~uORF:IOH13234	44	189	-145
B04R04C20	4-20-4	Hs~MGC:BC013294.2~uORF:IOH13234	47	178	-131
B04R04C21	4-21-4	Hs~Ref:NM_004094.2~uORF:IOH4059	54	220	-166
B04R04C22	4-22-4	Hs~Ref:NM_004094.2~uORF:IOH4059	63	327	-264
B04R05C01	4-1-5	Hs~Ref:NM_206909.1~uORF:IOH43255	10393	42	10351
B04R05C02	4-2-5	Hs~Ref:NM_206909.1~uORF:IOH43255	10549	42	10507
B04R05C03	4-3-5	Hs~Ref:NM_138430.3~uORF:IOH43468	353	41	312
B04R05C04	4-4-5	Hs~Ref:NM_138430.3~uORF:IOH43468	353	42	311
B04R05C05	4-5-5	Hs~Ref:NM_007278.1~uORF:IOH41289	1242	43	1199
B04R05C06	4-6-5	Hs~Ref:NM_007278.1~uORF:IOH41289	1233	47	1186
B04R05C07	4-7-5	Hs~Ref:NM_181514.1~uORF:IOH43068	238	65	173
B04R05C08	4-8-5	Hs~Ref:NM_181514.1~uORF:IOH43068	75	55	20
B04R05C09	4-9-5	Hs~MGC:NM_173471.1~uORF:IOH40179	133	50	83
B04R05C10	4-10-5	Hs~MGC:NM_173471.1~uORF:IOH40179	83	87	-4
B04R05C11	4-11-5	Hs~Ref:NM_001004306.1~uORF:IOH40085	1242	59	1183
B04R05C12	4-12-5	Hs~Ref:NM_001004306.1~uORF:IOH40085	1129	92	1037
B04R05C13	4-13-5	Hs~Ref:NM_207337.1~uORF:IOH40127	45	247	-202
B04R05C14	4-14-5	Hs~Ref:NM_207337.1~uORF:IOH40127	47	430	-383
B04R05C15	4-15-5	Hs~Ref:NM_001004300.1~uORF:IOH40180	47	269	-222
B04R05C16	4-16-5	Hs~Ref:NM_001004300.1~uORF:IOH40180	48	158	-110
B04R05C17	4-17-5	Hs~Ref:NM_006953.2~uORF:IOH40285	48	315	-267
B04R05C18	4-18-5	Hs~Ref:NM_006953.2~uORF:IOH40285	49	69	-20
B04R05C19	4-19-5	Hs~Ref:NM_178044.1~uORF:IOH40768	43	246	-203
B04R05C20	4-20-5	Hs~Ref:NM_178044.1~uORF:IOH40768	48	287	-239
B04R05C21	4-21-5	Hs~Ref:XM_376764.2~uORF:IOH40703	474	55	419
B04R05C22	4-22-5	Hs~Ref:XM_376764.2~uORF:IOH40703	55	272	-217
B04R06C01	4-1-6	Hs~Ref:NM_021821.2~uORF:IOH40909	293	43	250
B04R06C02	4-2-6	Hs~Ref:NM_021821.2~uORF:IOH40909	290	43	247
B04R06C03	4-3-6	Hs~Ref:NM_014508.2~uORF:IOH54737	610	42	568
B04R06C04	4-4-6	Hs~Ref:NM_014508.2~uORF:IOH54737	564	41	523
B04R06C05	4-5-6	Hs~Ref:NM_006010.2~uORF:IOH59542	324	42	282
B04R06C06	4-6-6	Hs~Ref:NM_006010.2~uORF:IOH59542	336	46	290
B04R06C07	4-7-6	Hs~Ref:NM_002451.3~uORF:IOH54928	1063	50	1013
B04R06C08	4-8-6	Hs~Ref:NM_002451.3~uORF:IOH54928	1075	49	1026
B04R06C09	4-9-6	Hs~Ref:NM_004862.2~uORF:IOH54666	622	49	573
B04R06C10	4-10-6	Hs~Ref:NM_004862.2~uORF:IOH54666	43	138	-95
B04R06C11	4-11-6	Hs~MGC:BC002568.1~uORF:IOH4051	198	110	88
B04R06C12	4-12-6	Hs~MGC:BC002568.1~uORF:IOH4051	392	67	325
B04R06C13	4-13-6	Hs~MGC:BC009820.2~uORF:IOH12615	1157	60	1097
B04R06C14	4-14-6	Hs~MGC:BC009820.2~uORF:IOH12615	56	74	-18
B04R06C15	4-15-6	Hs~MGC:BC022344.1~uORF:IOH14799	5189	157	5032
B04R06C16	4-16-6	Hs~MGC:BC022344.1~uORF:IOH14799	1752	359	1393
B04R06C17	4-17-6	Hs~Ref:NM_024946.1~uORF:IOH10395	53	607	-554
B04R06C18	4-18-6	Hs~Ref:NM_024946.1~uORF:IOH10395	57	322	-265
B04R06C19	4-19-6	Hs~MGC:BC003188.1~uORF:IOH4526	620	302	318
B04R06C20	4-20-6	Hs~MGC:BC003188.1~uORF:IOH4526	49	528	-479
B04R06C21	4-21-6	Hs~Ref:NM_006564.1~uORF:IOH22614	69	71	-2
B04R06C22	4-22-6	Hs~Ref:NM_006564.1~uORF:IOH22614	110	61	49
B04R07C01	4-1-7	Hs~Ref:NM_003944.2~uORF:IOH2324	267	45	222
B04R07C02	4-2-7	Hs~Ref:NM_003944.2~uORF:IOH2324	288	50	238
B04R07C03	4-3-7	Hs~MGC:NM_146421.1~uORF:IOH10710	475	44	431
B04R07C04	4-4-7	Hs~MGC:NM_146421.1~uORF:IOH10710	445	43	402
B04R07C05	4-5-7	Hs~Ref:NM_004845.3~uORF:IOH41138	226	48	178
B04R07C06	4-6-7	Hs~Ref:NM_004845.3~uORF:IOH41138	219	58	161
B04R07C07	4-7-7	Hs~Ref:NM_153757.1~uORF:IOH41339	378	51	327
B04R07C08	4-8-7	Hs~Ref:NM_153757.1~uORF:IOH41339	369	47	322
B04R07C09	4-9-7	Hs~Ref:NM_022347.1~uORF:IOH41552	351	52	299
B04R07C10	4-10-7	Hs~Ref:NM_022347.1~uORF:IOH41552	304	156	148
B04R07C11	4-11-7	Hs~Ref:NM_021071.2~uORF:IOH42492	41	49	-8
B04R07C12	4-12-7	Hs~Ref:NM_021071.2~uORF:IOH42492	44	151	-107
B04R07C13	4-13-7	Hs~Ref:NM_002003.2~uORF:IOH13613	1667	62	1605
B04R07C14	4-14-7	Hs~Ref:NM_002003.2~uORF:IOH13613	1175	129	1046
B04R07C15	4-15-7	Hs~Ref:NM_002974.1~uORF:IOH14839	46	190	-144
B04R07C16	4-16-7	Hs~Ref:NM_002974.1~uORF:IOH14839	45	90	-45
B04R07C17	4-17-7	Hs~MGC:BC025959.1~uORF:IOH14588	49	280	-231
B04R07C18	4-18-7	Hs~MGC:BC025959.1~uORF:IOH14588	66	354	-288
B04R07C19	4-19-7	Hs~MGC:BC024289.1~uORF:IOH14745	53095	99	52996
B04R07C20	4-20-7	Hs~MGC:BC024289.1~uORF:IOH14745	58650	70	58580
B04R07C21	4-21-7	Hs~MGC:BC078671.1~uORF:IOH63075	42269	68	42201
B04R07C22	4-22-7	Hs~MGC:BC078671.1~uORF:IOH63075	43094	63	43031
B04R08C01	4-1-8	Hs~MGC:BC044632.1~uORF:IOH62971	3455	45	3410
B04R08C02	4-2-8	Hs~MGC:BC044632.1~uORF:IOH62971	3180	47	3133
B04R08C03	4-3-8	Hs~Ref:NM_016230.3~uORF:IOH61410	1200	44	1156
B04R08C04	4-4-8	Hs~Ref:NM_016230.3~uORF:IOH61410	1107	44	1063
B04R08C05	4-5-8	Hs~MGC:BC040564.1~uORF:IOH62269	353	45	308
B04R08C06	4-6-8	Hs~MGC:BC040564.1~uORF:IOH62269	347	46	301
B04R08C07	4-7-8	Hs~Ref:NM_015938.2~uORF:IOH12752	466	44	422
B04R08C08	4-8-8	Hs~Ref:NM_015938.2~uORF:IOH12752	464	44	420
B04R08C09	4-9-8	Hs~MGC:BC009249.1~uORF:IOH12481	408	45	363
B04R08C10	4-10-8	Hs~MGC:BC009249.1~uORF:IOH12481	427	46	381
B04R08C11	4-11-8	Hs~Ref:NM_130788.1~uORF:IOH4842	679	47	632
B04R08C12	4-12-8	Hs~Ref:NM_130788.1~uORF:IOH4842	47	116	-69
B04R08C13	4-13-8	Hs~MGC:BC002360.1~uORF:IOH3606	50	115	-65
B04R08C14	4-14-8	Hs~MGC:BC002360.1~uORF:IOH3606	53	512	-459
B04R08C15	4-15-8	Hs~Ref:NM_138482.1~uORF:IOH12454	129	68	61
B04R08C16	4-16-8	Hs~Ref:NM_138482.1~uORF:IOH12454	69	69	0
B04R08C17	4-17-8	Hs~MGC:BC012783.2~uORF:IOH12579	120	75	45
B04R08C18	4-18-8	Hs~MGC:BC012783.2~uORF:IOH12579	51	176	-125
B04R08C19	4-19-8	Hs~MGC:BC009393.2~uORF:IOH12944	125	66	59
B04R08C20	4-20-8	Hs~MGC:BC009393.2~uORF:IOH12944	54	65	-11
B04R08C21	4-21-8	Hs~MGC:BC017869.1~uORF:IOH13888	59	89	-30
B04R08C22	4-22-8	Hs~MGC:BC017869.1~uORF:IOH13888	89	74	15
B04R09C01	4-1-9	Hs~MGC:BC070203.1~uORF:IOH40798	255	49	206
B04R09C02	4-2-9	Hs~MGC:BC070203.1~uORF:IOH40798	293	83	210
B04R09C03	4-3-9	Hs~Ref:NM_198490.1~uORF:IOH40675	404	43	361
B04R09C04	4-4-9	Hs~Ref:NM_198490.1~uORF:IOH40675	393	45	348
B04R09C05	4-5-9	Hs~Ref:NM_001004331.1~uORF:IOH40802	338	44	294
B04R09C06	4-6-9	Hs~Ref:NM_001004331.1~uORF:IOH40802	365	45	320
B04R09C07	4-7-9	Hs~MGC:BC022014.2~uORF:IOH56027	268	44	224
B04R09C08	4-8-9	Hs~MGC:BC022014.2~uORF:IOH56027	282	44	238
B04R09C09	4-9-9	Hs~MGC:BC043564.1~uORF:IOH26298	358	66	292
B04R09C10	4-10-9	Hs~MGC:BC043564.1~uORF:IOH26298	71	49	22
B04R09C11	4-11-9	Hs~MGC:BC041174.1~uORF:IOH26249	78	47	31
B04R09C12	4-12-9	Hs~MGC:BC041174.1~uORF:IOH26249	73	52	21
B04R09C13	4-13-9	Hs~MGC:BC044938.1~uORF:IOH26297	75	58	17
B04R09C14	4-14-9	Hs~MGC:BC044938.1~uORF:IOH26297	50	78	-28
B04R09C15	4-15-9	Hs~MGC:BC047869.1~uORF:IOH26925	90	69	21
B04R09C16	4-16-9	Hs~MGC:BC047869.1~uORF:IOH26925	54	82	-28
B04R09C17	4-17-9	Hs~Ref:NM_144492.1~uORF:IOH12590	44	119	-75
B04R09C18	4-18-9	Hs~Ref:NM_144492.1~uORF:IOH12590	171	169	2
B04R09C19	4-19-9	Hs~MGC:BC021245.2~uORF:IOH12158	51	136	-85
B04R09C20	4-20-9	Hs~MGC:BC021245.2~uORF:IOH12158	53	224	-171
B04R09C21	4-21-9	Hs~MGC:NM_152613.1~uORF:IOH10808	52	177	-125
B04R09C22	4-22-9	Hs~MGC:NM_152613.1~uORF:IOH10808	78	86	-8
B04R10C01	4-1-10	Hs~Ref:NM_015417.2~uORF:IOH11253	895	43	852
B04R10C02	4-2-10	Hs~Ref:NM_015417.2~uORF:IOH11253	935	45	890
B04R10C03	4-3-10	Hs~MGC:BC040732.1~uORF:IOH28779	389	44	345
B04R10C04	4-4-10	Hs~MGC:BC040732.1~uORF:IOH28779	393	48	345
B04R10C05	4-5-10	Hs~MGC:BC036917.1~uORF:IOH28736	416	44	372
B04R10C06	4-6-10	Hs~MGC:BC036917.1~uORF:IOH28736	394	43	351
B04R10C07	4-7-10	Hs~MGC:BC054033.1~uORF:IOH29124	312	44	268
B04R10C08	4-8-10	Hs~MGC:BC054033.1~uORF:IOH29124	290	46	244
B04R10C09	4-9-10	Hs~MGC:BC037957.1~uORF:IOH28753	234	47	187
B04R10C10	4-10-10	Hs~MGC:BC037957.1~uORF:IOH28753	574	51	523
B04R10C11	4-11-10	GST1	43	43	0
B04R10C12	4-12-10	GST1	47	44	3
B04R10C13	4-13-10	GST2	52	49	3
B04R10C14	4-14-10	GST2	46	51	-5
B04R10C15	4-15-10	GST3	50	48	2
B04R10C16	4-16-10	GST3	49	51	-2
B04R10C17	4-17-10	GST4	54	51	3
B04R10C18	4-18-10	GST4	50	49	1
B04R10C19	4-19-10	Anti-HumanIgA1~N/A	7042	52	6990
B04R10C20	4-20-10	Anti-HumanIgA1~N/A	5808	63	5745
B04R10C21	4-21-10	Anti-HumanIgA2~N/A	8676	69	8607
B04R10C22	4-22-10	Anti-HumanIgA2~N/A	12447	57	12390
B04R11C01	4-1-11	AlexaAntiMouseAb~N/A	23604	41	23563
B04R11C02	4-2-11	AlexaAntiMouseAb~N/A	21863	42	21821
B04R11C03	4-3-11	MAPKAP~N/A	151	46	105
B04R11C04	4-4-11	MAPKAP~N/A	99	44	55
B04R11C05	4-5-11	Buffer	196	44	152
B04R11C06	4-6-11	Buffer	134	43	91
B04R11C07	4-7-11	BSA~N/A	9576	42	9534
B04R11C08	4-8-11	BSA~N/A	9626	42	9584
B04R11C09	4-9-11	Anti-HumanIgG1~N/A	1634	43	1591
B04R11C10	4-10-11	Anti-HumanIgG1~N/A	1474	46	1428
B04R11C11	4-11-11	Anti-HumanIgG2~N/A	3054	45	3009
B04R11C12	4-12-11	Anti-HumanIgG2~N/A	2699	50	2649
B04R11C13	4-13-11	Anti-HumanIgG3~N/A	4951	50	4901
B04R11C14	4-14-11	Anti-HumanIgG3~N/A	4485	58	4427
B04R11C15	4-15-11	Anti-HumanIgG4~N/A	9454	56	9398
B04R11C16	4-16-11	Anti-HumanIgG4~N/A	7921	59	7862
B04R11C17	4-17-11	AntiBiotinAb~N/A	9944	56	9888
B04R11C18	4-18-11	AntiBiotinAb~N/A	10726	56	10670
B04R11C19	4-19-11	Buffer	224	54	170
B04R11C20	4-20-11	Buffer	53	48	5
B04R11C21	4-21-11	Hs~MGC:BC020602.1~uORF:IOH23062	242	53	189
B04R11C22	4-22-11	Hs~MGC:BC020602.1~uORF:IOH23062	122	60	62
B04R12C01	4-1-12	Hs~MGC:BC053533.1~uORF:IOH28925	282	45	237
B04R12C02	4-2-12	Hs~MGC:BC053533.1~uORF:IOH28925	284	46	238
B04R12C03	4-3-12	Hs~MGC:BC056398.1~uORF:IOH28786	395	49	346
B04R12C04	4-4-12	Hs~MGC:BC056398.1~uORF:IOH28786	353	50	303
B04R12C05	4-5-12	Hs~MGC:BC051849.2~uORF:IOH28888	344	45	299
B04R12C06	4-6-12	Hs~MGC:BC051849.2~uORF:IOH28888	335	44	291
B04R12C07	4-7-12	Hs~Ref:NM_175733.2~uORF:IOH26388	642	43	599
B04R12C08	4-8-12	Hs~Ref:NM_175733.2~uORF:IOH26388	544	43	501
B04R12C09	4-9-12	Hs~Ref:NM_005254.3~uORF:IOH27031	467	45	422
B04R12C10	4-10-12	Hs~Ref:NM_005254.3~uORF:IOH27031	482	53	429
B04R12C11	4-11-12	Hs~Ref:NM_139246.3~uORF:IOH27557	695	63	632
B04R12C12	4-12-12	Hs~Ref:NM_139246.3~uORF:IOH27557	755	46	709
B04R12C13	4-13-12	Hs~Ref:NM_004997.2~uORF:IOH26421	4953	57	4896
B04R12C14	4-14-12	Hs~Ref:NM_004997.2~uORF:IOH26421	3193	70	3123
B04R12C15	4-15-12	Hs~MGC:BC033818.1~uORF:IOH21869	62	69	-7
B04R12C16	4-16-12	Hs~MGC:BC033818.1~uORF:IOH21869	48	81	-33
B04R12C17	4-17-12	Hs~MGC:NM_152653.1~uORF:IOH13176	468	66	402
B04R12C18	4-18-12	Hs~MGC:NM_152653.1~uORF:IOH13176	440	74	366
B04R12C19	4-19-12	Hs~Ref:NM_006886.2~uORF:IOH3903	61	75	-14
B04R12C20	4-20-12	Hs~Ref:NM_006886.2~uORF:IOH3903	161	75	86
B04R12C21	4-21-12	Hs~Ref:NM_145044.1~uORF:IOH10819	140	68	72
B04R12C22	4-22-12	Hs~Ref:NM_145044.1~uORF:IOH10819	162	79	83
B04R13C01	4-1-13	Hs~MGC:BC029480.1~uORF:IOH23188	728	42	686
B04R13C02	4-2-13	Hs~MGC:BC029480.1~uORF:IOH23188	717	44	673
B04R13C03	4-3-13	Hs~Ref:NM_004332.1~uORF:IOH60535	465	51	414
B04R13C04	4-4-13	Hs~Ref:NM_004332.1~uORF:IOH60535	489	58	431
B04R13C05	4-5-13	Hs~MGC:BC094726.1~uORF:IOH62681	753	44	709
B04R13C06	4-6-13	Hs~MGC:BC094726.1~uORF:IOH62681	757	42	715
B04R13C07	4-7-13	Hs~MGC:NM_174922.3~uORF:IOH22636	281	43	238
B04R13C08	4-8-13	Hs~MGC:NM_174922.3~uORF:IOH22636	286	46	240
B04R13C09	4-9-13	Hs~Ref:NM_014752.1~uORF:IOH5878	421	46	375
B04R13C10	4-10-13	Hs~Ref:NM_014752.1~uORF:IOH5878	407	51	356
B04R13C11	4-11-13	Hs~Ref:NM_022572.1~uORF:IOH6351	86	52	34
B04R13C12	4-12-13	Hs~Ref:NM_022572.1~uORF:IOH6351	90	49	41
B04R13C13	4-13-13	Hs~MGC:BC004369.1~uORF:IOH5590	131	55	76
B04R13C14	4-14-13	Hs~MGC:BC004369.1~uORF:IOH5590	44	134	-90
B04R13C15	4-15-13	Hs~Ref:NM_006923.2~uORF:IOH4099	67	58	9
B04R13C16	4-16-13	Hs~Ref:NM_006923.2~uORF:IOH4099	182	66	116
B04R13C17	4-17-13	Hs~Ref:NM_198538.1~uORF:IOH39839	117	87	30
B04R13C18	4-18-13	Hs~Ref:NM_198538.1~uORF:IOH39839	60	104	-44
B04R13C19	4-19-13	Hs~Ref:NM_015920.3~uORF:IOH57353	63	146	-83
B04R13C20	4-20-13	Hs~Ref:NM_015920.3~uORF:IOH57353	51	108	-57
B04R13C21	4-21-13	Hs~Ref:NM_002432.1~uORF:IOH21730	51	79	-28
B04R13C22	4-22-13	Hs~Ref:NM_002432.1~uORF:IOH21730	47	67	-20
B04R14C01	4-1-14	Hs~MGC:BC014409.1~uORF:IOH13355	588	43	545
B04R14C02	4-2-14	Hs~MGC:BC014409.1~uORF:IOH13355	582	47	535
B04R14C03	4-3-14	Hs~Ref:NM_003385.4~uORF:IOH59016	168	55	113
B04R14C04	4-4-14	Hs~Ref:NM_003385.4~uORF:IOH59016	161	78	83
B04R14C05	4-5-14	Hs~Ref:NM_032467.1~uORF:IOH53453	794	43	751
B04R14C06	4-6-14	Hs~Ref:NM_032467.1~uORF:IOH53453	737	40	697
B04R14C07	4-7-14	Hs~Ref:NM_178550.3~uORF:IOH59725	865	42	823
B04R14C08	4-8-14	Hs~Ref:NM_178550.3~uORF:IOH59725	853	43	810
B04R14C09	4-9-14	Hs~Ref:NM_000298.4~uORF:IOH11862	404	43	361
B04R14C10	4-10-14	Hs~Ref:NM_000298.4~uORF:IOH11862	435	44	391
B04R14C11	4-11-14	Hs~Ref:NM_020423.1~N/A	68	42	26
B04R14C12	4-12-14	Hs~Ref:NM_020423.1~N/A	56	45	11
B04R14C13	4-13-14	Hs~Ref:NM_004304.2~N/A	59	44	15
B04R14C14	4-14-14	Hs~Ref:NM_004304.2~N/A	55	46	9
B04R14C15	4-15-14	Hs~Ref:NM_006891.2~uORF:IOH59488	298	47	251
B04R14C16	4-16-14	Hs~Ref:NM_006891.2~uORF:IOH59488	252	53	199
B04R14C17	4-17-14	Hs~Ref:NM_032975.2~uORF:IOH52620	1043	155	888
B04R14C18	4-18-14	Hs~Ref:NM_032975.2~uORF:IOH52620	904	152	752
B04R14C19	4-19-14	Hs~MGC:BC059361.1~uORF:IOH29207	75	145	-70
B04R14C20	4-20-14	Hs~MGC:BC059361.1~uORF:IOH29207	50	163	-113
B04R14C21	4-21-14	Hs~Ref:NM_001004354.1~uORF:IOH29006	5213	62	5151
B04R14C22	4-22-14	Hs~Ref:NM_001004354.1~uORF:IOH29006	4902	61	4841
B04R15C01	4-1-15	Hs~MGC:BC054004.1~uORF:IOH29012	512	50	462
B04R15C02	4-2-15	Hs~MGC:BC054004.1~uORF:IOH29012	505	50	455
B04R15C03	4-3-15	Hs~MGC:BC011419.1~uORF:IOH9719	426	44	382
B04R15C04	4-4-15	Hs~MGC:BC011419.1~uORF:IOH9719	430	43	387
B04R15C05	4-5-15	Hs~MGC:NM_182554.1~uORF:IOH11558	376	42	334
B04R15C06	4-6-15	Hs~MGC:NM_182554.1~uORF:IOH11558	364	41	323
B04R15C07	4-7-15	Hs~Ref:NM_012113.1~uORF:IOH27401	315	42	273
B04R15C08	4-8-15	Hs~Ref:NM_012113.1~uORF:IOH27401	379	42	337
B04R15C09	4-9-15	Hs~MGC:BC031231.1~uORF:IOH27515	821	41	780
B04R15C10	4-10-15	Hs~MGC:BC031231.1~uORF:IOH27515	830	41	789
B04R15C11	4-11-15	Hs~MGC:NM_153356.1~uORF:IOH27369	358	43	315
B04R15C12	4-12-15	Hs~MGC:NM_153356.1~uORF:IOH27369	371	45	326
B04R15C13	4-13-15	Hs~Ref:NM_002497.1~CAT:PV3360	451	49	402
B04R15C14	4-14-15	Hs~Ref:NM_002497.1~CAT:PV3360	192	46	146
B04R15C15	4-15-15	Hs~Ref:NM_005734.1~CAT:PV4209	86	49	37
B04R15C16	4-16-15	Hs~Ref:NM_005734.1~CAT:PV4209	71	51	20
B04R15C17	4-17-15	Hs~Ref:NM_003157.1~CAT:PV4315	210	47	163
B04R15C18	4-18-15	Hs~Ref:NM_003157.1~CAT:PV4315	51	52	-1
B04R15C19	4-19-15	Hs~Ref:NM_139012.1~CAT:PV3304	62	51	11
B04R15C20	4-20-15	Hs~Ref:NM_139012.1~CAT:PV3304	62	53	9
B04R15C21	4-21-15	Hs~Ref:NP_694592~CAT:P3042	104	52	52
B04R15C22	4-22-15	Hs~Ref:NP_694592~CAT:P3042	45	58	-13
B04R16C01	4-1-16	Hs~IVGN:NM_000572~CAT_PHC0105~N/A	46	52	-6
B04R16C02	4-2-16	Hs~IVGN:NM_000572~CAT_PHC0105~N/A	42	53	-11
B04R16C03	4-3-16	Hs~IVGN:NM_001190942~CAT_PHC1634~N/A	620	43	577
B04R16C04	4-4-16	Hs~IVGN:NM_001190942~CAT_PHC1634~N/A	606	41	565
B04R16C05	4-5-16	Hs~Ref:NM_002645.1~CAT:PV5586	365	41	324
B04R16C06	4-6-16	Hs~Ref:NM_002645.1~CAT:PV5586	377	41	336
B04R16C07	4-7-16	Hs~Ref:NM_003418.1~uORF:IOH59002	707	41	666
B04R16C08	4-8-16	Hs~Ref:NM_003418.1~uORF:IOH59002	680	41	639
B04R16C09	4-9-16	Hs~Ref:NM_134440.1~uORF:IOH40949	339	42	297
B04R16C10	4-10-16	Hs~Ref:NM_134440.1~uORF:IOH40949	338	43	295
B04R16C11	4-11-16	Hs~Ref:NM_001033.2~uORF:IOH61121	293	45	248
B04R16C12	4-12-16	Hs~Ref:NM_001033.2~uORF:IOH61121	274	48	226
B04R16C13	4-13-16	Hs~Ref:NM_170775.1~uORF:IOH43500	435	44	391
B04R16C14	4-14-16	Hs~Ref:NM_170775.1~uORF:IOH43500	65	49	16
B04R16C15	4-15-16	Hs~Ref:NM_014473.2~uORF:IOH9851	1005	52	953
B04R16C16	4-16-16	Hs~Ref:NM_014473.2~uORF:IOH9851	50	79	-29
B04R16C17	4-17-16	Hs~MGC:BC004549.2~uORF:IOH6358	167	53	114
B04R16C18	4-18-16	Hs~MGC:BC004549.2~uORF:IOH6358	65	57	8
B04R16C19	4-19-16	Hs~Ref:NM_016101.3~uORF:IOH10163	216	50	166
B04R16C20	4-20-16	Hs~Ref:NM_016101.3~uORF:IOH10163	51	64	-13
B04R16C21	4-21-16	Hs~MGC:BC020810.1~uORF:IOH27927	49	103	-54
B04R16C22	4-22-16	Hs~MGC:BC020810.1~uORF:IOH27927	46	121	-75
B04R17C01	4-1-17	Hs~MGC:BC028721.2~uORF:IOH11718	48	48	0
B04R17C02	4-2-17	Hs~MGC:BC028721.2~uORF:IOH11718	641	55	586
B04R17C03	4-3-17	Hs~MGC:BC028123.1~uORF:IOH11565	146	50	96
B04R17C04	4-4-17	Hs~MGC:BC028123.1~uORF:IOH11565	311	46	265
B04R17C05	4-5-17	Hs~Ref:NM_001738.1~uORF:IOH11391	319	44	275
B04R17C06	4-6-17	Hs~Ref:NM_001738.1~uORF:IOH11391	284	43	241
B04R17C07	4-7-17	Hs~Ref:NM_000687.1~uORF:IOH14308	246	42	204
B04R17C08	4-8-17	Hs~Ref:NM_000687.1~uORF:IOH14308	283	42	241
B04R17C09	4-9-17	Hs~MGC:BC007206.1~uORF:IOH6600	167	51	116
B04R17C10	4-10-17	Hs~MGC:BC007206.1~uORF:IOH6600	183	47	136
B04R17C11	4-11-17	Hs~Ref:NM_024068.1~uORF:IOH6654	540	46	494
B04R17C12	4-12-17	Hs~Ref:NM_024068.1~uORF:IOH6654	534	47	487
B04R17C13	4-13-17	Hs~Ref:NM_001659.1~uORF:IOH6999	164	50	114
B04R17C14	4-14-17	Hs~Ref:NM_001659.1~uORF:IOH6999	138	66	72
B04R17C15	4-15-17	Hs~MGC:BC004117.1~uORF:IOH5657	76	45	31
B04R17C16	4-16-17	Hs~MGC:BC004117.1~uORF:IOH5657	55	47	8
B04R17C17	4-17-17	Hs~MGC:BC036452.1~uORF:IOH22480	383	51	332
B04R17C18	4-18-17	Hs~MGC:BC036452.1~uORF:IOH22480	320	64	256
B04R17C19	4-19-17	Hs~MGC:BC006177.1~uORF:IOH6666	199	59	140
B04R17C20	4-20-17	Hs~MGC:BC006177.1~uORF:IOH6666	125	66	59
B04R17C21	4-21-17	Hs~Ref:NM_004456.2~uORF:IOH9963	169	65	104
B04R17C22	4-22-17	Hs~Ref:NM_004456.2~uORF:IOH9963	47	83	-36
B04R18C01	4-1-18	Hs~MGC:BC002914.1~uORF:IOH5733	10915	65	10850
B04R18C02	4-2-18	Hs~MGC:BC002914.1~uORF:IOH5733	6897	66	6831
B04R18C03	4-3-18	Hs~MGC:BC072669.1~uORF:IOH61804	14048	52	13996
B04R18C04	4-4-18	Hs~MGC:BC072669.1~uORF:IOH61804	14024	51	13973
B04R18C05	4-5-18	Hs~Ref:NM_030926.4~uORF:IOH62764	220	49	171
B04R18C06	4-6-18	Hs~Ref:NM_030926.4~uORF:IOH62764	171	75	96
B04R18C07	4-7-18	Hs~MGC:BC096097.2~uORF:IOH63199	123	42	81
B04R18C08	4-8-18	Hs~MGC:BC096097.2~uORF:IOH63199	111	45	66
B04R18C09	4-9-18	Hs~MGC:BC096280.2~uORF:IOH63267	371	88	283
B04R18C10	4-10-18	Hs~MGC:BC096280.2~uORF:IOH63267	369	63	306
B04R18C11	4-11-18	Hs~Ref:NM_003363.2~uORF:IOH39442	461	50	411
B04R18C12	4-12-18	Hs~Ref:NM_003363.2~uORF:IOH39442	478	53	425
B04R18C13	4-13-18	Hs~Ref:NM_004766.1~uORF:IOH3540	735	56	679
B04R18C14	4-14-18	Hs~Ref:NM_004766.1~uORF:IOH3540	718	55	663
B04R18C15	4-15-18	Hs~Ref:NM_080840.1~uORF:IOH11085	736	46	690
B04R18C16	4-16-18	Hs~Ref:NM_080840.1~uORF:IOH11085	524	48	476
B04R18C17	4-17-18	Hs~Ref:NM_032490.2~uORF:IOH11134	56	62	-6
B04R18C18	4-18-18	Hs~Ref:NM_032490.2~uORF:IOH11134	65	72	-7
B04R18C19	4-19-18	Hs~MGC:BC044582.1~uORF:IOH62427	231	130	101
B04R18C20	4-20-18	Hs~MGC:BC044582.1~uORF:IOH62427	44	239	-195
B04R18C21	4-21-18	Hs~MGC:BC073977.1~uORF:IOH61809	57	101	-44
B04R18C22	4-22-18	Hs~MGC:BC073977.1~uORF:IOH61809	83	60	23
B04R19C01	4-1-19	Hs~MGC:BC047438.1~uORF:IOH62395	730	79	651
B04R19C02	4-2-19	Hs~MGC:BC047438.1~uORF:IOH62395	495	97	398
B04R19C03	4-3-19	Hs~MGC:BC065555.1~uORF:IOH61585	291	154	137
B04R19C04	4-4-19	Hs~MGC:BC065555.1~uORF:IOH61585	166	67	99
B04R19C05	4-5-19	Hs~Ref:NM_024482.1~uORF:IOH4000	120	69	51
B04R19C06	4-6-19	Hs~Ref:NM_024482.1~uORF:IOH4000	132	55	77
B04R19C07	4-7-19	Hs~Ref:NM_032643.3~uORF:IOH3821	97	50	47
B04R19C08	4-8-19	Hs~Ref:NM_032643.3~uORF:IOH3821	318	52	266
B04R19C09	4-9-19	Hs~Ref:NM_004526.2~uORF:IOH6721	134	64	70
B04R19C10	4-10-19	Hs~Ref:NM_004526.2~uORF:IOH6721	167	65	102
B04R19C11	4-11-19	Hs~MGC:BC023288.1~uORF:IOH28628	4193	142	4051
B04R19C12	4-12-19	Hs~MGC:BC023288.1~uORF:IOH28628	431	96	335
B04R19C13	4-13-19	Hs~Ref:NM_000584.2~uORF:IOH58939	326	75	251
B04R19C14	4-14-19	Hs~Ref:NM_000584.2~uORF:IOH58939	208	58	150
B04R19C15	4-15-19	Hs~MGC:BC037863.1~uORF:IOH62291	64	52	12
B04R19C16	4-16-19	Hs~MGC:BC037863.1~uORF:IOH62291	40	52	-12
B04R19C17	4-17-19	Hs~MGC:BC066324.1~uORF:IOH61478	49	44	5
B04R19C18	4-18-19	Hs~MGC:BC066324.1~uORF:IOH61478	77	88	-11
B04R19C19	4-19-19	Hs~MGC:BC062437.1~uORF:IOH62819	60	63	-3
B04R19C20	4-20-19	Hs~MGC:BC062437.1~uORF:IOH62819	53	62	-9
B04R19C21	4-21-19	Hs~MGC:BC021258.1~uORF:IOH14670	74	55	19
B04R19C22	4-22-19	Hs~MGC:BC021258.1~uORF:IOH14670	145	56	89
B04R20C01	4-1-20	Hs~Ref:NM_138820.1~uORF:IOH4234	464	197	267
B04R20C02	4-2-20	Hs~Ref:NM_138820.1~uORF:IOH4234	479	151	328
B04R20C03	4-3-20	Hs~MGC:BC001286.1~uORF:IOH3272	471	53	418
B04R20C04	4-4-20	Hs~MGC:BC001286.1~uORF:IOH3272	120	51	69
B04R20C05	4-5-20	Hs~MGC:BC015535.1~uORF:IOH11057	262	62	200
B04R20C06	4-6-20	Hs~MGC:BC015535.1~uORF:IOH11057	155	90	65
B04R20C07	4-7-20	Hs~Ref:NM_014009.2~uORF:IOH43597	267	81	186
B04R20C08	4-8-20	Hs~Ref:NM_014009.2~uORF:IOH43597	262	99	163
B04R20C09	4-9-20	Hs~Ref:NM_001024646.1~uORF:IOH58964	114	68	46
B04R20C10	4-10-20	Hs~Ref:NM_001024646.1~uORF:IOH58964	55	68	-13
B04R20C11	4-11-20	Hs~Ref:NM_001018025.2~uORF:IOH58944	49	61	-12
B04R20C12	4-12-20	Hs~Ref:NM_001018025.2~uORF:IOH58944	50	53	-3
B04R20C13	4-13-20	Hs~MGC:BC033864.1~uORF:IOH21842	55	56	-1
B04R20C14	4-14-20	Hs~MGC:BC033864.1~uORF:IOH21842	41	43	-2
B04R20C15	4-15-20	Hs~Ref:NM_152594.1~uORF:IOH35769	334	51	283
B04R20C16	4-16-20	Hs~Ref:NM_152594.1~uORF:IOH35769	112	56	56
B04R20C17	4-17-20	Hs~Ref:XM_378660.1~uORF:IOH44637	2648	139	2509
B04R20C18	4-18-20	Hs~Ref:XM_378660.1~uORF:IOH44637	75	126	-51
B04R20C19	4-19-20	Hs~Ref:NM_198590.1~uORF:IOH45575	75	86	-11
B04R20C20	4-20-20	Hs~Ref:NM_198590.1~uORF:IOH45575	64	58	6
B04R20C21	4-21-20	Hs~Ref:NM_004816.2~uORF:IOH35782	52	62	-10
B04R20C22	4-22-20	Hs~Ref:NM_004816.2~uORF:IOH35782	50	67	-17
B04R21C01	4-1-21	Hs~Ref:NM_080926.1~uORF:IOH50158	980	700	280
B04R21C02	4-2-21	Hs~Ref:NM_080926.1~uORF:IOH50158	998	60	938
B04R21C03	4-3-21	Hs~Ref:NM_206967.1~uORF:IOH50131	321	57	264
B04R21C04	4-4-21	Hs~Ref:NM_206967.1~uORF:IOH50131	306	59	247
B04R21C05	4-5-21	Hs~Ref:BC026014~uORF:IOH50079	748	317	431
B04R21C06	4-6-21	Hs~Ref:BC026014~uORF:IOH50079	645	141	504
B04R21C07	4-7-21	Hs~Ref:NM_001014977.1~uORF:IOH50164	640	475	165
B04R21C08	4-8-21	Hs~Ref:NM_001014977.1~uORF:IOH50164	593	68	525
B04R21C09	4-9-21	Hs~Ref:NP_000604.1~CAT_10870-H08H-25	78	51	27
B04R21C10	4-10-21	Hs~Ref:NP_000604.1~CAT_10870-H08H-25	71	53	18
B04R21C11	4-11-21	Internal_1007209	95	54	41
B04R21C12	4-12-21	Internal_1007209	104	64	40
B04R21C13	4-13-21	Hs~Ref:NP_000561.3~CAT_11046-H08H-25	73	49	24
B04R21C14	4-14-21	Hs~Ref:NP_000561.3~CAT_11046-H08H-25	175	54	121
B04R21C15	4-15-21	Internal_1007209	65	54	11
B04R21C16	4-16-21	Internal_1007209	55	52	3
B04R21C17	4-17-21	Hs~Ref:P15509-1~CAT_10701-H08H-25	47	53	-6
B04R21C18	4-18-21	Hs~Ref:P15509-1~CAT_10701-H08H-25	44	50	-6
B04R21C19	4-19-21	Internal_1007209	89	55	34
B04R21C20	4-20-21	Internal_1007209	46	53	-7
B04R21C21	4-21-21	Internal_1007209	48	50	-2
B04R21C22	4-22-21	Internal_1007209	47	50	-3
B04R22C01	4-1-22	ERa~N/A	2109	598	1511
B04R22C02	4-2-22	ERa~N/A	1487	50	1437
B04R22C03	4-3-22	PKCeta~N/A	220	71	149
B04R22C04	4-4-22	PKCeta~N/A	50	51	-1
B04R22C05	4-5-22	Calmodulin~N/A	63	48	15
B04R22C06	4-6-22	Calmodulin~N/A	201	58	143
B04R22C07	4-7-22	V5control5~N/A	159	50	109
B04R22C08	4-8-22	V5control5~N/A	192	51	141
B04R22C09	4-9-22	V5control4~N/A	53	55	-2
B04R22C10	4-10-22	V5control4~N/A	59	53	6
B04R22C11	4-11-22	V5control3~N/A	99	71	28
B04R22C12	4-12-22	V5control3~N/A	100	63	37
B04R22C13	4-13-22	V5control2~N/A	64	55	9
B04R22C14	4-14-22	V5control2~N/A	156	62	94
B04R22C15	4-15-22	V5control1~N/A	55	51	4
B04R22C16	4-16-22	V5control1~N/A	69	50	19
B04R22C17	4-17-22	CMK2A~N/A	210	51	159
B04R22C18	4-18-22	CMK2A~N/A	750	87	663
B04R22C19	4-19-22	ERa~N/A	929	100	829
B04R22C20	4-20-22	ERa~N/A	50	73	-23
B04R22C21	4-21-22	AlexaAntiMouseAb~N/A	8654	53	8601
B04R22C22	4-22-22	AlexaAntiMouseAb~N/A	7900	51	7849
B05R01C01	5-1-1	AlexaAntiMouseAb~N/A	39787	37	39750
B05R01C02	5-2-1	AlexaAntiMouseAb~N/A	32692	36	32656
B05R01C03	5-3-1	ERa~N/A	1799	35	1764
B05R01C04	5-4-1	ERa~N/A	1911	36	1875
B05R01C05	5-5-1	HumanIgG1~N/A	1079	35	1044
B05R01C06	5-6-1	HumanIgG1~N/A	1064	36	1028
B05R01C07	5-7-1	HumanIgG2~N/A	3369	35	3334
B05R01C08	5-8-1	HumanIgG2~N/A	3304	35	3269
B05R01C09	5-9-1	HumanIgG3~N/A	15396	37	15359
B05R01C10	5-10-1	HumanIgG3~N/A	15732	37	15695
B05R01C11	5-11-1	HumanIgG4~N/A	41508	38	41470
B05R01C12	5-12-1	HumanIgG4~N/A	43049	38	43011
B05R01C13	5-13-1	BiotinAb~N/A	324	36	288
B05R01C14	5-14-1	BiotinAb~N/A	259	39	220
B05R01C15	5-15-1	RanBP2deltaFG~N/A	302	45	257
B05R01C16	5-16-1	RanBP2deltaFG~N/A	305	47	258
B05R01C17	5-17-1	hMDM2~N/A	909	51	858
B05R01C18	5-18-1	hMDM2~N/A	760	51	709
B05R01C19	5-19-1	PKCeta~N/A	536	49	487
B05R01C20	5-20-1	PKCeta~N/A	550	57	493
B05R01C21	5-21-1	AlexaAntiMouseAb~N/A	37074	66	37008
B05R01C22	5-22-1	AlexaAntiMouseAb~N/A	40762	60	40702
B05R02C01	5-1-2	PKCeta~N/A	1148	35	1113
B05R02C02	5-2-2	PKCeta~N/A	1212	36	1176
B05R02C03	5-3-2	Buffer	233	38	195
B05R02C04	5-4-2	Buffer	232	68	164
B05R02C05	5-5-2	HumanIgA~N/A	19716	40	19676
B05R02C06	5-6-2	HumanIgA~N/A	20782	39	20743
B05R02C07	5-7-2	Buffer	274	37	237
B05R02C08	5-8-2	Buffer	284	41	243
B05R02C09	5-9-2	BSA~N/A	12971	36	12935
B05R02C10	5-10-2	BSA~N/A	12483	37	12446
B05R02C11	5-11-2	Hs~Ref:NM_024540.2~uORF:IOH14529	418	38	380
B05R02C12	5-12-2	Hs~Ref:NM_024540.2~uORF:IOH14529	358	39	319
B05R02C13	5-13-2	Hs~MGC:BC015628.1~uORF:IOH13638	360	46	314
B05R02C14	5-14-2	Hs~MGC:BC015628.1~uORF:IOH13638	204	42	162
B05R02C15	5-15-2	Hs~MGC:BC026955.1~uORF:IOH11904	374	91	283
B05R02C16	5-16-2	Hs~MGC:BC026955.1~uORF:IOH11904	366	48	318
B05R02C17	5-17-2	Hs~MGC:BC015674.1~uORF:IOH13800	603	54	549
B05R02C18	5-18-2	Hs~MGC:BC015674.1~uORF:IOH13800	528	66	462
B05R02C19	5-19-2	Hs~Ref:NM_173579.1~uORF:IOH42346	195	73	122
B05R02C20	5-20-2	Hs~Ref:NM_173579.1~uORF:IOH42346	242	67	175
B05R02C21	5-21-2	Hs~Ref:NM_020473.1~uORF:IOH42225	227	104	123
B05R02C22	5-22-2	Hs~Ref:NM_020473.1~uORF:IOH42225	200	117	83
B05R03C01	5-1-3	Hs~Ref:NM_153044.1~uORF:IOH43644	284	37	247
B05R03C02	5-2-3	Hs~Ref:NM_153044.1~uORF:IOH43644	269	39	230
B05R03C03	5-3-3	Hs~Ref:NM_197973.2~uORF:IOH42306	177	43	134
B05R03C04	5-4-3	Hs~Ref:NM_197973.2~uORF:IOH42306	258	135	123
B05R03C05	5-5-3	Hs~MGC:NM_177559.2~uORF:IOH13704	1428	42	1386
B05R03C06	5-6-3	Hs~MGC:NM_177559.2~uORF:IOH13704	1456	38	1418
B05R03C07	5-7-3	Hs~MGC:BC037399.1~uORF:IOH27382	139	57	82
B05R03C08	5-8-3	Hs~MGC:BC037399.1~uORF:IOH27382	136	56	80
B05R03C09	5-9-3	Hs~MGC:BC045809.1~uORF:IOH26434	108	36	72
B05R03C10	5-10-3	Hs~MGC:BC045809.1~uORF:IOH26434	103	36	67
B05R03C11	5-11-3	Hs~MGC:BC013708.1~uORF:IOH25782	436	39	397
B05R03C12	5-12-3	Hs~MGC:BC013708.1~uORF:IOH25782	411	41	370
B05R03C13	5-13-3	Hs~MGC:BC009047.1~uORF:IOH9807	533	41	492
B05R03C14	5-14-3	Hs~MGC:BC009047.1~uORF:IOH9807	460	41	419
B05R03C15	5-15-3	Hs~Ref:NM_014366.1~uORF:IOH4189	555	52	503
B05R03C16	5-16-3	Hs~Ref:NM_014366.1~uORF:IOH4189	539	49	490
B05R03C17	5-17-3	Hs~MGC:BC001256.1~uORF:IOH3240	599	153	446
B05R03C18	5-18-3	Hs~MGC:BC001256.1~uORF:IOH3240	414	71	343
B05R03C19	5-19-3	Hs~MGC:BC001694.1~uORF:IOH3865	744	103	641
B05R03C20	5-20-3	Hs~MGC:BC001694.1~uORF:IOH3865	794	657	137
B05R03C21	5-21-3	Hs~MGC:BC029796.1~uORF:IOH22647	13572	76	13496
B05R03C22	5-22-3	Hs~MGC:BC029796.1~uORF:IOH22647	11975	64	11911
B05R04C01	5-1-4	Hs~MGC:BC029775.1~uORF:IOH22665	319	53	266
B05R04C02	5-2-4	Hs~MGC:BC029775.1~uORF:IOH22665	297	60	237
B05R04C03	5-3-4	Hs~MGC:BC029057.1~uORF:IOH22662	403	48	355
B05R04C04	5-4-4	Hs~MGC:BC029057.1~uORF:IOH22662	400	44	356
B05R04C05	5-5-4	Hs~Ref:NM_024791.2~uORF:IOH22680	628	36	592
B05R04C06	5-6-4	Hs~Ref:NM_024791.2~uORF:IOH22680	629	36	593
B05R04C07	5-7-4	Hs~MGC:BC003608.1~uORF:IOH4641	618	40	578
B05R04C08	5-8-4	Hs~MGC:BC003608.1~uORF:IOH4641	610	40	570
B05R04C09	5-9-4	Hs~Ref:NM_133487.1~uORF:IOH4038	298	37	261
B05R04C10	5-10-4	Hs~Ref:NM_133487.1~uORF:IOH4038	302	42	260
B05R04C11	5-11-4	Hs~MGC:BC003166.1~uORF:IOH5044	84	44	40
B05R04C12	5-12-4	Hs~MGC:BC003166.1~uORF:IOH5044	82	46	36
B05R04C13	5-13-4	Hs~Ref:NM_002156.1~uORF:IOH5036	271	123	148
B05R04C14	5-14-4	Hs~Ref:NM_002156.1~uORF:IOH5036	165	45	120
B05R04C15	5-15-4	Hs~MGC:BC017957.1~uORF:IOH12295	483	42	441
B05R04C16	5-16-4	Hs~MGC:BC017957.1~uORF:IOH12295	537	155	382
B05R04C17	5-17-4	Hs~Ref:NM_031482.3~uORF:IOH22840	185	131	54
B05R04C18	5-18-4	Hs~Ref:NM_031482.3~uORF:IOH22840	191	57	134
B05R04C19	5-19-4	Hs~Ref:NM_017986.2~uORF:IOH39818	130	56	74
B05R04C20	5-20-4	Hs~Ref:NM_017986.2~uORF:IOH39818	61	71	-10
B05R04C21	5-21-4	Hs~Ref:NM_144717.2~uORF:IOH40859	140	47	93
B05R04C22	5-22-4	Hs~Ref:NM_144717.2~uORF:IOH40859	161	61	100
B05R05C01	5-1-5	Hs~Ref:NM_138414.1~uORF:IOH10524	1049	58	991
B05R05C02	5-2-5	Hs~Ref:NM_138414.1~uORF:IOH10524	1078	53	1025
B05R05C03	5-3-5	Hs~MGC:BC026058.1~uORF:IOH13488	397	38	359
B05R05C04	5-4-5	Hs~MGC:BC026058.1~uORF:IOH13488	392	38	354
B05R05C05	5-5-5	Hs~MGC:BC007557.1~uORF:IOH6840	391	36	355
B05R05C06	5-6-5	Hs~MGC:BC007557.1~uORF:IOH6840	398	38	360
B05R05C07	5-7-5	Hs~Ref:NM_002298.2~uORF:IOH5905	196	121	75
B05R05C08	5-8-5	Hs~Ref:NM_002298.2~uORF:IOH5905	271	110	161
B05R05C09	5-9-5	Hs~MGC:BC047060.1~uORF:IOH26535	239	39	200
B05R05C10	5-10-5	Hs~MGC:BC047060.1~uORF:IOH26535	177	43	134
B05R05C11	5-11-5	Hs~MGC:NM_173545.1~uORF:IOH26160	237	50	187
B05R05C12	5-12-5	Hs~MGC:NM_173545.1~uORF:IOH26160	227	46	181
B05R05C13	5-13-5	Hs~MGC:BC040949.1~uORF:IOH26268	850	49	801
B05R05C14	5-14-5	Hs~MGC:BC040949.1~uORF:IOH26268	832	42	790
B05R05C15	5-15-5	Hs~MGC:BC048299.1~uORF:IOH26615	2942	40	2902
B05R05C16	5-16-5	Hs~MGC:BC048299.1~uORF:IOH26615	2886	45	2841
B05R05C17	5-17-5	Hs~Ref:NM_004088.1~uORF:IOH11297	1885	58	1827
B05R05C18	5-18-5	Hs~Ref:NM_004088.1~uORF:IOH11297	1754	65	1689
B05R05C19	5-19-5	Hs~MGC:BC016615.1~uORF:IOH10688	281	253	28
B05R05C20	5-20-5	Hs~MGC:BC016615.1~uORF:IOH10688	235	80	155
B05R05C21	5-21-5	Hs~Ref:NM_033640.1~uORF:IOH10841	323	123	200
B05R05C22	5-22-5	Hs~Ref:NM_033640.1~uORF:IOH10841	276	157	119
B05R06C01	5-1-6	Hs~Ref:NM_001446.2~uORF:IOH11228	112	53	59
B05R06C02	5-2-6	Hs~Ref:NM_001446.2~uORF:IOH11228	85	44	41
B05R06C03	5-3-6	Hs~Ref:NM_181738.1~uORF:IOH39994	350	39	311
B05R06C04	5-4-6	Hs~Ref:NM_181738.1~uORF:IOH39994	339	37	302
B05R06C05	5-5-6	Hs~MGC:BC063500.1~uORF:IOH39897	3011	38	2973
B05R06C06	5-6-6	Hs~MGC:BC063500.1~uORF:IOH39897	3023	39	2984
B05R06C07	5-7-6	Hs~Ref:NM_020312.1~uORF:IOH39954	191	42	149
B05R06C08	5-8-6	Hs~Ref:NM_020312.1~uORF:IOH39954	247	119	128
B05R06C09	5-9-6	Hs~MGC:BC064841.1~uORF:IOH39998	228	69	159
B05R06C10	5-10-6	Hs~MGC:BC064841.1~uORF:IOH39998	244	39	205
B05R06C11	5-11-6	Hs~Ref:NM_079424.1~uORF:IOH45798	312	172	140
B05R06C12	5-12-6	Hs~Ref:NM_079424.1~uORF:IOH45798	296	164	132
B05R06C13	5-13-6	Hs~Ref:NM_001002033.1~uORF:IOH45892	109	74	35
B05R06C14	5-14-6	Hs~Ref:NM_001002033.1~uORF:IOH45892	115	48	67
B05R06C15	5-15-6	Hs~Ref:NM_197974.1~uORF:IOH45792	292	42	250
B05R06C16	5-16-6	Hs~Ref:NM_197974.1~uORF:IOH45792	311	46	265
B05R06C17	5-17-6	Hs~Ref:NM_199331.1~uORF:IOH45816	1900	46	1854
B05R06C18	5-18-6	Hs~Ref:NM_199331.1~uORF:IOH45816	1443	55	1388
B05R06C19	5-19-6	Hs~Ref:NM_002387.1~uORF:IOH14306	2792	76	2716
B05R06C20	5-20-6	Hs~Ref:NM_002387.1~uORF:IOH14306	2610	90	2520
B05R06C21	5-21-6	Hs~MGC:BC018891.2~uORF:IOH14500	48	97	-49
B05R06C22	5-22-6	Hs~MGC:BC018891.2~uORF:IOH14500	93	71	22
B05R07C01	5-1-7	Hs~MGC:BC024256.1~uORF:IOH14000	255	50	205
B05R07C02	5-2-7	Hs~MGC:BC024256.1~uORF:IOH14000	258	42	216
B05R07C03	5-3-7	Hs~MGC:BC009785.1~uORF:IOH14325	286	39	247
B05R07C04	5-4-7	Hs~MGC:BC009785.1~uORF:IOH14325	286	39	247
B05R07C05	5-5-7	Hs~Ref:NM_002867.2~uORF:IOH6672	190	44	146
B05R07C06	5-6-7	Hs~Ref:NM_002867.2~uORF:IOH6672	277	157	120
B05R07C07	5-7-7	Hs~Ref:NM_001663.2~uORF:IOH4954	2117	40	2077
B05R07C08	5-8-7	Hs~Ref:NM_001663.2~uORF:IOH4954	2009	40	1969
B05R07C09	5-9-7	Hs~Ref:NM_017595.2~uORF:IOH6101	295	40	255
B05R07C10	5-10-7	Hs~Ref:NM_017595.2~uORF:IOH6101	331	42	289
B05R07C11	5-11-7	Hs~Ref:NM_002068.1~uORF:IOH9848	2633	43	2590
B05R07C12	5-12-7	Hs~Ref:NM_002068.1~uORF:IOH9848	2628	44	2584
B05R07C13	5-13-7	Hs~Ref:NM_000317.1~uORF:IOH9965	595	49	546
B05R07C14	5-14-7	Hs~Ref:NM_000317.1~uORF:IOH9965	579	47	532
B05R07C15	5-15-7	Hs~MGC:BC018624.1~uORF:IOH14128	374	48	326
B05R07C16	5-16-7	Hs~MGC:BC018624.1~uORF:IOH14128	370	43	327
B05R07C17	5-17-7	Hs~MGC:BC008435.1~uORF:IOH7556	1216	55	1161
B05R07C18	5-18-7	Hs~MGC:BC008435.1~uORF:IOH7556	1084	117	967
B05R07C19	5-19-7	Hs~MGC:BC010137.1~uORF:IOH14488	571	51	520
B05R07C20	5-20-7	Hs~MGC:BC010137.1~uORF:IOH14488	541	63	478
B05R07C21	5-21-7	Hs~Ref:NM_002957.3~uORF:IOH39435	360	58	302
B05R07C22	5-22-7	Hs~Ref:NM_002957.3~uORF:IOH39435	360	52	308
B05R08C01	5-1-8	Hs~MGC:BC008077.2~uORF:IOH6111	379	39	340
B05R08C02	5-2-8	Hs~MGC:BC008077.2~uORF:IOH6111	385	39	346
B05R08C03	5-3-8	Hs~Ref:NM_003674.2~uORF:IOH39710	223	40	183
B05R08C04	5-4-8	Hs~Ref:NM_003674.2~uORF:IOH39710	237	38	199
B05R08C05	5-5-8	Hs~Ref:NM_006914.2~uORF:IOH39668	360	39	321
B05R08C06	5-6-8	Hs~Ref:NM_006914.2~uORF:IOH39668	383	39	344
B05R08C07	5-7-8	Hs~MGC:BC026187.2~uORF:IOH22486	429	38	391
B05R08C08	5-8-8	Hs~MGC:BC026187.2~uORF:IOH22486	421	39	382
B05R08C09	5-9-8	Hs~MGC:BC028396.1~uORF:IOH26867	453	38	415
B05R08C10	5-10-8	Hs~MGC:BC028396.1~uORF:IOH26867	428	37	391
B05R08C11	5-11-8	Hs~MGC:BC021121.1~uORF:IOH23113	444	39	405
B05R08C12	5-12-8	Hs~MGC:BC021121.1~uORF:IOH23113	450	38	412
B05R08C13	5-13-8	Hs~Ref:NM_005916.2~uORF:IOH12526	491	40	451
B05R08C14	5-14-8	Hs~Ref:NM_005916.2~uORF:IOH12526	495	45	450
B05R08C15	5-15-8	Hs~Ref:NM_017867.1~uORF:IOH12106	462	54	408
B05R08C16	5-16-8	Hs~Ref:NM_017867.1~uORF:IOH12106	443	46	397
B05R08C17	5-17-8	Hs~MGC:BC007581.1~uORF:IOH6857	800	46	754
B05R08C18	5-18-8	Hs~MGC:BC007581.1~uORF:IOH6857	805	49	756
B05R08C19	5-19-8	Hs~MGC:BC031010.1~uORF:IOH23142	534	420	114
B05R08C20	5-20-8	Hs~MGC:BC031010.1~uORF:IOH23142	504	52	452
B05R08C21	5-21-8	Hs~MGC:BC042578.1~uORF:IOH27311	349	47	302
B05R08C22	5-22-8	Hs~MGC:BC042578.1~uORF:IOH27311	305	46	259
B05R09C01	5-1-9	Hs~Ref:NM_139313.1~uORF:IOH6704	285	41	244
B05R09C02	5-2-9	Hs~Ref:NM_139313.1~uORF:IOH6704	274	41	233
B05R09C03	5-3-9	Hs~MGC:BC001446.2~uORF:IOH4019	205	43	162
B05R09C04	5-4-9	Hs~MGC:BC001446.2~uORF:IOH4019	189	43	146
B05R09C05	5-5-9	Hs~Ref:NM_138819.1~uORF:IOH13823	2121	42	2079
B05R09C06	5-6-9	Hs~Ref:NM_138819.1~uORF:IOH13823	2222	40	2182
B05R09C07	5-7-9	Hs~MGC:BC006999.1~uORF:IOH7367	376	38	338
B05R09C08	5-8-9	Hs~MGC:BC006999.1~uORF:IOH7367	349	41	308
B05R09C09	5-9-9	Hs~MGC:BC035619.1~uORF:IOH27570	296	40	256
B05R09C10	5-10-9	Hs~MGC:BC035619.1~uORF:IOH27570	289	39	250
B05R09C11	5-11-9	Hs~MGC:BC036923.1~uORF:IOH25928	474	36	438
B05R09C12	5-12-9	Hs~MGC:BC036923.1~uORF:IOH25928	471	35	436
B05R09C13	5-13-9	Hs~MGC:BC056160.1~uORF:IOH29049	244	39	205
B05R09C14	5-14-9	Hs~MGC:BC056160.1~uORF:IOH29049	286	101	185
B05R09C15	5-15-9	Hs~MGC:BC013366.2~uORF:IOH27815	392	46	346
B05R09C16	5-16-9	Hs~MGC:BC013366.2~uORF:IOH27815	342	41	301
B05R09C17	5-17-9	Hs~MGC:BC002759.2~uORF:IOH46070	123	51	72
B05R09C18	5-18-9	Hs~MGC:BC002759.2~uORF:IOH46070	192	44	148
B05R09C19	5-19-9	Hs~MGC:BC002381.2~uORF:IOH46138	114	43	71
B05R09C20	5-20-9	Hs~MGC:BC002381.2~uORF:IOH46138	135	87	48
B05R09C21	5-21-9	Hs~MGC:BC002950.1~uORF:IOH46164	127	49	78
B05R09C22	5-22-9	Hs~MGC:BC002950.1~uORF:IOH46164	114	49	65
B05R10C01	5-1-10	Hs~MGC:BC020711.1~uORF:IOH46097	213	48	165
B05R10C02	5-2-10	Hs~MGC:BC020711.1~uORF:IOH46097	237	78	159
B05R10C03	5-3-10	Hs~Ref:NM_001899.2~uORF:IOH40718	460	136	324
B05R10C04	5-4-10	Hs~Ref:NM_001899.2~uORF:IOH40718	160	50	110
B05R10C05	5-5-10	Hs~MGC:BC026039.1~uORF:IOH40656	17535	45	17490
B05R10C06	5-6-10	Hs~MGC:BC026039.1~uORF:IOH40656	17573	42	17531
B05R10C07	5-7-10	Hs~Ref:NM_153229.1~uORF:IOH40698	283	40	243
B05R10C08	5-8-10	Hs~Ref:NM_153229.1~uORF:IOH40698	299	52	247
B05R10C09	5-9-10	Hs~Ref:NM_198083.1~uORF:IOH40660	351	38	313
B05R10C10	5-10-10	Hs~Ref:NM_198083.1~uORF:IOH40660	326	43	283
B05R10C11	5-11-10	GST1	39	35	4
B05R10C12	5-12-10	GST1	38	34	4
B05R10C13	5-13-10	GST2	39	36	3
B05R10C14	5-14-10	GST2	41	37	4
B05R10C15	5-15-10	GST3	50	37	13
B05R10C16	5-16-10	GST3	45	36	9
B05R10C17	5-17-10	GST4	63	35	28
B05R10C18	5-18-10	GST4	53	47	6
B05R10C19	5-19-10	Anti-HumanIgA1~N/A	8940	39	8901
B05R10C20	5-20-10	Anti-HumanIgA1~N/A	9906	41	9865
B05R10C21	5-21-10	Anti-HumanIgA2~N/A	18087	45	18042
B05R10C22	5-22-10	Anti-HumanIgA2~N/A	17740	43	17697
B05R11C01	5-1-11	AlexaAntiMouseAb~N/A	22183	46	22137
B05R11C02	5-2-11	AlexaAntiMouseAb~N/A	21067	46	21021
B05R11C03	5-3-11	MAPKAP~N/A	101	42	59
B05R11C04	5-4-11	MAPKAP~N/A	192	46	146
B05R11C05	5-5-11	Buffer	286	47	239
B05R11C06	5-6-11	Buffer	320	43	277
B05R11C07	5-7-11	BSA~N/A	10482	38	10444
B05R11C08	5-8-11	BSA~N/A	11136	39	11097
B05R11C09	5-9-11	Anti-HumanIgG1~N/A	1426	36	1390
B05R11C10	5-10-11	Anti-HumanIgG1~N/A	1634	36	1598
B05R11C11	5-11-11	Anti-HumanIgG2~N/A	3630	35	3595
B05R11C12	5-12-11	Anti-HumanIgG2~N/A	3370	35	3335
B05R11C13	5-13-11	Anti-HumanIgG3~N/A	6029	37	5992
B05R11C14	5-14-11	Anti-HumanIgG3~N/A	6284	38	6246
B05R11C15	5-15-11	Anti-HumanIgG4~N/A	12555	40	12515
B05R11C16	5-16-11	Anti-HumanIgG4~N/A	11887	41	11846
B05R11C17	5-17-11	AntiBiotinAb~N/A	13884	39	13845
B05R11C18	5-18-11	AntiBiotinAb~N/A	13879	40	13839
B05R11C19	5-19-11	Buffer	53	36	17
B05R11C20	5-20-11	Buffer	49	35	14
B05R11C21	5-21-11	Hs~MGC:BC009689.1~uORF:IOH9910	272	41	231
B05R11C22	5-22-11	Hs~MGC:BC009689.1~uORF:IOH9910	253	209	44
B05R12C01	5-1-12	Hs~MGC:BC017492.1~uORF:IOH10044	348	47	301
B05R12C02	5-2-12	Hs~MGC:BC017492.1~uORF:IOH10044	349	66	283
B05R12C03	5-3-12	Hs~MGC:BC007618.1~uORF:IOH6923	290	129	161
B05R12C04	5-4-12	Hs~MGC:BC007618.1~uORF:IOH6923	388	107	281
B05R12C05	5-5-12	Hs~MGC:BC003398.1~uORF:IOH3008	2634	50	2584
B05R12C06	5-6-12	Hs~MGC:BC003398.1~uORF:IOH3008	2627	44	2583
B05R12C07	5-7-12	Hs~Ref:NM_033103.1~uORF:IOH22340	1330	39	1291
B05R12C08	5-8-12	Hs~Ref:NM_033103.1~uORF:IOH22340	1279	40	1239
B05R12C09	5-9-12	Hs~MGC:BC032249.1~uORF:IOH21538	550	39	511
B05R12C10	5-10-12	Hs~MGC:BC032249.1~uORF:IOH21538	528	37	491
B05R12C11	5-11-12	Hs~MGC:BC030020.2~uORF:IOH22410	34	36	-2
B05R12C12	5-12-12	Hs~MGC:BC030020.2~uORF:IOH22410	32	35	-3
B05R12C13	5-13-12	Hs~MGC:BC056669.1~uORF:IOH29465	123	35	88
B05R12C14	5-14-12	Hs~MGC:BC056669.1~uORF:IOH29465	111	37	74
B05R12C15	5-15-12	Hs~Ref:NM_133336.1~uORF:IOH42549	518	38	480
B05R12C16	5-16-12	Hs~Ref:NM_133336.1~uORF:IOH42549	460	39	421
B05R12C17	5-17-12	Hs~Ref:NM_022977.1~uORF:IOH42656	947	41	906
B05R12C18	5-18-12	Hs~Ref:NM_022977.1~uORF:IOH42656	957	42	915
B05R12C19	5-19-12	Hs~Ref:NM_133341.1~uORF:IOH42565	235	67	168
B05R12C20	5-20-12	Hs~Ref:NM_133341.1~uORF:IOH42565	199	39	160
B05R12C21	5-21-12	Hs~Ref:NM_012459.1~uORF:IOH42518	256	43	213
B05R12C22	5-22-12	Hs~Ref:NM_012459.1~uORF:IOH42518	217	42	175
B05R13C01	5-1-13	Hs~Ref:NM_000638.2~uORF:IOH6660	808	39	769
B05R13C02	5-2-13	Hs~Ref:NM_000638.2~uORF:IOH6660	910	47	863
B05R13C03	5-3-13	Hs~Ref:NM_006832.1~uORF:IOH12652	463	63	400
B05R13C04	5-4-13	Hs~Ref:NM_006832.1~uORF:IOH12652	473	52	421
B05R13C05	5-5-13	Hs~Ref:NM_000930.2~uORF:IOH29603	633	40	593
B05R13C06	5-6-13	Hs~Ref:NM_000930.2~uORF:IOH29603	690	42	648
B05R13C07	5-7-13	Hs~Ref:NM_015886.3~uORF:IOH29651	863	47	816
B05R13C08	5-8-13	Hs~Ref:NM_015886.3~uORF:IOH29651	821	42	779
B05R13C09	5-9-13	Hs~Ref:NM_016113.3~uORF:IOH12783	404	41	363
B05R13C10	5-10-13	Hs~Ref:NM_016113.3~uORF:IOH12783	413	41	372
B05R13C11	5-11-13	Hs~Ref:NM_017988.4~uORF:IOH61176	143	45	98
B05R13C12	5-12-13	Hs~Ref:NM_017988.4~uORF:IOH61176	550	76	474
B05R13C13	5-13-13	Hs~Ref:NM_002607.4~uORF:IOH35279	1411	41	1370
B05R13C14	5-14-13	Hs~Ref:NM_002607.4~uORF:IOH35279	1440	41	1399
B05R13C15	5-15-13	Hs~Ref:NM_003887.1~uORF:IOH60033	609	42	567
B05R13C16	5-16-13	Hs~Ref:NM_003887.1~uORF:IOH60033	569	40	529
B05R13C17	5-17-13	Hs~Ref:NM_001312.2~uORF:IOH3437	690	38	652
B05R13C18	5-18-13	Hs~Ref:NM_001312.2~uORF:IOH3437	727	37	690
B05R13C19	5-19-13	Hs~Ref:NM_003254.1~uORF:IOH3196	549	39	510
B05R13C20	5-20-13	Hs~Ref:NM_003254.1~uORF:IOH3196	313	39	274
B05R13C21	5-21-13	Hs~Ref:NM_002415.1~uORF:IOH3502	490	43	447
B05R13C22	5-22-13	Hs~Ref:NM_002415.1~uORF:IOH3502	552	43	509
B05R14C01	5-1-14	Hs~MGC:BC001083.1~uORF:IOH3776	435	36	399
B05R14C02	5-2-14	Hs~MGC:BC001083.1~uORF:IOH3776	433	38	395
B05R14C03	5-3-14	Hs~MGC:BC052966.1~uORF:IOH28846	500	39	461
B05R14C04	5-4-14	Hs~MGC:BC052966.1~uORF:IOH28846	491	38	453
B05R14C05	5-5-14	Hs~MGC:BC020737.1~uORF:IOH14449	299	43	256
B05R14C06	5-6-14	Hs~MGC:BC020737.1~uORF:IOH14449	288	44	244
B05R14C07	5-7-14	Hs~MGC:BC007401.2~uORF:IOH5852	381	197	184
B05R14C08	5-8-14	Hs~MGC:BC007401.2~uORF:IOH5852	379	49	330
B05R14C09	5-9-14	Hs~MGC:BC025996.2~uORF:IOH10875	334	40	294
B05R14C10	5-10-14	Hs~MGC:BC025996.2~uORF:IOH10875	317	41	276
B05R14C11	5-11-14	Hs~Ref:NM_004985.3~uORF:IOH53851	234	59	175
B05R14C12	5-12-14	Hs~Ref:NM_004985.3~uORF:IOH53851	173	58	115
B05R14C13	5-13-14	Hs~Ref:NM_139245.2~uORF:IOH53944	381	46	335
B05R14C14	5-14-14	Hs~Ref:NM_139245.2~uORF:IOH53944	400	44	356
B05R14C15	5-15-14	Hs~Ref:NM_001008491.1~uORF:IOH53945	364	209	155
B05R14C16	5-16-14	Hs~Ref:NM_001008491.1~uORF:IOH53945	274	157	117
B05R14C17	5-17-14	Hs~Ref:NM_001006625.1~uORF:IOH58657	130	48	82
B05R14C18	5-18-14	Hs~Ref:NM_001006625.1~uORF:IOH58657	232	43	189
B05R14C19	5-19-14	Hs~Ref:NM_030641.2~uORF:IOH26930	339	37	302
B05R14C20	5-20-14	Hs~Ref:NM_030641.2~uORF:IOH26930	242	38	204
B05R14C21	5-21-14	Hs~MGC:BC043348.2~uORF:IOH26348	275	207	68
B05R14C22	5-22-14	Hs~MGC:BC043348.2~uORF:IOH26348	256	48	208
B05R15C01	5-1-15	Hs~MGC:BC047666.1~uORF:IOH26700	461	36	425
B05R15C02	5-2-15	Hs~MGC:BC047666.1~uORF:IOH26700	434	36	398
B05R15C03	5-3-15	Hs~MGC:BC051850.1~uORF:IOH27078	421	36	385
B05R15C04	5-4-15	Hs~MGC:BC051850.1~uORF:IOH27078	397	36	361
B05R15C05	5-5-15	Hs~MGC:BC093661.1~uORF:IOH61968	1303	38	1265
B05R15C06	5-6-15	Hs~MGC:BC093661.1~uORF:IOH61968	1355	37	1318
B05R15C07	5-7-15	Hs~MGC:BC016486.2~uORF:IOH61399	1033	43	990
B05R15C08	5-8-15	Hs~MGC:BC016486.2~uORF:IOH61399	1169	42	1127
B05R15C09	5-9-15	Hs~MGC:BC039251.1~uORF:IOH62148	335	40	295
B05R15C10	5-10-15	Hs~MGC:BC039251.1~uORF:IOH62148	118	37	81
B05R15C11	5-11-15	Hs~MGC:BC072000.1~uORF:IOH63090	381	41	340
B05R15C12	5-12-15	Hs~MGC:BC072000.1~uORF:IOH63090	342	40	302
B05R15C13	5-13-15	Hs~IVGN:PM_2146~Ext:JO-1~N/A	130	55	75
B05R15C14	5-14-15	Hs~IVGN:PM_2146~Ext:JO-1~N/A	106	34	72
B05R15C15	5-15-15	Hs~Ref:NM_006254.3~CAT:P2287	506	34	472
B05R15C16	5-16-15	Hs~Ref:NM_006254.3~CAT:P2287	553	37	516
B05R15C17	5-17-15	Hs~Ref:NM_001895.1~CAT:PV3248	1720	45	1675
B05R15C18	5-18-15	Hs~Ref:NM_001895.1~CAT:PV3248	1687	42	1645
B05R15C19	5-19-15	Hs~Ref:NM_004073.2~CAT:PV3812	1088	35	1053
B05R15C20	5-20-15	Hs~Ref:NM_004073.2~CAT:PV3812	987	35	952
B05R15C21	5-21-15	Hs~Ref:NM_022048.1~CAT:PV3825	703	36	667
B05R15C22	5-22-15	Hs~Ref:NM_022048.1~CAT:PV3825	602	43	559
B05R16C01	5-1-16	Hs~Ref:NM_001893.3~CAT:PV3665	2165	39	2126
B05R16C02	5-2-16	Hs~Ref:NM_001893.3~CAT:PV3665	2322	35	2287
B05R16C03	5-3-16	Hs~Ref:NM_004452.2~CAT:PV4802	559	35	524
B05R16C04	5-4-16	Hs~Ref:NM_004452.2~CAT:PV4802	555	36	519
B05R16C05	5-5-16	Hs~N/A:NM_006206.3~CAT:PV4680	348	37	311
B05R16C06	5-6-16	Hs~N/A:NM_006206.3~CAT:PV4680	346	40	306
B05R16C07	5-7-16	Hs~MGC:BC072396.1~uORF:IOH61805	398	39	359
B05R16C08	5-8-16	Hs~MGC:BC072396.1~uORF:IOH61805	410	43	367
B05R16C09	5-9-16	Hs~MGC:BC095467.1~uORF:IOH62758	436	48	388
B05R16C10	5-10-16	Hs~MGC:BC095467.1~uORF:IOH62758	440	58	382
B05R16C11	5-11-16	Hs~MGC:BC096272.2~uORF:IOH63224	11995	40	11955
B05R16C12	5-12-16	Hs~MGC:BC096272.2~uORF:IOH63224	11388	36	11352
B05R16C13	5-13-16	Hs~MGC:BC092476.1~uORF:IOH62623	598	35	563
B05R16C14	5-14-16	Hs~MGC:BC092476.1~uORF:IOH62623	633	36	597
B05R16C15	5-15-16	Hs~Ref:NM_025219.1~uORF:IOH28943	1863	34	1829
B05R16C16	5-16-16	Hs~Ref:NM_025219.1~uORF:IOH28943	1988	39	1949
B05R16C17	5-17-16	Hs~MGC:BC032825.2~uORF:IOH26816	343	246	97
B05R16C18	5-18-16	Hs~MGC:BC032825.2~uORF:IOH26816	316	231	85
B05R16C19	5-19-16	Hs~MGC:BC058862.1~uORF:IOH28675	598	42	556
B05R16C20	5-20-16	Hs~MGC:BC058862.1~uORF:IOH28675	586	39	547
B05R16C21	5-21-16	Hs~MGC:BC040981.2~uORF:IOH27624	465	42	423
B05R16C22	5-22-16	Hs~MGC:BC040981.2~uORF:IOH27624	372	39	333
B05R17C01	5-1-17	Hs~MGC:BC036817.1~uORF:IOH22107	482	38	444
B05R17C02	5-2-17	Hs~MGC:BC036817.1~uORF:IOH22107	463	38	425
B05R17C03	5-3-17	Hs~Ref:NM_001007258.1~uORF:IOH22078	595	37	558
B05R17C04	5-4-17	Hs~Ref:NM_001007258.1~uORF:IOH22078	560	37	523
B05R17C05	5-5-17	Hs~MGC:BC013107.1~uORF:IOH11160	627	38	589
B05R17C06	5-6-17	Hs~MGC:BC013107.1~uORF:IOH11160	671	38	633
B05R17C07	5-7-17	Hs~Ref:NM_153261.3~uORF:IOH22075	713	38	675
B05R17C08	5-8-17	Hs~Ref:NM_153261.3~uORF:IOH22075	676	37	639
B05R17C09	5-9-17	Hs~MGC:BC087841.1~uORF:IOH62571	369	41	328
B05R17C10	5-10-17	Hs~MGC:BC087841.1~uORF:IOH62571	427	61	366
B05R17C11	5-11-17	Hs~MGC:BC073937.1~uORF:IOH61765	5707	40	5667
B05R17C12	5-12-17	Hs~MGC:BC073937.1~uORF:IOH61765	5583	37	5546
B05R17C13	5-13-17	Hs~MGC:BC066254.1~uORF:IOH61859	127	37	90
B05R17C14	5-14-17	Hs~MGC:BC066254.1~uORF:IOH61859	248	46	202
B05R17C15	5-15-17	Hs~MGC:BC067811.1~uORF:IOH61678	275	51	224
B05R17C16	5-16-17	Hs~MGC:BC067811.1~uORF:IOH61678	130	35	95
B05R17C17	5-17-17	Hs~Ref:NM_016061.1~uORF:IOH3118	619	44	575
B05R17C18	5-18-17	Hs~Ref:NM_016061.1~uORF:IOH3118	643	43	600
B05R17C19	5-19-17	Hs~MGC:BC008656.1~uORF:IOH3347	366	42	324
B05R17C20	5-20-17	Hs~MGC:BC008656.1~uORF:IOH3347	379	43	336
B05R17C21	5-21-17	Hs~Ref:NM_006830.2~uORF:IOH3579	448	148	300
B05R17C22	5-22-17	Hs~Ref:NM_006830.2~uORF:IOH3579	428	48	380
B05R18C01	5-1-18	Hs~Ref:NM_173621.1~uORF:IOH43334	630	37	593
B05R18C02	5-2-18	Hs~Ref:NM_173621.1~uORF:IOH43334	575	40	535
B05R18C03	5-3-18	Hs~MGC:BC038294.2~uORF:IOH27125	347	41	306
B05R18C04	5-4-18	Hs~MGC:BC038294.2~uORF:IOH27125	328	41	287
B05R18C05	5-5-18	Hs~Ref:NM_139240.2~uORF:IOH27365	426	39	387
B05R18C06	5-6-18	Hs~Ref:NM_139240.2~uORF:IOH27365	430	38	392
B05R18C07	5-7-18	Hs~Ref:NM_019069.3~uORF:IOH26403	355	54	301
B05R18C08	5-8-18	Hs~Ref:NM_019069.3~uORF:IOH26403	346	41	305
B05R18C09	5-9-18	Hs~MGC:BC046645.1~uORF:IOH26386	361	39	322
B05R18C10	5-10-18	Hs~MGC:BC046645.1~uORF:IOH26386	372	46	326
B05R18C11	5-11-18	Hs~Ref:NM_002949.2~uORF:IOH56891	472	39	433
B05R18C12	5-12-18	Hs~Ref:NM_002949.2~uORF:IOH56891	456	39	417
B05R18C13	5-13-18	Hs~Ref:NM_020401.2~uORF:IOH55752	612	42	570
B05R18C14	5-14-18	Hs~Ref:NM_020401.2~uORF:IOH55752	524	41	483
B05R18C15	5-15-18	Hs~Ref:NM_016512.2~uORF:IOH58592	284	48	236
B05R18C16	5-16-18	Hs~Ref:NM_016512.2~uORF:IOH58592	290	81	209
B05R18C17	5-17-18	Hs~Ref:NM_002731.2~uORF:IOH53938	407	69	338
B05R18C18	5-18-18	Hs~Ref:NM_002731.2~uORF:IOH53938	257	40	217
B05R18C19	5-19-18	Hs~Ref:NM_138993.1~N/A	492	39	453
B05R18C20	5-20-18	Hs~Ref:NM_138993.1~N/A	483	38	445
B05R18C21	5-21-18	Hs~Ref:NM_022972.1~N/A	935	40	895
B05R18C22	5-22-18	Hs~Ref:NM_022972.1~N/A	818	37	781
B05R19C01	5-1-19	Hs~Ref:NM_002969.2~N/A	389	38	351
B05R19C02	5-2-19	Hs~Ref:NM_002969.2~N/A	444	41	403
B05R19C03	5-3-19	Hs~Ref:NM_152727.4~uORF:IOH28984	1539	43	1496
B05R19C04	5-4-19	Hs~Ref:NM_152727.4~uORF:IOH28984	1555	42	1513
B05R19C05	5-5-19	Hs~Ref:NM_017877.2~uORF:IOH11542	213	48	165
B05R19C06	5-6-19	Hs~Ref:NM_017877.2~uORF:IOH11542	208	109	99
B05R19C07	5-7-19	Hs~Ref:NM_001651.1~uORF:IOH22503	572	40	532
B05R19C08	5-8-19	Hs~Ref:NM_001651.1~uORF:IOH22503	597	38	559
B05R19C09	5-9-19	Hs~MGC:NM_152489.1~uORF:IOH22752	552	37	515
B05R19C10	5-10-19	Hs~MGC:NM_152489.1~uORF:IOH22752	538	36	502
B05R19C11	5-11-19	Hs~MGC:BC030295.1~uORF:IOH21572	570	37	533
B05R19C12	5-12-19	Hs~MGC:BC030295.1~uORF:IOH21572	545	38	507
B05R19C13	5-13-19	Hs~MGC:BC010467.1~uORF:IOH11119	4115	40	4075
B05R19C14	5-14-19	Hs~MGC:BC010467.1~uORF:IOH11119	4309	38	4271
B05R19C15	5-15-19	Hs~MGC:BC013009.1~uORF:IOH13110	3853	43	3810
B05R19C16	5-16-19	Hs~MGC:BC013009.1~uORF:IOH13110	3708	42	3666
B05R19C17	5-17-19	Hs~Ref:NM_002159.2~uORF:IOH12902	346	37	309
B05R19C18	5-18-19	Hs~Ref:NM_002159.2~uORF:IOH12902	332	37	295
B05R19C19	5-19-19	Hs~MGC:BC029877.1~uORF:IOH22783	409	36	373
B05R19C20	5-20-19	Hs~MGC:BC029877.1~uORF:IOH22783	368	39	329
B05R19C21	5-21-19	Hs~Ref:NM_014248.2~uORF:IOH4015	579	42	537
B05R19C22	5-22-19	Hs~Ref:NM_014248.2~uORF:IOH4015	594	44	550
B05R20C01	5-1-20	Hs~Ref:NM_004566.1~uORF:IOH27198	791	35	756
B05R20C02	5-2-20	Hs~Ref:NM_004566.1~uORF:IOH27198	814	37	777
B05R20C03	5-3-20	Hs~MGC:BC033196.1~uORF:IOH23248	1470	36	1434
B05R20C04	5-4-20	Hs~MGC:BC033196.1~uORF:IOH23248	1491	38	1453
B05R20C05	5-5-20	Hs~Ref:NM_053006.1~uORF:IOH27746	750	41	709
B05R20C06	5-6-20	Hs~Ref:NM_053006.1~uORF:IOH27746	681	41	640
B05R20C07	5-7-20	Hs~Ref:NM_000666.1~uORF:IOH4147	345	44	301
B05R20C08	5-8-20	Hs~Ref:NM_000666.1~uORF:IOH4147	333	43	290
B05R20C09	5-9-20	Hs~MGC:BC052600.1~uORF:IOH29370	416	40	376
B05R20C10	5-10-20	Hs~MGC:BC052600.1~uORF:IOH29370	395	40	355
B05R20C11	5-11-20	Hs~MGC:BC058932.1~uORF:IOH29074	359	40	319
B05R20C12	5-12-20	Hs~MGC:BC058932.1~uORF:IOH29074	364	40	324
B05R20C13	5-13-20	Hs~MGC:BC059374.1~uORF:IOH29261	429	36	393
B05R20C14	5-14-20	Hs~MGC:BC059374.1~uORF:IOH29261	411	35	376
B05R20C15	5-15-20	Hs~MGC:BC006117.1~uORF:IOH6567	167	54	113
B05R20C16	5-16-20	Hs~MGC:BC006117.1~uORF:IOH6567	212	51	161
B05R20C17	5-17-20	Hs~MGC:BC027724.1~uORF:IOH14366	318	36	282
B05R20C18	5-18-20	Hs~MGC:BC027724.1~uORF:IOH14366	302	36	266
B05R20C19	5-19-20	Hs~MGC:BC029554.1~uORF:IOH21598	565	34	531
B05R20C20	5-20-20	Hs~MGC:BC029554.1~uORF:IOH21598	548	36	512
B05R20C21	5-21-20	Hs~Ref:NM_145253.1~uORF:IOH14070	5480	39	5441
B05R20C22	5-22-20	Hs~Ref:NM_145253.1~uORF:IOH14070	5286	36	5250
B05R21C01	5-1-21	Hs~Ref:NM_001000.2~uORF:IOH4200	704	33	671
B05R21C02	5-2-21	Hs~Ref:NM_001000.2~uORF:IOH4200	745	34	711
B05R21C03	5-3-21	Hs~Ref:NM_000990.2~uORF:IOH7151	395	34	361
B05R21C04	5-4-21	Hs~Ref:NM_000990.2~uORF:IOH7151	414	36	378
B05R21C05	5-5-21	Hs~Ref:NM_002425.1~uORF:IOH4106	108	59	49
B05R21C06	5-6-21	Hs~Ref:NM_002425.1~uORF:IOH4106	114	39	75
B05R21C07	5-7-21	Hs~Ref:NM_001337.2~uORF:IOH11359	979	36	943
B05R21C08	5-8-21	Hs~Ref:NM_001337.2~uORF:IOH11359	1044	35	1009
B05R21C09	5-9-21	Hs~Ref:NP_777596.2~CAT_10594-H08H-25	32	33	-1
B05R21C10	5-10-21	Hs~Ref:NP_777596.2~CAT_10594-H08H-25	32	32	0
B05R21C11	5-11-21	Internal_1007209	37	33	4
B05R21C12	5-12-21	Internal_1007209	38	33	5
B05R21C13	5-13-21	Hs~Ref:NP_004086.1~CAT_10022-H07E-25	31	32	-1
B05R21C14	5-14-21	Hs~Ref:NP_004086.1~CAT_10022-H07E-25	32	32	0
B05R21C15	5-15-21	Internal_1007209	60	46	14
B05R21C16	5-16-21	Internal_1007209	190	55	135
B05R21C17	5-17-21	Hs~Ref:NP_036374.1~CAT_10170-H08H-25	33	33	0
B05R21C18	5-18-21	Hs~Ref:NP_036374.1~CAT_10170-H08H-25	32	32	0
B05R21C19	5-19-21	Internal_1007209	49	32	17
B05R21C20	5-20-21	Internal_1007209	52	33	19
B05R21C21	5-21-21	Hs~Ref:NP_036374.1~CAT_PHC9215	766	34	732
B05R21C22	5-22-21	Hs~Ref:NP_036374.1~CAT_PHC9215	741	34	707
B05R22C01	5-1-22	ERa~N/A	2878	33	2845
B05R22C02	5-2-22	ERa~N/A	2668	33	2635
B05R22C03	5-3-22	PKCeta~N/A	260	35	225
B05R22C04	5-4-22	PKCeta~N/A	303	35	268
B05R22C05	5-5-22	Calmodulin~N/A	118	35	83
B05R22C06	5-6-22	Calmodulin~N/A	62	33	29
B05R22C07	5-7-22	V5control5~N/A	399	33	366
B05R22C08	5-8-22	V5control5~N/A	381	35	346
B05R22C09	5-9-22	V5control4~N/A	188	38	150
B05R22C10	5-10-22	V5control4~N/A	129	40	89
B05R22C11	5-11-22	V5control3~N/A	217	74	143
B05R22C12	5-12-22	V5control3~N/A	107	61	46
B05R22C13	5-13-22	V5control2~N/A	51	33	18
B05R22C14	5-14-22	V5control2~N/A	74	42	32
B05R22C15	5-15-22	V5control1~N/A	46	33	13
B05R22C16	5-16-22	V5control1~N/A	55	33	22
B05R22C17	5-17-22	CMK2A~N/A	439	33	406
B05R22C18	5-18-22	CMK2A~N/A	416	33	383
B05R22C19	5-19-22	ERa~N/A	2190	32	2158
B05R22C20	5-20-22	ERa~N/A	2455	32	2423
B05R22C21	5-21-22	AlexaAntiMouseAb~N/A	10534	34	10500
B05R22C22	5-22-22	AlexaAntiMouseAb~N/A	9596	34	9562
B06R01C01	6-1-1	AlexaAntiMouseAb~N/A	43888	51	43837
B06R01C02	6-2-1	AlexaAntiMouseAb~N/A	39910	51	39859
B06R01C03	6-3-1	ERa~N/A	1669	48	1621
B06R01C04	6-4-1	ERa~N/A	1640	48	1592
B06R01C05	6-5-1	HumanIgG1~N/A	1581	52	1529
B06R01C06	6-6-1	HumanIgG1~N/A	1644	52	1592
B06R01C07	6-7-1	HumanIgG2~N/A	3973	49	3924
B06R01C08	6-8-1	HumanIgG2~N/A	3848	49	3799
B06R01C09	6-9-1	HumanIgG3~N/A	19200	52	19148
B06R01C10	6-10-1	HumanIgG3~N/A	20455	52	20403
B06R01C11	6-11-1	HumanIgG4~N/A	49589	53	49536
B06R01C12	6-12-1	HumanIgG4~N/A	49350	53	49297
B06R01C13	6-13-1	BiotinAb~N/A	383	50	333
B06R01C14	6-14-1	BiotinAb~N/A	388	49	339
B06R01C15	6-15-1	RanBP2deltaFG~N/A	338	45	293
B06R01C16	6-16-1	RanBP2deltaFG~N/A	348	44	304
B06R01C17	6-17-1	hMDM2~N/A	844	47	797
B06R01C18	6-18-1	hMDM2~N/A	860	47	813
B06R01C19	6-19-1	PKCeta~N/A	557	48	509
B06R01C20	6-20-1	PKCeta~N/A	564	50	514
B06R01C21	6-21-1	AlexaAntiMouseAb~N/A	39233	50	39183
B06R01C22	6-22-1	AlexaAntiMouseAb~N/A	37006	51	36955
B06R02C01	6-1-2	PKCeta~N/A	2252	50	2202
B06R02C02	6-2-2	PKCeta~N/A	2368	51	2317
B06R02C03	6-3-2	Buffer	189	55	134
B06R02C04	6-4-2	Buffer	212	54	158
B06R02C05	6-5-2	HumanIgA~N/A	24183	54	24129
B06R02C06	6-6-2	HumanIgA~N/A	24903	54	24849
B06R02C07	6-7-2	Buffer	112	51	61
B06R02C08	6-8-2	Buffer	184	57	127
B06R02C09	6-9-2	BSA~N/A	13971	54	13917
B06R02C10	6-10-2	BSA~N/A	13245	59	13186
B06R02C11	6-11-2	Hs~MGC:BC010352.1~uORF:IOH14239	642	60	582
B06R02C12	6-12-2	Hs~MGC:BC010352.1~uORF:IOH14239	663	57	606
B06R02C13	6-13-2	Hs~MGC:BC018142.1~uORF:IOH10362	731	51	680
B06R02C14	6-14-2	Hs~MGC:BC018142.1~uORF:IOH10362	741	50	691
B06R02C15	6-15-2	Hs~MGC:BC053647.1~uORF:IOH28956	625	50	575
B06R02C16	6-16-2	Hs~MGC:BC053647.1~uORF:IOH28956	713	45	668
B06R02C17	6-17-2	Hs~Ref:NM_021063.2~uORF:IOH58956	832	49	783
B06R02C18	6-18-2	Hs~Ref:NM_021063.2~uORF:IOH58956	924	48	876
B06R02C19	6-19-2	Hs~MGC:BC012596.1~uORF:IOH14331	852	45	807
B06R02C20	6-20-2	Hs~MGC:BC012596.1~uORF:IOH14331	752	46	706
B06R02C21	6-21-2	Hs~Ref:NM_000992.2~uORF:IOH1702	1247	47	1200
B06R02C22	6-22-2	Hs~Ref:NM_000992.2~uORF:IOH1702	1194	47	1147
B06R03C01	6-1-3	Hs~Ref:NM_001839.1~uORF:IOH14563	872	51	821
B06R03C02	6-2-3	Hs~Ref:NM_001839.1~uORF:IOH14563	729	54	675
B06R03C03	6-3-3	Hs~Ref:NM_005147.1~uORF:IOH14013	903	55	848
B06R03C04	6-4-3	Hs~Ref:NM_005147.1~uORF:IOH14013	755	49	706
B06R03C05	6-5-3	Hs~Ref:NM_078630.1~uORF:IOH37755	1557	50	1507
B06R03C06	6-6-3	Hs~Ref:NM_078630.1~uORF:IOH37755	1490	53	1437
B06R03C07	6-7-3	Hs~MGC:NM_015191.1~uORF:IOH45349	572	55	517
B06R03C08	6-8-3	Hs~MGC:NM_015191.1~uORF:IOH45349	566	57	509
B06R03C09	6-9-3	Hs~Ref:NM_130467.3~uORF:IOH40626	349	62	287
B06R03C10	6-10-3	Hs~Ref:NM_130467.3~uORF:IOH40626	349	68	281
B06R03C11	6-11-3	Hs~Ref:NM_004349.2~uORF:IOH36626	429	79	350
B06R03C12	6-12-3	Hs~Ref:NM_004349.2~uORF:IOH36626	378	63	315
B06R03C13	6-13-3	Hs~Ref:NM_016276.3~uORF:IOH35747	316	51	265
B06R03C14	6-14-3	Hs~Ref:NM_016276.3~uORF:IOH35747	292	51	241
B06R03C15	6-15-3	Hs~MGC:NM_173809.2~uORF:IOH41035	198	54	144
B06R03C16	6-16-3	Hs~MGC:NM_173809.2~uORF:IOH41035	194	53	141
B06R03C17	6-17-3	Hs~Ref:NM_004282.2~uORF:IOH40925	398	72	326
B06R03C18	6-18-3	Hs~Ref:NM_004282.2~uORF:IOH40925	353	53	300
B06R03C19	6-19-3	Hs~Ref:NM_173178.1~uORF:IOH35125	218	164	54
B06R03C20	6-20-3	Hs~Ref:NM_173178.1~uORF:IOH35125	234	53	181
B06R03C21	6-21-3	Hs~Ref:NM_001671.2~uORF:IOH23108	248	48	200
B06R03C22	6-22-3	Hs~Ref:NM_001671.2~uORF:IOH23108	256	46	210
B06R04C01	6-1-4	Hs~MGC:BC007602.1~uORF:IOH6921	294	54	240
B06R04C02	6-2-4	Hs~MGC:BC007602.1~uORF:IOH6921	243	65	178
B06R04C03	6-3-4	Hs~MGC:NM_152776.1~uORF:IOH21708	122	62	60
B06R04C04	6-4-4	Hs~MGC:NM_152776.1~uORF:IOH21708	325	54	271
B06R04C05	6-5-4	Hs~Ref:NM_004829.1~uORF:IOH21540	290	49	241
B06R04C06	6-6-4	Hs~Ref:NM_004829.1~uORF:IOH21540	352	56	296
B06R04C07	6-7-4	Hs~MGC:BC015416.1~uORF:IOH10998	334	55	279
B06R04C08	6-8-4	Hs~MGC:BC015416.1~uORF:IOH10998	473	50	423
B06R04C09	6-9-4	Hs~MGC:BC009006.1~uORF:IOH10201	358	50	308
B06R04C10	6-10-4	Hs~MGC:BC009006.1~uORF:IOH10201	396	51	345
B06R04C11	6-11-4	Hs~Ref:NM_032169.2~uORF:IOH10227	413	50	363
B06R04C12	6-12-4	Hs~Ref:NM_032169.2~uORF:IOH10227	414	50	364
B06R04C13	6-13-4	Hs~MGC:BC011239.1~uORF:IOH10245	295	49	246
B06R04C14	6-14-4	Hs~MGC:BC011239.1~uORF:IOH10245	231	51	180
B06R04C15	6-15-4	Hs~Ref:NM_015459.3~uORF:IOH37933	293	177	116
B06R04C16	6-16-4	Hs~Ref:NM_015459.3~uORF:IOH37933	166	51	115
B06R04C17	6-17-4	Hs~Ref:NM_018158.1~uORF:IOH38323	204	156	48
B06R04C18	6-18-4	Hs~Ref:NM_018158.1~uORF:IOH38323	176	79	97
B06R04C19	6-19-4	Hs~Ref:NM_052917.1~uORF:IOH37969	314	54	260
B06R04C20	6-20-4	Hs~Ref:NM_052917.1~uORF:IOH37969	309	50	259
B06R04C21	6-21-4	Hs~Ref:NM_006873.2~uORF:IOH38227	1067	50	1017
B06R04C22	6-22-4	Hs~Ref:NM_006873.2~uORF:IOH38227	983	43	940
B06R05C01	6-1-5	Hs~Ref:NM_015568.2~uORF:IOH37988	322	60	262
B06R05C02	6-2-5	Hs~Ref:NM_015568.2~uORF:IOH37988	394	86	308
B06R05C03	6-3-5	Hs~Ref:NM_178275.3~uORF:IOH38420	360	53	307
B06R05C04	6-4-5	Hs~Ref:NM_178275.3~uORF:IOH38420	468	68	400
B06R05C05	6-5-5	Hs~Ref:NM_198449.1~uORF:IOH29134	563	53	510
B06R05C06	6-6-5	Hs~Ref:NM_198449.1~uORF:IOH29134	544	52	492
B06R05C07	6-7-5	Hs~Ref:NM_018848.2~uORF:IOH37996	427	172	255
B06R05C08	6-8-5	Hs~Ref:NM_018848.2~uORF:IOH37996	434	72	362
B06R05C09	6-9-5	Hs~Ref:NM_005965.2~N/A	450	62	388
B06R05C10	6-10-5	Hs~Ref:NM_005965.2~N/A	204	54	150
B06R05C11	6-11-5	Hs~Ref:NM_007194.2~N/A	445	166	279
B06R05C12	6-12-5	Hs~Ref:NM_007194.2~N/A	332	60	272
B06R05C13	6-13-5	Hs~Ref:NM_004226.1~N/A	306	52	254
B06R05C14	6-14-5	Hs~Ref:NM_004226.1~N/A	345	72	273
B06R05C15	6-15-5	Hs~Ref:NM_016507.1~N/A	440	49	391
B06R05C16	6-16-5	Hs~Ref:NM_016507.1~N/A	414	47	367
B06R05C17	6-17-5	Hs~Ref:NM_005307.1~N/A	711	51	660
B06R05C18	6-18-5	Hs~Ref:NM_005307.1~N/A	641	49	592
B06R05C19	6-19-5	Hs~Ref:NM_002613.1~N/A	460	47	413
B06R05C20	6-20-5	Hs~Ref:NM_002613.1~N/A	486	53	433
B06R05C21	6-21-5	Hs~Ref:NM_020397.1~N/A	433	45	388
B06R05C22	6-22-5	Hs~Ref:NM_020397.1~N/A	429	46	383
B06R06C01	6-1-6	Hs~Ref:NM_024046.1~N/A	598	53	545
B06R06C02	6-2-6	Hs~Ref:NM_024046.1~N/A	659	59	600
B06R06C03	6-3-6	Hs~Ref:NM_018137.1~uORF:IOH5353	879	61	818
B06R06C04	6-4-6	Hs~Ref:NM_018137.1~uORF:IOH5353	913	57	856
B06R06C05	6-5-6	Hs~Ref:NM_024712.2~uORF:IOH22774	960	52	908
B06R06C06	6-6-6	Hs~Ref:NM_024712.2~uORF:IOH22774	1047	51	996
B06R06C07	6-7-6	Hs~MGC:BC032451.1~uORF:IOH21663	65535	59	65476
B06R06C08	6-8-6	Hs~MGC:BC032451.1~uORF:IOH21663	65535	62	65473
B06R06C09	6-9-6	Hs~Ref:NM_002576.2~N/A	292	57	235
B06R06C10	6-10-6	Hs~Ref:NM_002576.2~N/A	408	57	351
B06R06C11	6-11-6	Hs~MGC:BC022253.1~uORF:IOH13441	795	51	744
B06R06C12	6-12-6	Hs~MGC:BC022253.1~uORF:IOH13441	797	51	746
B06R06C13	6-13-6	Hs~Ref:NM_016614.1~uORF:IOH10129	822	54	768
B06R06C14	6-14-6	Hs~Ref:NM_016614.1~uORF:IOH10129	864	51	813
B06R06C15	6-15-6	Hs~MGC:BC015842.1~uORF:IOH23072	854	48	806
B06R06C16	6-16-6	Hs~MGC:BC015842.1~uORF:IOH23072	835	45	790
B06R06C17	6-17-6	Hs~MGC:BC011781.2~uORF:IOH13131	1483	47	1436
B06R06C18	6-18-6	Hs~MGC:BC011781.2~uORF:IOH13131	1289	46	1243
B06R06C19	6-19-6	Hs~Ref:NM_152597.3~uORF:IOH25870	400	42	358
B06R06C20	6-20-6	Hs~Ref:NM_152597.3~uORF:IOH25870	431	52	379
B06R06C21	6-21-6	Hs~MGC:BC043528.1~uORF:IOH26294	311	42	269
B06R06C22	6-22-6	Hs~MGC:BC043528.1~uORF:IOH26294	405	44	361
B06R07C01	6-1-7	Hs~MGC:BC049216.1~uORF:IOH26610	450	53	397
B06R07C02	6-2-7	Hs~MGC:BC049216.1~uORF:IOH26610	461	65	396
B06R07C03	6-3-7	Hs~Ref:NM_002462.2~uORF:IOH21990	424	279	145
B06R07C04	6-4-7	Hs~Ref:NM_002462.2~uORF:IOH21990	475	86	389
B06R07C05	6-5-7	Hs~MGC:BC000574.1~uORF:IOH4174	505	59	446
B06R07C06	6-6-7	Hs~MGC:BC000574.1~uORF:IOH4174	474	218	256
B06R07C07	6-7-7	Hs~Ref:NM_018679.2~uORF:IOH26898	109	60	49
B06R07C08	6-8-7	Hs~Ref:NM_018679.2~uORF:IOH26898	108	82	26
B06R07C09	6-9-7	Hs~Ref:NM_018393.2~uORF:IOH26255	206	70	136
B06R07C10	6-10-7	Hs~Ref:NM_018393.2~uORF:IOH26255	271	164	107
B06R07C11	6-11-7	Hs~Ref:NM_144988.2~uORF:IOH12542	361	58	303
B06R07C12	6-12-7	Hs~Ref:NM_144988.2~uORF:IOH12542	158	64	94
B06R07C13	6-13-7	Hs~Ref:NM_000310.2~uORF:IOH7465	374	49	325
B06R07C14	6-14-7	Hs~Ref:NM_000310.2~uORF:IOH7465	439	52	387
B06R07C15	6-15-7	Hs~Ref:NM_003782.3~uORF:IOH21916	475	138	337
B06R07C16	6-16-7	Hs~Ref:NM_003782.3~uORF:IOH21916	354	131	223
B06R07C17	6-17-7	Hs~Ref:NM_024508.3~uORF:IOH45853	189	45	144
B06R07C18	6-18-7	Hs~Ref:NM_024508.3~uORF:IOH45853	173	44	129
B06R07C19	6-19-7	Hs~Ref:NM_033306.1~uORF:IOH45759	123	41	82
B06R07C20	6-20-7	Hs~Ref:NM_033306.1~uORF:IOH45759	122	40	82
B06R07C21	6-21-7	Hs~Ref:NM_002401.2~N/A	1803	38	1765
B06R07C22	6-22-7	Hs~Ref:NM_002401.2~N/A	1865	38	1827
B06R08C01	6-1-8	Hs~Ref:NM_003177.2~N/A	416	51	365
B06R08C02	6-2-8	Hs~Ref:NM_003177.2~N/A	444	69	375
B06R08C03	6-3-8	Hs~Ref:NM_001433.1~N/A	519	150	369
B06R08C04	6-4-8	Hs~Ref:NM_001433.1~N/A	313	88	225
B06R08C05	6-5-8	Hs~Ref:NM_001315.1~N/A	532	95	437
B06R08C06	6-6-8	Hs~Ref:NM_001315.1~N/A	456	131	325
B06R08C07	6-7-8	Hs~Ref:NM_014251.1~uORF:IOH13160	468	97	371
B06R08C08	6-8-8	Hs~Ref:NM_014251.1~uORF:IOH13160	219	53	166
B06R08C09	6-9-8	Hs~MGC:BC033167.1~uORF:IOH23232	578	56	522
B06R08C10	6-10-8	Hs~MGC:BC033167.1~uORF:IOH23232	528	56	472
B06R08C11	6-11-8	Hs~MGC:BC014640.1~uORF:IOH12428	448	72	376
B06R08C12	6-12-8	Hs~MGC:BC014640.1~uORF:IOH12428	247	50	197
B06R08C13	6-13-8	Hs~Ref:NM_001640.3~uORF:IOH3679	377	47	330
B06R08C14	6-14-8	Hs~Ref:NM_001640.3~uORF:IOH3679	378	63	315
B06R08C15	6-15-8	Hs~Ref:NM_001834.2~uORF:IOH43456	420	69	351
B06R08C16	6-16-8	Hs~Ref:NM_001834.2~uORF:IOH43456	445	55	390
B06R08C17	6-17-8	Hs~Ref:NM_022041.2~uORF:IOH25725	605	43	562
B06R08C18	6-18-8	Hs~Ref:NM_022041.2~uORF:IOH25725	621	41	580
B06R08C19	6-19-8	Hs~Ref:NM_032417.2~uORF:IOH57369	694	46	648
B06R08C20	6-20-8	Hs~Ref:NM_032417.2~uORF:IOH57369	650	43	607
B06R08C21	6-21-8	Hs~Ref:NM_018199.1~uORF:IOH4885	541	38	503
B06R08C22	6-22-8	Hs~Ref:NM_018199.1~uORF:IOH4885	518	37	481
B06R09C01	6-1-9	Hs~Ref:NM_182692.1~uORF:IOH38187	420	46	374
B06R09C02	6-2-9	Hs~Ref:NM_182692.1~uORF:IOH38187	1829	64	1765
B06R09C03	6-3-9	Hs~Ref:NM_001003397.1~uORF:IOH58745	26242	106	26136
B06R09C04	6-4-9	Hs~Ref:NM_001003397.1~uORF:IOH58745	26540	101	26439
B06R09C05	6-5-9	Hs~Ref:NM_003165.1~uORF:IOH52429	824	156	668
B06R09C06	6-6-9	Hs~Ref:NM_003165.1~uORF:IOH52429	680	73	607
B06R09C07	6-7-9	Hs~Ref:NM_170746.2~uORF:IOH58679	285	58	227
B06R09C08	6-8-9	Hs~Ref:NM_170746.2~uORF:IOH58679	212	54	158
B06R09C09	6-9-9	Hs~Ref:NM_017541.2~uORF:IOH56649	127	48	79
B06R09C10	6-10-9	Hs~Ref:NM_017541.2~uORF:IOH56649	171	95	76
B06R09C11	6-11-9	Hs~Ref:NM_000373.1~uORF:IOH56733	320	198	122
B06R09C12	6-12-9	Hs~Ref:NM_000373.1~uORF:IOH56733	291	61	230
B06R09C13	6-13-9	Hs~Ref:NM_006900.2~uORF:IOH56629	196	53	143
B06R09C14	6-14-9	Hs~Ref:NM_006900.2~uORF:IOH56629	183	87	96
B06R09C15	6-15-9	Hs~MGC:BC009239.2~uORF:IOH57087	415	77	338
B06R09C16	6-16-9	Hs~MGC:BC009239.2~uORF:IOH57087	397	76	321
B06R09C17	6-17-9	Hs~MGC:NM_152474.2~uORF:IOH25857	500	46	454
B06R09C18	6-18-9	Hs~MGC:NM_152474.2~uORF:IOH25857	382	43	339
B06R09C19	6-19-9	Hs~MGC:BC005388.1~uORF:IOH7239	57	47	10
B06R09C20	6-20-9	Hs~MGC:BC005388.1~uORF:IOH7239	38	54	-16
B06R09C21	6-21-9	Hs~MGC:BC006273.1~uORF:IOH6379	296	41	255
B06R09C22	6-22-9	Hs~MGC:BC006273.1~uORF:IOH6379	272	41	231
B06R10C01	6-1-10	Hs~Ref:NM_018052.2~uORF:IOH6786	213	46	167
B06R10C02	6-2-10	Hs~Ref:NM_018052.2~uORF:IOH6786	310	60	250
B06R10C03	6-3-10	Hs~Ref:NM_002399.2~uORF:IOH13086	830	64	766
B06R10C04	6-4-10	Hs~Ref:NM_002399.2~uORF:IOH13086	307	231	76
B06R10C05	6-5-10	Hs~MGC:BC007894.2~uORF:IOH6720	368	75	293
B06R10C06	6-6-10	Hs~MGC:BC007894.2~uORF:IOH6720	405	58	347
B06R10C07	6-7-10	Hs~Ref:NM_016016.1~uORF:IOH3982	387	59	328
B06R10C08	6-8-10	Hs~Ref:NM_016016.1~uORF:IOH3982	47	61	-14
B06R10C09	6-9-10	Hs~Ref:NM_003337.2~uORF:IOH7555	695	107	588
B06R10C10	6-10-10	Hs~Ref:NM_003337.2~uORF:IOH7555	514	62	452
B06R10C11	6-11-10	GST1	158	44	114
B06R10C12	6-12-10	GST1	46	43	3
B06R10C13	6-13-10	GST2	78	43	35
B06R10C14	6-14-10	GST2	58	47	11
B06R10C15	6-15-10	GST3	51	45	6
B06R10C16	6-16-10	GST3	49	45	4
B06R10C17	6-17-10	GST4	57	41	16
B06R10C18	6-18-10	GST4	47	42	5
B06R10C19	6-19-10	Anti-HumanIgA1~N/A	8272	40	8232
B06R10C20	6-20-10	Anti-HumanIgA1~N/A	9147	42	9105
B06R10C21	6-21-10	Anti-HumanIgA2~N/A	17146	54	17092
B06R10C22	6-22-10	Anti-HumanIgA2~N/A	17063	49	17014
B06R11C01	6-1-11	AlexaAntiMouseAb~N/A	23927	41	23886
B06R11C02	6-2-11	AlexaAntiMouseAb~N/A	23524	50	23474
B06R11C03	6-3-11	MAPKAP~N/A	117	48	69
B06R11C04	6-4-11	MAPKAP~N/A	94	49	45
B06R11C05	6-5-11	Buffer	332	114	218
B06R11C06	6-6-11	Buffer	265	47	218
B06R11C07	6-7-11	BSA~N/A	11932	46	11886
B06R11C08	6-8-11	BSA~N/A	11423	49	11374
B06R11C09	6-9-11	Anti-HumanIgG1~N/A	1796	53	1743
B06R11C10	6-10-11	Anti-HumanIgG1~N/A	2244	48	2196
B06R11C11	6-11-11	Anti-HumanIgG2~N/A	4503	44	4459
B06R11C12	6-12-11	Anti-HumanIgG2~N/A	4213	42	4171
B06R11C13	6-13-11	Anti-HumanIgG3~N/A	6513	42	6471
B06R11C14	6-14-11	Anti-HumanIgG3~N/A	7086	42	7044
B06R11C15	6-15-11	Anti-HumanIgG4~N/A	13479	45	13434
B06R11C16	6-16-11	Anti-HumanIgG4~N/A	12205	43	12162
B06R11C17	6-17-11	AntiBiotinAb~N/A	13712	41	13671
B06R11C18	6-18-11	AntiBiotinAb~N/A	13080	41	13039
B06R11C19	6-19-11	Buffer	58	41	17
B06R11C20	6-20-11	Buffer	63	49	14
B06R11C21	6-21-11	Hs~Ref:NM_005801.2~uORF:IOH6916	907	47	860
B06R11C22	6-22-11	Hs~Ref:NM_005801.2~uORF:IOH6916	904	44	860
B06R12C01	6-1-12	Hs~Ref:NM_000449.2~uORF:IOH10040	890	42	848
B06R12C02	6-2-12	Hs~Ref:NM_000449.2~uORF:IOH10040	898	45	853
B06R12C03	6-3-12	Hs~Ref:NM_003068.2~uORF:IOH10082	2230	49	2181
B06R12C04	6-4-12	Hs~Ref:NM_003068.2~uORF:IOH10082	2422	48	2374
B06R12C05	6-5-12	Hs~MGC:BC008318.1~uORF:IOH6883	539	50	489
B06R12C06	6-6-12	Hs~MGC:BC008318.1~uORF:IOH6883	609	60	549
B06R12C07	6-7-12	Hs~Ref:NM_145268.1~uORF:IOH10668	800	49	751
B06R12C08	6-8-12	Hs~Ref:NM_145268.1~uORF:IOH10668	919	49	870
B06R12C09	6-9-12	Hs~Ref:NM_016230.2~uORF:IOH10958	594	51	543
B06R12C10	6-10-12	Hs~Ref:NM_016230.2~uORF:IOH10958	586	48	538
B06R12C11	6-11-12	Hs~MGC:BC005258.1~uORF:IOH7193	569	46	523
B06R12C12	6-12-12	Hs~MGC:BC005258.1~uORF:IOH7193	596	44	552
B06R12C13	6-13-12	Hs~Ref:NM_144647.1~uORF:IOH10664	1184	43	1141
B06R12C14	6-14-12	Hs~Ref:NM_144647.1~uORF:IOH10664	1185	44	1141
B06R12C15	6-15-12	Hs~MGC:BC068483.1~uORF:IOH40534	199	43	156
B06R12C16	6-16-12	Hs~MGC:BC068483.1~uORF:IOH40534	123	42	81
B06R12C17	6-17-12	Hs~MGC:BC066929.1~uORF:IOH40095	171	44	127
B06R12C18	6-18-12	Hs~MGC:BC066929.1~uORF:IOH40095	214	50	164
B06R12C19	6-19-12	Hs~MGC:BC064943.1~uORF:IOH39950	118	40	78
B06R12C20	6-20-12	Hs~MGC:BC064943.1~uORF:IOH39950	118	40	78
B06R12C21	6-21-12	Hs~MGC:BC013120.1~uORF:IOH40178	136	39	97
B06R12C22	6-22-12	Hs~MGC:BC013120.1~uORF:IOH40178	124	40	84
B06R13C01	6-1-13	Hs~MGC:NM_153702.1~uORF:IOH21427	45	37	8
B06R13C02	6-2-13	Hs~MGC:NM_153702.1~uORF:IOH21427	251	37	214
B06R13C03	6-3-13	Hs~MGC:NM_152269.1~uORF:IOH10365	410	50	360
B06R13C04	6-4-13	Hs~MGC:NM_152269.1~uORF:IOH10365	506	53	453
B06R13C05	6-5-13	Hs~Ref:NM_000585.1~uORF:IOH21448	358	97	261
B06R13C06	6-6-13	Hs~Ref:NM_000585.1~uORF:IOH21448	232	62	170
B06R13C07	6-7-13	Hs~MGC:BC018404.1~uORF:IOH21454	425	51	374
B06R13C08	6-8-13	Hs~MGC:BC018404.1~uORF:IOH21454	340	52	288
B06R13C09	6-9-13	Hs~MGC:BC020733.1~uORF:IOH13021	159	50	109
B06R13C10	6-10-13	Hs~MGC:BC020733.1~uORF:IOH13021	163	45	118
B06R13C11	6-11-13	Hs~MGC:BC024021.1~uORF:IOH12764	190	43	147
B06R13C12	6-12-13	Hs~MGC:BC024021.1~uORF:IOH12764	255	44	211
B06R13C13	6-13-13	Hs~MGC:BC012106.1~uORF:IOH13202	305	46	259
B06R13C14	6-14-13	Hs~MGC:BC012106.1~uORF:IOH13202	256	92	164
B06R13C15	6-15-13	Hs~Ref:NM_032181.1~uORF:IOH13482	182	43	139
B06R13C16	6-16-13	Hs~Ref:NM_032181.1~uORF:IOH13482	216	46	170
B06R13C17	6-17-13	Hs~MGC:BC060818.1~uORF:IOH29248	470	43	427
B06R13C18	6-18-13	Hs~MGC:BC060818.1~uORF:IOH29248	452	43	409
B06R13C19	6-19-13	Hs~MGC:BC020597.1~uORF:IOH14197	275	42	233
B06R13C20	6-20-13	Hs~MGC:BC020597.1~uORF:IOH14197	254	63	191
B06R13C21	6-21-13	Hs~MGC:BC009015.1~uORF:IOH3279	235	44	191
B06R13C22	6-22-13	Hs~MGC:BC009015.1~uORF:IOH3279	179	44	135
B06R14C01	6-1-14	Hs~MGC:BC025314.1~uORF:IOH13984	182	37	145
B06R14C02	6-2-14	Hs~MGC:BC025314.1~uORF:IOH13984	176	38	138
B06R14C03	6-3-14	Hs~MGC:BC004305.1~uORF:IOH5525	332	53	279
B06R14C04	6-4-14	Hs~MGC:BC004305.1~uORF:IOH5525	553	83	470
B06R14C05	6-5-14	Hs~Ref:NM_006858.2~uORF:IOH4254	294	51	243
B06R14C06	6-6-14	Hs~Ref:NM_006858.2~uORF:IOH4254	469	49	420
B06R14C07	6-7-14	Hs~MGC:BC009644.1~uORF:IOH9983	758	48	710
B06R14C08	6-8-14	Hs~MGC:BC009644.1~uORF:IOH9983	671	46	625
B06R14C09	6-9-14	Hs~MGC:BC042428.1~uORF:IOH27443	393	52	341
B06R14C10	6-10-14	Hs~MGC:BC042428.1~uORF:IOH27443	2294	114	2180
B06R14C11	6-11-14	Hs~MGC:BC025254.1~uORF:IOH12449	285	54	231
B06R14C12	6-12-14	Hs~MGC:BC025254.1~uORF:IOH12449	192	42	150
B06R14C13	6-13-14	Hs~MGC:NM_173793.2~uORF:IOH22040	235	70	165
B06R14C14	6-14-14	Hs~MGC:NM_173793.2~uORF:IOH22040	247	43	204
B06R14C15	6-15-14	Hs~Ref:NM_020390.3~uORF:IOH27243	130	71	59
B06R14C16	6-16-14	Hs~Ref:NM_020390.3~uORF:IOH27243	157	48	109
B06R14C17	6-17-14	Hs~Ref:NM_022823.1~uORF:IOH21980	257	41	216
B06R14C18	6-18-14	Hs~Ref:NM_022823.1~uORF:IOH21980	299	40	259
B06R14C19	6-19-14	Hs~Ref:NM_005218.2~uORF:IOH26662	276	40	236
B06R14C20	6-20-14	Hs~Ref:NM_005218.2~uORF:IOH26662	256	40	216
B06R14C21	6-21-14	Hs~Ref:NM_002898.1~uORF:IOH11398	415	40	375
B06R14C22	6-22-14	Hs~Ref:NM_002898.1~uORF:IOH11398	457	38	419
B06R15C01	6-1-15	Hs~Ref:NM_000351.3~uORF:IOH44381	81	39	42
B06R15C02	6-2-15	Hs~Ref:NM_000351.3~uORF:IOH44381	558	82	476
B06R15C03	6-3-15	Hs~Ref:NM_018031.2~uORF:IOH42567	285	43	242
B06R15C04	6-4-15	Hs~Ref:NM_018031.2~uORF:IOH42567	287	56	231
B06R15C05	6-5-15	Hs~MGC:BC015932.2~uORF:IOH10047	709	135	574
B06R15C06	6-6-15	Hs~MGC:BC015932.2~uORF:IOH10047	629	54	575
B06R15C07	6-7-15	Hs~MGC:BC027622.2~uORF:IOH26866	2352	46	2306
B06R15C08	6-8-15	Hs~MGC:BC027622.2~uORF:IOH26866	2435	45	2390
B06R15C09	6-9-15	Hs~MGC:BC032007.1~uORF:IOH22165	621	275	346
B06R15C10	6-10-15	Hs~MGC:BC032007.1~uORF:IOH22165	560	266	294
B06R15C11	6-11-15	Hs~Ref:NM_019021.1~uORF:IOH3368	526	43	483
B06R15C12	6-12-15	Hs~Ref:NM_019021.1~uORF:IOH3368	539	42	497
B06R15C13	6-13-15	Hs~IVGN:PM_3502~Ext:myeloperoxidase_IV~N/A	46	38	8
B06R15C14	6-14-15	Hs~IVGN:PM_3502~Ext:myeloperoxidase_IV~N/A	47	41	6
B06R15C15	6-15-15	Hs~Ref:NM_002755.2~CAT:P3099	73	40	33
B06R15C16	6-16-15	Hs~Ref:NM_002755.2~CAT:P3099	72	39	33
B06R15C17	6-17-15	Hs~Ref:NM_053006.1~CAT:PV3622	696	36	660
B06R15C18	6-18-15	Hs~Ref:NM_053006.1~CAT:PV3622	740	36	704
B06R15C19	6-19-15	Hs~Ref:NM_005592.1~CAT:PV3834	435	37	398
B06R15C20	6-20-15	Hs~Ref:NM_005592.1~CAT:PV3834	394	36	358
B06R15C21	6-21-15	Hs~Ref:NM_014720.1~CAT:PV3830	305	36	269
B06R15C22	6-22-15	Hs~Ref:NM_014720.1~CAT:PV3830	330	37	293
B06R16C01	6-1-16	Hs~N/A:NM_001006932.1~CAT:PV3846	276	36	240
B06R16C02	6-2-16	Hs~N/A:NM_001006932.1~CAT:PV3846	205	35	170
B06R16C03	6-3-16	Hs~Ref:NM_032430.1~CAT:PV4333	2004	42	1962
B06R16C04	6-4-16	Hs~Ref:NM_032430.1~CAT:PV4333	3412	50	3362
B06R16C05	6-5-16	Hs~Ref:NM_006648.3~CAT:PV4341	58	46	12
B06R16C06	6-6-16	Hs~Ref:NM_006648.3~CAT:PV4341	59	50	9
B06R16C07	6-7-16	Hs~MGC:BC006304.2~uORF:IOH56932	131	46	85
B06R16C08	6-8-16	Hs~MGC:BC006304.2~uORF:IOH56932	179	48	131
B06R16C09	6-9-16	Hs~MGC:BC006112.1~uORF:IOH56962	169	47	122
B06R16C10	6-10-16	Hs~MGC:BC006112.1~uORF:IOH56962	102	49	53
B06R16C11	6-11-16	Hs~Ref:NM_001842.3~uORF:IOH14561	269	56	213
B06R16C12	6-12-16	Hs~Ref:NM_001842.3~uORF:IOH14561	123	68	55
B06R16C13	6-13-16	Hs~MGC:BC101330.1~uORF:IOH63571	274	47	227
B06R16C14	6-14-16	Hs~MGC:BC101330.1~uORF:IOH63571	203	80	123
B06R16C15	6-15-16	Hs~Ref:NM_138781.2~uORF:IOH58618	435	49	386
B06R16C16	6-16-16	Hs~Ref:NM_138781.2~uORF:IOH58618	403	48	355
B06R16C17	6-17-16	Hs~Ref:NM_182482.1~uORF:IOH58616	369	46	323
B06R16C18	6-18-16	Hs~Ref:NM_182482.1~uORF:IOH58616	317	41	276
B06R16C19	6-19-16	Hs~Ref:NM_182718.1~uORF:IOH58615	347	37	310
B06R16C20	6-20-16	Hs~Ref:NM_182718.1~uORF:IOH58615	299	36	263
B06R16C21	6-21-16	Hs~Ref:NM_002230.1~uORF:IOH54131	355	37	318
B06R16C22	6-22-16	Hs~Ref:NM_002230.1~uORF:IOH54131	372	37	335
B06R17C01	6-1-17	Hs~MGC:BC093762.1~uORF:IOH61990	245	48	197
B06R17C02	6-2-17	Hs~MGC:BC093762.1~uORF:IOH61990	219	34	185
B06R17C03	6-3-17	Hs~MGC:BC093926.1~uORF:IOH62009	212	43	169
B06R17C04	6-4-17	Hs~MGC:BC093926.1~uORF:IOH62009	191	92	99
B06R17C05	6-5-17	Hs~Ref:NM_000759.2~uORF:IOH59727	206	95	111
B06R17C06	6-6-17	Hs~Ref:NM_000759.2~uORF:IOH59727	153	67	86
B06R17C07	6-7-17	Hs~MGC:BC032508.1~uORF:IOH62199	619	51	568
B06R17C08	6-8-17	Hs~MGC:BC032508.1~uORF:IOH62199	482	47	435
B06R17C09	6-9-17	Hs~MGC:BC034247.1~uORF:IOH21451	368	144	224
B06R17C10	6-10-17	Hs~MGC:BC034247.1~uORF:IOH21451	246	56	190
B06R17C11	6-11-17	Hs~Ref:NM_032352.1~uORF:IOH6326	504	103	401
B06R17C12	6-12-17	Hs~Ref:NM_032352.1~uORF:IOH6326	492	43	449
B06R17C13	6-13-17	Hs~Ref:NM_001011658.1~uORF:IOH12376	718	42	676
B06R17C14	6-14-17	Hs~Ref:NM_001011658.1~uORF:IOH12376	692	41	651
B06R17C15	6-15-17	Hs~Ref:NM_001029896.1~uORF:IOH3590	790	41	749
B06R17C16	6-16-17	Hs~Ref:NM_001029896.1~uORF:IOH3590	774	40	734
B06R17C17	6-17-17	Hs~Ref:NM_001008239.1~uORF:IOH45708	1182	43	1139
B06R17C18	6-18-17	Hs~Ref:NM_001008239.1~uORF:IOH45708	1206	41	1165
B06R17C19	6-19-17	Hs~MGC:BC012095.1~uORF:IOH13147	263	37	226
B06R17C20	6-20-17	Hs~MGC:BC012095.1~uORF:IOH13147	241	38	203
B06R17C21	6-21-17	Hs~MGC:BC011399.1~N/A	123	39	84
B06R17C22	6-22-17	Hs~MGC:BC011399.1~N/A	112	37	75
B06R18C01	6-1-18	Hs~Ref:NM_014364.1~uORF:IOH22295	271	37	234
B06R18C02	6-2-18	Hs~Ref:NM_014364.1~uORF:IOH22295	462	47	415
B06R18C03	6-3-18	Hs~Ref:NM_022100.1~uORF:IOH12979	726	197	529
B06R18C04	6-4-18	Hs~Ref:NM_022100.1~uORF:IOH12979	457	49	408
B06R18C05	6-5-18	Hs~MGC:BC001012.2~uORF:IOH4207	441	48	393
B06R18C06	6-6-18	Hs~MGC:BC001012.2~uORF:IOH4207	381	49	332
B06R18C07	6-7-18	Hs~MGC:BC043619.1~uORF:IOH26417	457	51	406
B06R18C08	6-8-18	Hs~MGC:BC043619.1~uORF:IOH26417	484	47	437
B06R18C09	6-9-18	Hs~Ref:NM_000207.1~uORF:IOH7334	417	51	366
B06R18C10	6-10-18	Hs~Ref:NM_000207.1~uORF:IOH7334	329	90	239
B06R18C11	6-11-18	Hs~Ref:NM_031496.1~uORF:IOH4571	226	42	184
B06R18C12	6-12-18	Hs~Ref:NM_031496.1~uORF:IOH4571	207	42	165
B06R18C13	6-13-18	Hs~MGC:BC036767.1~uORF:IOH22101	1018	45	973
B06R18C14	6-14-18	Hs~MGC:BC036767.1~uORF:IOH22101	979	44	935
B06R18C15	6-15-18	Hs~Ref:NM_024677.3~uORF:IOH22080	198	48	150
B06R18C16	6-16-18	Hs~Ref:NM_024677.3~uORF:IOH22080	239	45	194
B06R18C17	6-17-18	Hs~Ref:NM_013368.2~uORF:IOH1790	316	41	275
B06R18C18	6-18-18	Hs~Ref:NM_013368.2~uORF:IOH1790	278	41	237
B06R18C19	6-19-18	Hs~MGC:BC052601.1~uORF:IOH29371	648	37	611
B06R18C20	6-20-18	Hs~MGC:BC052601.1~uORF:IOH29371	646	38	608
B06R18C21	6-21-18	Hs~MGC:BC032864.2~uORF:IOH28650	503	38	465
B06R18C22	6-22-18	Hs~MGC:BC032864.2~uORF:IOH28650	429	37	392
B06R19C01	6-1-19	Hs~Ref:NM_003099.1~uORF:IOH3673	347	37	310
B06R19C02	6-2-19	Hs~Ref:NM_003099.1~uORF:IOH3673	296	58	238
B06R19C03	6-3-19	Hs~MGC:AB065755.1~uORF:IOH28258	327	65	262
B06R19C04	6-4-19	Hs~MGC:AB065755.1~uORF:IOH28258	652	48	604
B06R19C05	6-5-19	Hs~Ref:NM_032360.1~uORF:IOH6003	176	45	131
B06R19C06	6-6-19	Hs~Ref:NM_032360.1~uORF:IOH6003	221	79	142
B06R19C07	6-7-19	Hs~MGC:BC006499.1~uORF:IOH5767	138	83	55
B06R19C08	6-8-19	Hs~MGC:BC006499.1~uORF:IOH5767	94	44	50
B06R19C09	6-9-19	Hs~Ref:NM_002964.3~uORF:IOH7407	173	97	76
B06R19C10	6-10-19	Hs~Ref:NM_002964.3~uORF:IOH7407	89	54	35
B06R19C11	6-11-19	Hs~Ref:NM_006555.2~uORF:IOH5843	330	74	256
B06R19C12	6-12-19	Hs~Ref:NM_006555.2~uORF:IOH5843	291	50	241
B06R19C13	6-13-19	Hs~Ref:NM_000818.1~uORF:IOH42395	384	48	336
B06R19C14	6-14-19	Hs~Ref:NM_000818.1~uORF:IOH42395	329	50	279
B06R19C15	6-15-19	Hs~Ref:NM_001623.3~uORF:IOH13810	134	43	91
B06R19C16	6-16-19	Hs~Ref:NM_001623.3~uORF:IOH13810	162	47	115
B06R19C17	6-17-19	Hs~Ref:NM_144602.1~uORF:IOH11852	483	41	442
B06R19C18	6-18-19	Hs~Ref:NM_144602.1~uORF:IOH11852	441	40	401
B06R19C19	6-19-19	Hs~MGC:BC028120.1~uORF:IOH11613	483	38	445
B06R19C20	6-20-19	Hs~MGC:BC028120.1~uORF:IOH11613	516	38	478
B06R19C21	6-21-19	Hs~Ref:NM_001906.1~uORF:IOH7194	355	38	317
B06R19C22	6-22-19	Hs~Ref:NM_001906.1~uORF:IOH7194	296	40	256
B06R20C01	6-1-20	Hs~MGC:BC025399.1~uORF:IOH11285	601	35	566
B06R20C02	6-2-20	Hs~MGC:BC025399.1~uORF:IOH11285	447	38	409
B06R20C03	6-3-20	Hs~Ref:NM_138461.1~uORF:IOH21483	403	71	332
B06R20C04	6-4-20	Hs~Ref:NM_138461.1~uORF:IOH21483	673	75	598
B06R20C05	6-5-20	Empty	46	43	3
B06R20C06	6-6-20	Empty	48	45	3
B06R20C07	6-7-20	Hs~MGC:BC030636.1~uORF:IOH22939	202	84	118
B06R20C08	6-8-20	Hs~MGC:BC030636.1~uORF:IOH22939	261	46	215
B06R20C09	6-9-20	Hs~Ref:NM_001277.1~uORF:IOH21323	243	48	195
B06R20C10	6-10-20	Hs~Ref:NM_001277.1~uORF:IOH21323	180	42	138
B06R20C11	6-11-20	Hs~MGC:BC012147.1~uORF:IOH62958	165	40	125
B06R20C12	6-12-20	Hs~MGC:BC012147.1~uORF:IOH62958	238	46	192
B06R20C13	6-13-20	Hs~MGC:BC010092.2~uORF:IOH62921	355	40	315
B06R20C14	6-14-20	Hs~MGC:BC010092.2~uORF:IOH62921	196	40	156
B06R20C15	6-15-20	Hs~Ref:NM_002229.2~uORF:IOH27814	1482	38	1444
B06R20C16	6-16-20	Hs~Ref:NM_002229.2~uORF:IOH27814	1495	40	1455
B06R20C17	6-17-20	Hs~Ref:NM_017798.2~uORF:IOH25880	1325	44	1281
B06R20C18	6-18-20	Hs~Ref:NM_017798.2~uORF:IOH25880	1335	42	1293
B06R20C19	6-19-20	Hs~Ref:NM_015695.1~uORF:IOH38756	346	40	306
B06R20C20	6-20-20	Hs~Ref:NM_015695.1~uORF:IOH38756	309	41	268
B06R20C21	6-21-20	Hs~Ref:NM_012219.2~uORF:IOH39681	407	40	367
B06R20C22	6-22-20	Hs~Ref:NM_012219.2~uORF:IOH39681	389	40	349
B06R21C01	6-1-21	Hs~MGC:BC009403.2~uORF:IOH12949	215	35	180
B06R21C02	6-2-21	Hs~MGC:BC009403.2~uORF:IOH12949	185	37	148
B06R21C03	6-3-21	Hs~MGC:BC018007.1~uORF:IOH13351	438	58	380
B06R21C04	6-4-21	Hs~MGC:BC018007.1~uORF:IOH13351	970	109	861
B06R21C05	6-5-21	Hs~Ref:NM_005223.3~uORF:IOH23149	276	53	223
B06R21C06	6-6-21	Hs~Ref:NM_005223.3~uORF:IOH23149	480	101	379
B06R21C07	6-7-21	Hs~MGC:BC010099.2~uORF:IOH13184	166	52	114
B06R21C08	6-8-21	Hs~MGC:BC010099.2~uORF:IOH13184	354	75	279
B06R21C09	6-9-21	Hs~Ref:NP_055190.2~CAT_11834-H08H-25	39	43	-4
B06R21C10	6-10-21	Hs~Ref:NP_055190.2~CAT_11834-H08H-25	40	39	1
B06R21C11	6-11-21	Internal_1007209	39	40	-1
B06R21C12	6-12-21	Internal_1007209	49	37	12
B06R21C13	6-13-21	Hs~Ref:P01344-1~CAT_13032-H24E-25	395	38	357
B06R21C14	6-14-21	Hs~Ref:P01344-1~CAT_13032-H24E-25	44	35	9
B06R21C15	6-15-21	Internal_1007209	71	46	25
B06R21C16	6-16-21	Internal_1007209	107	46	61
B06R21C17	6-17-21	Hs~Ref:NP_001775.2~CAT_11280-H02H-25	21823	41	21782
B06R21C18	6-18-21	Hs~Ref:NP_001775.2~CAT_11280-H02H-25	19696	40	19656
B06R21C19	6-19-21	Internal_1007209	35	36	-1
B06R21C20	6-20-21	Internal_1007209	39	35	4
B06R21C21	6-21-21	Internal_1007209	42	36	6
B06R21C22	6-22-21	Internal_1007209	38	37	1
B06R22C01	6-1-22	ERa~N/A	2319	34	2285
B06R22C02	6-2-22	ERa~N/A	2152	34	2118
B06R22C03	6-3-22	PKCeta~N/A	262	38	224
B06R22C04	6-4-22	PKCeta~N/A	430	64	366
B06R22C05	6-5-22	Calmodulin~N/A	192	59	133
B06R22C06	6-6-22	Calmodulin~N/A	132	46	86
B06R22C07	6-7-22	V5control5~N/A	701	47	654
B06R22C08	6-8-22	V5control5~N/A	699	43	656
B06R22C09	6-9-22	V5control4~N/A	218	42	176
B06R22C10	6-10-22	V5control4~N/A	141	43	98
B06R22C11	6-11-22	V5control3~N/A	41	40	1
B06R22C12	6-12-22	V5control3~N/A	87	40	47
B06R22C13	6-13-22	V5control2~N/A	53	41	12
B06R22C14	6-14-22	V5control2~N/A	69	38	31
B06R22C15	6-15-22	V5control1~N/A	71	36	35
B06R22C16	6-16-22	V5control1~N/A	68	38	30
B06R22C17	6-17-22	CMK2A~N/A	609	36	573
B06R22C18	6-18-22	CMK2A~N/A	534	36	498
B06R22C19	6-19-22	ERa~N/A	1765	35	1730
B06R22C20	6-20-22	ERa~N/A	1732	35	1697
B06R22C21	6-21-22	AlexaAntiMouseAb~N/A	9536	36	9500
B06R22C22	6-22-22	AlexaAntiMouseAb~N/A	10787	36	10751
B07R01C01	7-1-1	AlexaAntiMouseAb~N/A	35296	46	35250
B07R01C02	7-2-1	AlexaAntiMouseAb~N/A	39884	41	39843
B07R01C03	7-3-1	ERa~N/A	1671	39	1632
B07R01C04	7-4-1	ERa~N/A	1715	39	1676
B07R01C05	7-5-1	HumanIgG1~N/A	1083	39	1044
B07R01C06	7-6-1	HumanIgG1~N/A	1076	40	1036
B07R01C07	7-7-1	HumanIgG2~N/A	3274	40	3234
B07R01C08	7-8-1	HumanIgG2~N/A	3151	41	3110
B07R01C09	7-9-1	HumanIgG3~N/A	15103	41	15062
B07R01C10	7-10-1	HumanIgG3~N/A	14886	42	14844
B07R01C11	7-11-1	HumanIgG4~N/A	45776	42	45734
B07R01C12	7-12-1	HumanIgG4~N/A	47773	45	47728
B07R01C13	7-13-1	BiotinAb~N/A	95	52	43
B07R01C14	7-14-1	BiotinAb~N/A	247	55	192
B07R01C15	7-15-1	RanBP2deltaFG~N/A	459	278	181
B07R01C16	7-16-1	RanBP2deltaFG~N/A	370	53	317
B07R01C17	7-17-1	hMDM2~N/A	939	52	887
B07R01C18	7-18-1	hMDM2~N/A	998	393	605
B07R01C19	7-19-1	PKCeta~N/A	485	186	299
B07R01C20	7-20-1	PKCeta~N/A	386	61	325
B07R01C21	7-21-1	AlexaAntiMouseAb~N/A	34894	48	34846
B07R01C22	7-22-1	AlexaAntiMouseAb~N/A	31095	47	31048
B07R02C01	7-1-2	PKCeta~N/A	955	43	912
B07R02C02	7-2-2	PKCeta~N/A	874	43	831
B07R02C03	7-3-2	Buffer	298	128	170
B07R02C04	7-4-2	Buffer	176	41	135
B07R02C05	7-5-2	HumanIgA~N/A	21933	41	21892
B07R02C06	7-6-2	HumanIgA~N/A	21314	41	21273
B07R02C07	7-7-2	Buffer	107	42	65
B07R02C08	7-8-2	Buffer	106	46	60
B07R02C09	7-9-2	BSA~N/A	13133	46	13087
B07R02C10	7-10-2	BSA~N/A	13287	44	13243
B07R02C11	7-11-2	Hs~Ref:NM_144705.1~uORF:IOH11065	1423	44	1379
B07R02C12	7-12-2	Hs~Ref:NM_144705.1~uORF:IOH11065	1281	48	1233
B07R02C13	7-13-2	Hs~Ref:NM_005313.3~uORF:IOH14276	607	57	550
B07R02C14	7-14-2	Hs~Ref:NM_005313.3~uORF:IOH14276	896	395	501
B07R02C15	7-15-2	Hs~MGC:BC014667.1~uORF:IOH14303	65535	77	65458
B07R02C16	7-16-2	Hs~MGC:BC014667.1~uORF:IOH14303	65535	75	65460
B07R02C17	7-17-2	Hs~MGC:BC015614.1~uORF:IOH14601	1197	467	730
B07R02C18	7-18-2	Hs~MGC:BC015614.1~uORF:IOH14601	649	74	575
B07R02C19	7-19-2	Hs~Ref:NM_018667.2~uORF:IOH43841	645	72	573
B07R02C20	7-20-2	Hs~Ref:NM_018667.2~uORF:IOH43841	710	54	656
B07R02C21	7-21-2	Hs~Ref:XM_096883.2~uORF:IOH42301	169	48	121
B07R02C22	7-22-2	Hs~Ref:XM_096883.2~uORF:IOH42301	162	49	113
B07R03C01	7-1-3	Hs~Ref:NM_178463.2~uORF:IOH40984	226	43	183
B07R03C02	7-2-3	Hs~Ref:NM_178463.2~uORF:IOH40984	242	60	182
B07R03C03	7-3-3	Hs~Ref:NM_197962.1~uORF:IOH43651	704	43	661
B07R03C04	7-4-3	Hs~Ref:NM_197962.1~uORF:IOH43651	662	43	619
B07R03C05	7-5-3	Hs~Ref:NM_015129.3~uORF:IOH27517	361	43	318
B07R03C06	7-6-3	Hs~Ref:NM_015129.3~uORF:IOH27517	337	41	296
B07R03C07	7-7-3	Hs~Ref:NM_015927.2~uORF:IOH3924	801	42	759
B07R03C08	7-8-3	Hs~Ref:NM_015927.2~uORF:IOH3924	725	45	680
B07R03C09	7-9-3	Hs~MGC:BC046106.1~uORF:IOH26919	167	51	116
B07R03C10	7-10-3	Hs~MGC:BC046106.1~uORF:IOH26919	170	50	120
B07R03C11	7-11-3	Hs~Ref:NM_006244.1~uORF:IOH27509	336	48	288
B07R03C12	7-12-3	Hs~Ref:NM_006244.1~uORF:IOH27509	338	46	292
B07R03C13	7-13-3	Hs~Ref:NM_006468.3~uORF:IOH4100	397	47	350
B07R03C14	7-14-3	Hs~Ref:NM_006468.3~uORF:IOH4100	392	57	335
B07R03C15	7-15-3	Hs~Ref:NM_020467.2~uORF:IOH3994	10656	62	10594
B07R03C16	7-16-3	Hs~Ref:NM_020467.2~uORF:IOH3994	11350	57	11293
B07R03C17	7-17-3	Hs~MGC:BC010172.2~uORF:IOH12518	483	47	436
B07R03C18	7-18-3	Hs~MGC:BC010172.2~uORF:IOH12518	564	47	517
B07R03C19	7-19-3	Hs~MGC:NM_178191.1~uORF:IOH4850	47	69	-22
B07R03C20	7-20-3	Hs~MGC:NM_178191.1~uORF:IOH4850	47	51	-4
B07R03C21	7-21-3	Hs~MGC:NM_152435.1~uORF:IOH22648	703	47	656
B07R03C22	7-22-3	Hs~MGC:NM_152435.1~uORF:IOH22648	741	49	692
B07R04C01	7-1-4	Hs~Ref:NM_145071.1~uORF:IOH22653	350	43	307
B07R04C02	7-2-4	Hs~Ref:NM_145071.1~uORF:IOH22653	450	48	402
B07R04C03	7-3-4	Hs~MGC:NM_173625.3~uORF:IOH22664	382	65	317
B07R04C04	7-4-4	Hs~MGC:NM_173625.3~uORF:IOH22664	322	54	268
B07R04C05	7-5-4	Hs~MGC:NM_153237.1~uORF:IOH22672	246	44	202
B07R04C06	7-6-4	Hs~MGC:NM_153237.1~uORF:IOH22672	245	42	203
B07R04C07	7-7-4	Hs~Ref:NM_031473.1~uORF:IOH6215	517	41	476
B07R04C08	7-8-4	Hs~Ref:NM_031473.1~uORF:IOH6215	446	41	405
B07R04C09	7-9-4	Hs~Ref:NM_016495.1~uORF:IOH7137	358	46	312
B07R04C10	7-10-4	Hs~Ref:NM_016495.1~uORF:IOH7137	370	47	323
B07R04C11	7-11-4	Hs~Ref:NM_003313.2~uORF:IOH4998	549	46	503
B07R04C12	7-12-4	Hs~Ref:NM_003313.2~uORF:IOH4998	535	45	490
B07R04C13	7-13-4	Hs~MGC:BC003624.1~uORF:IOH3856	228	48	180
B07R04C14	7-14-4	Hs~MGC:BC003624.1~uORF:IOH3856	253	48	205
B07R04C15	7-15-4	Hs~Ref:NM_178496.2~uORF:IOH26761	2011	44	1967
B07R04C16	7-16-4	Hs~Ref:NM_178496.2~uORF:IOH26761	2399	43	2356
B07R04C17	7-17-4	Hs~Ref:NM_145315.2~uORF:IOH39795	358	46	312
B07R04C18	7-18-4	Hs~Ref:NM_145315.2~uORF:IOH39795	360	44	316
B07R04C19	7-19-4	Hs~Ref:NM_016145.1~uORF:IOH39838	306	47	259
B07R04C20	7-20-4	Hs~Ref:NM_016145.1~uORF:IOH39838	336	44	292
B07R04C21	7-21-4	Hs~Ref:NM_153320.1~uORF:IOH12336	318	45	273
B07R04C22	7-22-4	Hs~Ref:NM_153320.1~uORF:IOH12336	118	66	52
B07R05C01	7-1-5	Hs~MGC:BC014299.2~uORF:IOH12128	258	41	217
B07R05C02	7-2-5	Hs~MGC:BC014299.2~uORF:IOH12128	315	49	266
B07R05C03	7-3-5	Hs~Ref:NM_138333.1~uORF:IOH10239	552	68	484
B07R05C04	7-4-5	Hs~Ref:NM_138333.1~uORF:IOH10239	511	54	457
B07R05C05	7-5-5	Hs~MGC:BC005889.2~uORF:IOH5867	636	42	594
B07R05C06	7-6-5	Hs~MGC:BC005889.2~uORF:IOH5867	638	40	598
B07R05C07	7-7-5	Hs~Ref:NM_015926.2~uORF:IOH5918	242	43	199
B07R05C08	7-8-5	Hs~Ref:NM_015926.2~uORF:IOH5918	189	44	145
B07R05C09	7-9-5	Hs~Ref:NM_005518.1~uORF:IOH26365	296	45	251
B07R05C10	7-10-5	Hs~Ref:NM_005518.1~uORF:IOH26365	316	47	269
B07R05C11	7-11-5	Hs~MGC:BC047720.1~uORF:IOH26648	151	55	96
B07R05C12	7-12-5	Hs~MGC:BC047720.1~uORF:IOH26648	151	49	102
B07R05C13	7-13-5	Hs~MGC:BC039729.1~uORF:IOH26128	299	49	250
B07R05C14	7-14-5	Hs~MGC:BC039729.1~uORF:IOH26128	369	43	326
B07R05C15	7-15-5	Hs~MGC:BC041157.1~uORF:IOH26254	103	40	63
B07R05C16	7-16-5	Hs~MGC:BC041157.1~uORF:IOH26254	100	39	61
B07R05C17	7-17-5	Hs~Ref:NM_018147.1~uORF:IOH11086	226	98	128
B07R05C18	7-18-5	Hs~Ref:NM_018147.1~uORF:IOH11086	123	60	63
B07R05C19	7-19-5	Hs~Ref:NM_030778.1~uORF:IOH10715	222	59	163
B07R05C20	7-20-5	Hs~Ref:NM_030778.1~uORF:IOH10715	166	50	116
B07R05C21	7-21-5	Hs~Ref:NM_015918.2~uORF:IOH10987	451	44	407
B07R05C22	7-22-5	Hs~Ref:NM_015918.2~uORF:IOH10987	432	41	391
B07R06C01	7-1-6	Hs~Ref:NM_145168.1~uORF:IOH10914	159	39	120
B07R06C02	7-2-6	Hs~Ref:NM_145168.1~uORF:IOH10914	292	42	250
B07R06C03	7-3-6	Hs~MGC:BC066960.1~uORF:IOH40071	142	42	100
B07R06C04	7-4-6	Hs~MGC:BC066960.1~uORF:IOH40071	151	40	111
B07R06C05	7-5-6	Hs~MGC:BC064634.1~uORF:IOH39924	442	38	404
B07R06C06	7-6-6	Hs~MGC:BC064634.1~uORF:IOH39924	382	39	343
B07R06C07	7-7-6	Hs~Ref:NM_203284.1~uORF:IOH39978	9030	42	8988
B07R06C08	7-8-6	Hs~Ref:NM_203284.1~uORF:IOH39978	8788	47	8741
B07R06C09	7-9-6	Hs~MGC:BC066353.1~uORF:IOH40075	175	124	51
B07R06C10	7-10-6	Hs~MGC:BC066353.1~uORF:IOH40075	154	51	103
B07R06C11	7-11-6	Hs~Ref:NM_032464.1~uORF:IOH45837	287	43	244
B07R06C12	7-12-6	Hs~Ref:NM_032464.1~uORF:IOH45837	268	43	225
B07R06C13	7-13-6	Hs~Ref:NM_002713.2~uORF:IOH45768	892	46	846
B07R06C14	7-14-6	Hs~Ref:NM_002713.2~uORF:IOH45768	852	49	803
B07R06C15	7-15-6	Hs~Ref:NM_212530.1~uORF:IOH45821	451	244	207
B07R06C16	7-16-6	Hs~Ref:NM_212530.1~uORF:IOH45821	397	48	349
B07R06C17	7-17-6	Hs~Ref:NM_198038.1~uORF:IOH45894	263	44	219
B07R06C18	7-18-6	Hs~Ref:NM_198038.1~uORF:IOH45894	247	183	64
B07R06C19	7-19-6	Hs~MGC:BC017355.1~uORF:IOH14046	644	46	598
B07R06C20	7-20-6	Hs~MGC:BC017355.1~uORF:IOH14046	648	42	606
B07R06C21	7-21-6	Hs~MGC:BC017440.1~uORF:IOH14659	1164	40	1124
B07R06C22	7-22-6	Hs~MGC:BC017440.1~uORF:IOH14659	1187	38	1149
B07R07C01	7-1-7	Hs~MGC:NM_153001.1~uORF:IOH13837	283	40	243
B07R07C02	7-2-7	Hs~MGC:NM_153001.1~uORF:IOH13837	286	43	243
B07R07C03	7-3-7	Hs~MGC:BC009949.2~uORF:IOH14336	340	43	297
B07R07C04	7-4-7	Hs~MGC:BC009949.2~uORF:IOH14336	409	44	365
B07R07C05	7-5-7	Hs~MGC:BC004522.1~uORF:IOH5691	149	42	107
B07R07C06	7-6-7	Hs~MGC:BC004522.1~uORF:IOH5691	156	41	115
B07R07C07	7-7-7	Hs~Ref:NM_023940.1~uORF:IOH6072	154	40	114
B07R07C08	7-8-7	Hs~Ref:NM_023940.1~uORF:IOH6072	122	43	79
B07R07C09	7-9-7	Hs~Ref:NM_001664.1~uORF:IOH7574	120	102	18
B07R07C10	7-10-7	Hs~Ref:NM_001664.1~uORF:IOH7574	120	53	67
B07R07C11	7-11-7	Hs~Ref:NM_020673.1~uORF:IOH10004	304	59	245
B07R07C12	7-12-7	Hs~Ref:NM_020673.1~uORF:IOH10004	110	50	60
B07R07C13	7-13-7	Hs~Ref:NM_003104.2~uORF:IOH14671	1170	44	1126
B07R07C14	7-14-7	Hs~Ref:NM_003104.2~uORF:IOH14671	1295	46	1249
B07R07C15	7-15-7	Hs~MGC:BC009738.1~uORF:IOH9861	1060	50	1010
B07R07C16	7-16-7	Hs~MGC:BC009738.1~uORF:IOH9861	1079	48	1031
B07R07C17	7-17-7	Hs~MGC:BC011710.2~uORF:IOH13726	834	41	793
B07R07C18	7-18-7	Hs~MGC:BC011710.2~uORF:IOH13726	849	42	807
B07R07C19	7-19-7	Hs~Ref:NM_032476.1~uORF:IOH13845	1225	41	1184
B07R07C20	7-20-7	Hs~Ref:NM_032476.1~uORF:IOH13845	1160	40	1120
B07R07C21	7-21-7	Hs~Ref:NM_005803.2~uORF:IOH4826	425	41	384
B07R07C22	7-22-7	Hs~Ref:NM_005803.2~uORF:IOH4826	404	41	363
B07R08C01	7-1-8	Hs~Ref:NM_005011.2~uORF:IOH11918	191	41	150
B07R08C02	7-2-8	Hs~Ref:NM_005011.2~uORF:IOH11918	188	48	140
B07R08C03	7-3-8	Hs~Ref:NM_014110.3~uORF:IOH39485	911	46	865
B07R08C04	7-4-8	Hs~Ref:NM_014110.3~uORF:IOH39485	878	42	836
B07R08C05	7-5-8	Hs~Ref:NM_170603.1~uORF:IOH39528	798	41	757
B07R08C06	7-6-8	Hs~Ref:NM_170603.1~uORF:IOH39528	822	40	782
B07R08C07	7-7-8	Hs~Ref:NM_033122.1~uORF:IOH26918	4376	39	4337
B07R08C08	7-8-8	Hs~Ref:NM_033122.1~uORF:IOH26918	4035	41	3994
B07R08C09	7-9-8	Hs~Ref:NM_078476.1~uORF:IOH10883	270	43	227
B07R08C10	7-10-8	Hs~Ref:NM_078476.1~uORF:IOH10883	380	54	326
B07R08C11	7-11-8	Hs~MGC:NM_153498.1~uORF:IOH26033	58	74	-16
B07R08C12	7-12-8	Hs~MGC:NM_153498.1~uORF:IOH26033	236	59	177
B07R08C13	7-13-8	Hs~MGC:BC011792.1~uORF:IOH13815	1050	48	1002
B07R08C14	7-14-8	Hs~MGC:BC011792.1~uORF:IOH13815	1038	46	992
B07R08C15	7-15-8	Hs~MGC:BC031608.1~uORF:IOH22796	634	52	582
B07R08C16	7-16-8	Hs~MGC:BC031608.1~uORF:IOH22796	632	325	307
B07R08C17	7-17-8	Hs~MGC:BC029509.1~uORF:IOH22569	495	50	445
B07R08C18	7-18-8	Hs~MGC:BC029509.1~uORF:IOH22569	503	48	455
B07R08C19	7-19-8	Hs~MGC:BC023286.1~uORF:IOH26797	449	42	407
B07R08C20	7-20-8	Hs~MGC:BC023286.1~uORF:IOH26797	404	41	363
B07R08C21	7-21-8	Hs~MGC:BC018049.1~uORF:IOH26801	586	42	544
B07R08C22	7-22-8	Hs~MGC:BC018049.1~uORF:IOH26801	558	40	518
B07R09C01	7-1-9	Hs~Ref:NM_002486.3~uORF:IOH4014	190	123	67
B07R09C02	7-2-9	Hs~Ref:NM_002486.3~uORF:IOH4014	152	44	108
B07R09C03	7-3-9	Hs~MGC:BC002582.2~uORF:IOH4120	862	42	820
B07R09C04	7-4-9	Hs~MGC:BC002582.2~uORF:IOH4120	838	42	796
B07R09C05	7-5-9	Hs~MGC:BC021704.1~uORF:IOH10916	269	41	228
B07R09C06	7-6-9	Hs~MGC:BC021704.1~uORF:IOH10916	189	43	146
B07R09C07	7-7-9	Hs~MGC:BC005279.1~uORF:IOH7369	290	40	250
B07R09C08	7-8-9	Hs~MGC:BC005279.1~uORF:IOH7369	223	40	183
B07R09C09	7-9-9	Hs~MGC:BC038934.1~uORF:IOH27574	254	41	213
B07R09C10	7-10-9	Hs~MGC:BC038934.1~uORF:IOH27574	345	43	302
B07R09C11	7-11-9	Hs~MGC:BC032698.1~uORF:IOH27591	200	46	154
B07R09C12	7-12-9	Hs~MGC:BC032698.1~uORF:IOH27591	273	45	228
B07R09C13	7-13-9	Hs~MGC:BC057829.1~uORF:IOH29166	199	46	153
B07R09C14	7-14-9	Hs~MGC:BC057829.1~uORF:IOH29166	331	53	278
B07R09C15	7-15-9	Hs~MGC:BC013768.1~uORF:IOH11543	203	42	161
B07R09C16	7-16-9	Hs~MGC:BC013768.1~uORF:IOH11543	202	42	160
B07R09C17	7-17-9	Hs~MGC:BC007242.1~uORF:IOH46096	302	225	77
B07R09C18	7-18-9	Hs~MGC:BC007242.1~uORF:IOH46096	331	152	179
B07R09C19	7-19-9	Hs~MGC:BC000226.1~uORF:IOH46086	274	69	205
B07R09C20	7-20-9	Hs~MGC:BC000226.1~uORF:IOH46086	288	47	241
B07R09C21	7-21-9	Hs~MGC:BC004884.2~uORF:IOH46071	279	62	217
B07R09C22	7-22-9	Hs~MGC:BC004884.2~uORF:IOH46071	236	48	188
B07R10C01	7-1-10	Hs~MGC:BC011636.2~uORF:IOH46091	168	45	123
B07R10C02	7-2-10	Hs~MGC:BC011636.2~uORF:IOH46091	116	43	73
B07R10C03	7-3-10	Hs~Ref:NM_004906.3~uORF:IOH40770	186	47	139
B07R10C04	7-4-10	Hs~Ref:NM_004906.3~uORF:IOH40770	200	52	148
B07R10C05	7-5-10	Hs~MGC:BC062359.1~uORF:IOH40676	185	46	139
B07R10C06	7-6-10	Hs~MGC:BC062359.1~uORF:IOH40676	186	45	141
B07R10C07	7-7-10	Hs~Ref:NM_006552.1~uORF:IOH40719	221	40	181
B07R10C08	7-8-10	Hs~Ref:NM_006552.1~uORF:IOH40719	233	41	192
B07R10C09	7-9-10	Hs~Ref:NM_178232.2~uORF:IOH40677	275	41	234
B07R10C10	7-10-10	Hs~Ref:NM_178232.2~uORF:IOH40677	306	45	261
B07R10C11	7-11-10	GST1	39	41	-2
B07R10C12	7-12-10	GST1	37	42	-5
B07R10C13	7-13-10	GST2	52	40	12
B07R10C14	7-14-10	GST2	49	42	7
B07R10C15	7-15-10	GST3	105	42	63
B07R10C16	7-16-10	GST3	93	48	45
B07R10C17	7-17-10	GST4	70	39	31
B07R10C18	7-18-10	GST4	72	42	30
B07R10C19	7-19-10	Anti-HumanIgA1~N/A	8672	43	8629
B07R10C20	7-20-10	Anti-HumanIgA1~N/A	8806	42	8764
B07R10C21	7-21-10	Anti-HumanIgA2~N/A	16698	44	16654
B07R10C22	7-22-10	Anti-HumanIgA2~N/A	16167	43	16124
B07R11C01	7-1-11	AlexaAntiMouseAb~N/A	25068	40	25028
B07R11C02	7-2-11	AlexaAntiMouseAb~N/A	26524	41	26483
B07R11C03	7-3-11	MAPKAP~N/A	88	43	45
B07R11C04	7-4-11	MAPKAP~N/A	112	48	64
B07R11C05	7-5-11	Buffer	101	45	56
B07R11C06	7-6-11	Buffer	298	45	253
B07R11C07	7-7-11	BSA~N/A	11281	40	11241
B07R11C08	7-8-11	BSA~N/A	11046	40	11006
B07R11C09	7-9-11	Anti-HumanIgG1~N/A	1771	41	1730
B07R11C10	7-10-11	Anti-HumanIgG1~N/A	1763	41	1722
B07R11C11	7-11-11	Anti-HumanIgG2~N/A	3524	41	3483
B07R11C12	7-12-11	Anti-HumanIgG2~N/A	3487	42	3445
B07R11C13	7-13-11	Anti-HumanIgG3~N/A	6499	42	6457
B07R11C14	7-14-11	Anti-HumanIgG3~N/A	6437	41	6396
B07R11C15	7-15-11	Anti-HumanIgG4~N/A	11921	44	11877
B07R11C16	7-16-11	Anti-HumanIgG4~N/A	12576	45	12531
B07R11C17	7-17-11	AntiBiotinAb~N/A	12701	41	12660
B07R11C18	7-18-11	AntiBiotinAb~N/A	11783	42	11741
B07R11C19	7-19-11	Buffer	53	40	13
B07R11C20	7-20-11	Buffer	49	40	9
B07R11C21	7-21-11	Hs~MGC:BC029487.1~uORF:IOH22545	277	57	220
B07R11C22	7-22-11	Hs~MGC:BC029487.1~uORF:IOH22545	191	44	147
B07R12C01	7-1-12	Hs~MGC:BC025926.1~uORF:IOH14187	197	66	131
B07R12C02	7-2-12	Hs~MGC:BC025926.1~uORF:IOH14187	135	41	94
B07R12C03	7-3-12	Hs~Ref:NM_006752.4~uORF:IOH26279	393	60	333
B07R12C04	7-4-12	Hs~Ref:NM_006752.4~uORF:IOH26279	354	49	305
B07R12C05	7-5-12	Hs~Ref:NM_004453.1~uORF:IOH14548	246	41	205
B07R12C06	7-6-12	Hs~Ref:NM_004453.1~uORF:IOH14548	326	42	284
B07R12C07	7-7-12	Hs~Ref:NM_006202.1~uORF:IOH22369	36	39	-3
B07R12C08	7-8-12	Hs~Ref:NM_006202.1~uORF:IOH22369	39	38	1
B07R12C09	7-9-12	Hs~Ref:NM_005510.2~uORF:IOH13910	2622	40	2582
B07R12C10	7-10-12	Hs~Ref:NM_005510.2~uORF:IOH13910	2605	43	2562
B07R12C11	7-11-12	Hs~MGC:BC050444.1~uORF:IOH26738	173	54	119
B07R12C12	7-12-12	Hs~MGC:BC050444.1~uORF:IOH26738	99	47	52
B07R12C13	7-13-12	Hs~MGC:BC037567.1~uORF:IOH27585	180	46	134
B07R12C14	7-14-12	Hs~MGC:BC037567.1~uORF:IOH27585	121	43	78
B07R12C15	7-15-12	Hs~Ref:NM_022650.1~uORF:IOH41794	1415	46	1369
B07R12C16	7-16-12	Hs~Ref:NM_022650.1~uORF:IOH41794	1292	48	1244
B07R12C17	7-17-12	Hs~Ref:NM_024953.2~uORF:IOH44869	324	47	277
B07R12C18	7-18-12	Hs~Ref:NM_024953.2~uORF:IOH44869	176	53	123
B07R12C19	7-19-12	Hs~Ref:NM_182644.1~uORF:IOH44403	287	47	240
B07R12C20	7-20-12	Hs~Ref:NM_182644.1~uORF:IOH44403	276	44	232
B07R12C21	7-21-12	Hs~Ref:NM_024012.1~uORF:IOH42519	381	42	339
B07R12C22	7-22-12	Hs~Ref:NM_024012.1~uORF:IOH42519	380	40	340
B07R13C01	7-1-13	Hs~Ref:NM_032901.2~uORF:IOH6728	552	39	513
B07R13C02	7-2-13	Hs~Ref:NM_032901.2~uORF:IOH6728	666	41	625
B07R13C03	7-3-13	Hs~Ref:NM_006912.3~uORF:IOH29584	1757	45	1712
B07R13C04	7-4-13	Hs~Ref:NM_006912.3~uORF:IOH29584	1791	42	1749
B07R13C05	7-5-13	Hs~MGC:BC008840.2~uORF:IOH46146	698	40	658
B07R13C06	7-6-13	Hs~MGC:BC008840.2~uORF:IOH46146	668	43	625
B07R13C07	7-7-13	Hs~MGC:BC014210.2~uORF:IOH46147	1013	46	967
B07R13C08	7-8-13	Hs~MGC:BC014210.2~uORF:IOH46147	569	44	525
B07R13C09	7-9-13	Hs~Ref:NM_002634.2~uORF:IOH59055	256	42	214
B07R13C10	7-10-13	Hs~Ref:NM_002634.2~uORF:IOH59055	247	42	205
B07R13C11	7-11-13	Hs~Ref:NM_001892.4~uORF:IOH59150	177	47	130
B07R13C12	7-12-13	Hs~Ref:NM_001892.4~uORF:IOH59150	157	61	96
B07R13C13	7-13-13	Hs~MGC:BC074765.2~uORF:IOH59064	440	44	396
B07R13C14	7-14-13	Hs~MGC:BC074765.2~uORF:IOH59064	480	44	436
B07R13C15	7-15-13	Hs~Ref:NM_000175.2~uORF:IOH5104	125	50	75
B07R13C16	7-16-13	Hs~Ref:NM_000175.2~uORF:IOH5104	194	72	122
B07R13C17	7-17-13	Hs~Ref:NM_004310.2~uORF:IOH13574	843	47	796
B07R13C18	7-18-13	Hs~Ref:NM_004310.2~uORF:IOH13574	643	44	599
B07R13C19	7-19-13	Hs~MGC:BC001030.1~uORF:IOH4266	645	218	427
B07R13C20	7-20-13	Hs~MGC:BC001030.1~uORF:IOH4266	605	41	564
B07R13C21	7-21-13	Hs~Ref:NM_002592.1~uORF:IOH3449	747	42	705
B07R13C22	7-22-13	Hs~Ref:NM_002592.1~uORF:IOH3449	668	41	627
B07R14C01	7-1-14	Hs~Ref:NM_004493.1~uORF:IOH3421	1007	37	970
B07R14C02	7-2-14	Hs~Ref:NM_004493.1~uORF:IOH3421	1024	39	985
B07R14C03	7-3-14	Hs~MGC:BC027612.2~uORF:IOH11844	511	41	470
B07R14C04	7-4-14	Hs~MGC:BC027612.2~uORF:IOH11844	540	42	498
B07R14C05	7-5-14	Hs~MGC:BC059371.1~uORF:IOH29259	308	44	264
B07R14C06	7-6-14	Hs~MGC:BC059371.1~uORF:IOH29259	262	43	219
B07R14C07	7-7-14	Hs~Ref:NM_004645.1~uORF:IOH14379	1451	47	1404
B07R14C08	7-8-14	Hs~Ref:NM_004645.1~uORF:IOH14379	1449	45	1404
B07R14C09	7-9-14	Hs~Ref:NM_000184.1~uORF:IOH13644	175	42	133
B07R14C10	7-10-14	Hs~Ref:NM_000184.1~uORF:IOH13644	183	41	142
B07R14C11	7-11-14	Hs~Ref:NM_002799.2~uORF:IOH53883	242	44	198
B07R14C12	7-12-14	Hs~Ref:NM_002799.2~uORF:IOH53883	366	148	218
B07R14C13	7-13-14	Hs~Ref:NM_006243.2~uORF:IOH54021	601	176	425
B07R14C14	7-14-14	Hs~Ref:NM_006243.2~uORF:IOH54021	499	45	454
B07R14C15	7-15-14	Hs~Ref:NM_001870.1~uORF:IOH53977	150	42	108
B07R14C16	7-16-14	Hs~Ref:NM_001870.1~uORF:IOH53977	143	44	99
B07R14C17	7-17-14	Hs~Ref:NM_001176.2~uORF:IOH53858	242	44	198
B07R14C18	7-18-14	Hs~Ref:NM_001176.2~uORF:IOH53858	296	44	252
B07R14C19	7-19-14	Hs~Ref:NM_006698.1~uORF:IOH26699	518	45	473
B07R14C20	7-20-14	Hs~Ref:NM_006698.1~uORF:IOH26699	415	235	180
B07R14C21	7-21-14	Hs~MGC:BC050393.1~uORF:IOH26678	431	42	389
B07R14C22	7-22-14	Hs~MGC:BC050393.1~uORF:IOH26678	361	42	319
B07R15C01	7-1-15	Hs~MGC:BC044612.1~uORF:IOH26756	255	37	218
B07R15C02	7-2-15	Hs~MGC:BC044612.1~uORF:IOH26756	294	39	255
B07R15C03	7-3-15	Hs~Ref:NM_001980.1~uORF:IOH26517	455	43	412
B07R15C04	7-4-15	Hs~Ref:NM_001980.1~uORF:IOH26517	393	41	352
B07R15C05	7-5-15	Hs~MGC:BC093700.1~uORF:IOH61973	370	42	328
B07R15C06	7-6-15	Hs~MGC:BC093700.1~uORF:IOH61973	525	101	424
B07R15C07	7-7-15	Hs~MGC:BC035123.1~uORF:IOH62252	161	48	113
B07R15C08	7-8-15	Hs~MGC:BC035123.1~uORF:IOH62252	49	51	-2
B07R15C09	7-9-15	Hs~MGC:BC036872.1~uORF:IOH62341	279	42	237
B07R15C10	7-10-15	Hs~MGC:BC036872.1~uORF:IOH62341	249	40	209
B07R15C11	7-11-15	Hs~MGC:BC038293.2~uORF:IOH61416	242	41	201
B07R15C12	7-12-15	Hs~MGC:BC038293.2~uORF:IOH61416	195	44	151
B07R15C13	7-13-15	Hs~Ref:NM_002742.1~CAT:PV3791	220	42	178
B07R15C14	7-14-15	Hs~Ref:NM_002742.1~CAT:PV3791	294	45	249
B07R15C15	7-15-15	Hs~Ref:NM_001042452.1~CAT:PV3690	420	43	377
B07R15C16	7-16-15	Hs~Ref:NM_001042452.1~CAT:PV3690	290	47	243
B07R15C17	7-17-15	Hs~Ref:NM_006281.1~CAT:PV4805	465	211	254
B07R15C18	7-18-15	Hs~Ref:NM_006281.1~CAT:PV4805	387	46	341
B07R15C19	7-19-15	Hs~Ref:NM_013302.1~CAT:PV4559	271	44	227
B07R15C20	7-20-15	Hs~Ref:NM_013302.1~CAT:PV4559	279	43	236
B07R15C21	7-21-15	Hs~N/A:NM_005228.3~CAT:PV3873	194	43	151
B07R15C22	7-22-15	Hs~N/A:NM_005228.3~CAT:PV3873	282	47	235
B07R16C01	7-1-16	Hs~Ref:NM_020341.3~CAT:PV4405	145	39	106
B07R16C02	7-2-16	Hs~Ref:NM_020341.3~CAT:PV4405	156	50	106
B07R16C03	7-3-16	Hs~Ref:NM_014002.1~CAT:PV4875	332	42	290
B07R16C04	7-4-16	Hs~Ref:NM_014002.1~CAT:PV4875	299	41	258
B07R16C05	7-5-16	Hs~Ref:NM_014791.1~CAT:PV4823	177	64	113
B07R16C06	7-6-16	Hs~Ref:NM_014791.1~CAT:PV4823	133	71	62
B07R16C07	7-7-16	Hs~MGC:BC095422.1~uORF:IOH62620	223	44	179
B07R16C08	7-8-16	Hs~MGC:BC095422.1~uORF:IOH62620	199	43	156
B07R16C09	7-9-16	Hs~MGC:BC067431.1~uORF:IOH62524	306	43	263
B07R16C10	7-10-16	Hs~MGC:BC067431.1~uORF:IOH62524	291	42	249
B07R16C11	7-11-16	Hs~MGC:BC072436.1~uORF:IOH61814	320	42	278
B07R16C12	7-12-16	Hs~MGC:BC072436.1~uORF:IOH61814	395	43	352
B07R16C13	7-13-16	Hs~MGC:BC095401.1~uORF:IOH62645	389	43	346
B07R16C14	7-14-16	Hs~MGC:BC095401.1~uORF:IOH62645	469	44	425
B07R16C15	7-15-16	Hs~MGC:BC051695.1~uORF:IOH26532	544	47	497
B07R16C16	7-16-16	Hs~MGC:BC051695.1~uORF:IOH26532	434	49	385
B07R16C17	7-17-16	Hs~Ref:NM_153337.1~uORF:IOH27298	472	46	426
B07R16C18	7-18-16	Hs~Ref:NM_153337.1~uORF:IOH27298	464	44	420
B07R16C19	7-19-16	Hs~Ref:NM_001033551.1~uORF:IOH26533	572	321	251
B07R16C20	7-20-16	Hs~Ref:NM_001033551.1~uORF:IOH26533	378	64	314
B07R16C21	7-21-16	Hs~MGC:BC054347.1~uORF:IOH28965	612	150	462
B07R16C22	7-22-16	Hs~MGC:BC054347.1~uORF:IOH28965	502	47	455
B07R17C01	7-1-17	Hs~Ref:NM_021210.2~uORF:IOH21962	417	40	377
B07R17C02	7-2-17	Hs~Ref:NM_021210.2~uORF:IOH21962	434	43	391
B07R17C03	7-3-17	Hs~Ref:NM_016616.2~uORF:IOH22105	394	42	352
B07R17C04	7-4-17	Hs~Ref:NM_016616.2~uORF:IOH22105	406	42	364
B07R17C05	7-5-17	Hs~Ref:NM_001167.2~uORF:IOH21984	3559	54	3505
B07R17C06	7-6-17	Hs~Ref:NM_001167.2~uORF:IOH21984	3453	56	3397
B07R17C07	7-7-17	Hs~Ref:NM_178821.1~uORF:IOH22298	558	45	513
B07R17C08	7-8-17	Hs~Ref:NM_178821.1~uORF:IOH22298	623	42	581
B07R17C09	7-9-17	Hs~MGC:BC071674.1~uORF:IOH61797	372	108	264
B07R17C10	7-10-17	Hs~MGC:BC071674.1~uORF:IOH61797	284	81	203
B07R17C11	7-11-17	Hs~MGC:BC067435.1~uORF:IOH62535	349	43	306
B07R17C12	7-12-17	Hs~MGC:BC067435.1~uORF:IOH62535	418	42	376
B07R17C13	7-13-17	Hs~MGC:BC084582.1~uORF:IOH62563	83	44	39
B07R17C14	7-14-17	Hs~MGC:BC084582.1~uORF:IOH62563	326	44	282
B07R17C15	7-15-17	Hs~MGC:BC067859.1~uORF:IOH62489	148	41	107
B07R17C16	7-16-17	Hs~MGC:BC067859.1~uORF:IOH62489	127	42	85
B07R17C17	7-17-17	Hs~Ref:NM_003374.1~uORF:IOH7514	309	47	262
B07R17C18	7-18-17	Hs~Ref:NM_003374.1~uORF:IOH7514	599	47	552
B07R17C19	7-19-17	Hs~Ref:NM_078470.1~uORF:IOH3663	672	48	624
B07R17C20	7-20-17	Hs~Ref:NM_078470.1~uORF:IOH3663	758	50	708
B07R17C21	7-21-17	Hs~Ref:XM_378356.1~uORF:IOH43700	626	46	580
B07R17C22	7-22-17	Hs~Ref:XM_378356.1~uORF:IOH43700	589	169	420
B07R18C01	7-1-18	Hs~MGC:BC002755.1~N/A	612	38	574
B07R18C02	7-2-18	Hs~MGC:BC002755.1~N/A	572	42	530
B07R18C03	7-3-18	Hs~MGC:BC040558.1~uORF:IOH27718	192	52	140
B07R18C04	7-4-18	Hs~MGC:BC040558.1~uORF:IOH27718	224	40	184
B07R18C05	7-5-18	Hs~MGC:BC051687.1~uORF:IOH26538	296	42	254
B07R18C06	7-6-18	Hs~MGC:BC051687.1~uORF:IOH26538	306	42	264
B07R18C07	7-7-18	Hs~MGC:BC047472.1~uORF:IOH26486	159	44	115
B07R18C08	7-8-18	Hs~MGC:BC047472.1~uORF:IOH26486	219	41	178
B07R18C09	7-9-18	Hs~Ref:NM_005191.2~uORF:IOH27312	192	43	149
B07R18C10	7-10-18	Hs~Ref:NM_005191.2~uORF:IOH27312	168	45	123
B07R18C11	7-11-18	Hs~MGC:BC036900.1~uORF:IOH56423	490	45	445
B07R18C12	7-12-18	Hs~MGC:BC036900.1~uORF:IOH56423	455	43	412
B07R18C13	7-13-18	Hs~Ref:NM_018154.2~uORF:IOH56957	263	45	218
B07R18C14	7-14-18	Hs~Ref:NM_018154.2~uORF:IOH56957	343	45	298
B07R18C15	7-15-18	Hs~MGC:BC096341.1~uORF:IOH63245	310	115	195
B07R18C16	7-16-18	Hs~MGC:BC096341.1~uORF:IOH63245	237	47	190
B07R18C17	7-17-18	Hs~Ref:NM_001971.4~uORF:IOH60513	120	46	74
B07R18C18	7-18-18	Hs~Ref:NM_001971.4~uORF:IOH60513	192	102	90
B07R18C19	7-19-18	Hs~Ref:NM_003656.3~N/A	180	49	131
B07R18C20	7-20-18	Hs~Ref:NM_003656.3~N/A	195	45	150
B07R18C21	7-21-18	Hs~Ref:NM_001274.2~N/A	38	40	-2
B07R18C22	7-22-18	Hs~Ref:NM_001274.2~N/A	36	39	-3
B07R19C01	7-1-19	Hs~Ref:NM_001715.1~N/A	392	39	353
B07R19C02	7-2-19	Hs~Ref:NM_001715.1~N/A	369	41	328
B07R19C03	7-3-19	Hs~Ref:NM_032806.4~uORF:IOH29140	215	41	174
B07R19C04	7-4-19	Hs~Ref:NM_032806.4~uORF:IOH29140	257	57	200
B07R19C05	7-5-19	Hs~Ref:NM_145020.1~uORF:IOH22338	1073	40	1033
B07R19C06	7-6-19	Hs~Ref:NM_145020.1~uORF:IOH22338	1309	43	1266
B07R19C07	7-7-19	Hs~MGC:BC031606.1~uORF:IOH22809	44	81	-37
B07R19C08	7-8-19	Hs~MGC:BC031606.1~uORF:IOH22809	492	45	447
B07R19C09	7-9-19	Hs~MGC:BC030260.1~uORF:IOH21521	420	42	378
B07R19C10	7-10-19	Hs~MGC:BC030260.1~uORF:IOH21521	417	42	375
B07R19C11	7-11-19	Hs~MGC:BC033871.1~uORF:IOH21866	505	44	461
B07R19C12	7-12-19	Hs~MGC:BC033871.1~uORF:IOH21866	528	62	466
B07R19C13	7-13-19	Hs~MGC:BC007766.1~uORF:IOH6455	297	46	251
B07R19C14	7-14-19	Hs~MGC:BC007766.1~uORF:IOH6455	358	48	310
B07R19C15	7-15-19	Hs~Ref:NM_014515.1~uORF:IOH4119	391	42	349
B07R19C16	7-16-19	Hs~Ref:NM_014515.1~uORF:IOH4119	426	41	385
B07R19C17	7-17-19	Hs~MGC:BC029562.1~uORF:IOH21575	492	85	407
B07R19C18	7-18-19	Hs~MGC:BC029562.1~uORF:IOH21575	421	45	376
B07R19C19	7-19-19	Hs~MGC:NM_152717.1~uORF:IOH22811	406	135	271
B07R19C20	7-20-19	Hs~MGC:NM_152717.1~uORF:IOH22811	69	49	20
B07R19C21	7-21-19	Hs~Ref:NM_000486.2~uORF:IOH27325	661	43	618
B07R19C22	7-22-19	Hs~Ref:NM_000486.2~uORF:IOH27325	618	42	576
B07R20C01	7-1-20	Hs~MGC:NM_182665.1~uORF:IOH25788	420	42	378
B07R20C02	7-2-20	Hs~MGC:NM_182665.1~uORF:IOH25788	378	43	335
B07R20C03	7-3-20	Hs~MGC:BC037333.1~uORF:IOH27700	315	43	272
B07R20C04	7-4-20	Hs~MGC:BC037333.1~uORF:IOH27700	384	72	312
B07R20C05	7-5-20	Hs~MGC:NM_198081.1~uORF:IOH25820	36	40	-4
B07R20C06	7-6-20	Hs~MGC:NM_198081.1~uORF:IOH25820	37	38	-1
B07R20C07	7-7-20	Hs~Ref:NM_032182.2~uORF:IOH10212	131	41	90
B07R20C08	7-8-20	Hs~Ref:NM_032182.2~uORF:IOH10212	124	55	69
B07R20C09	7-9-20	Hs~MGC:BC020577.1~uORF:IOH21439	320	44	276
B07R20C10	7-10-20	Hs~MGC:BC020577.1~uORF:IOH21439	73	51	22
B07R20C11	7-11-20	Hs~MGC:BC003656.1~uORF:IOH27778	77	54	23
B07R20C12	7-12-20	Hs~MGC:BC003656.1~uORF:IOH27778	200	47	153
B07R20C13	7-13-20	Hs~MGC:BC053602.1~uORF:IOH28986	176	50	126
B07R20C14	7-14-20	Hs~MGC:BC053602.1~uORF:IOH28986	196	183	13
B07R20C15	7-15-20	Hs~MGC:NM_173472.1~uORF:IOH11568	126	44	82
B07R20C16	7-16-20	Hs~MGC:NM_173472.1~uORF:IOH11568	188	53	135
B07R20C17	7-17-20	Hs~Ref:NM_001004714.1~uORF:IOH28305	139	50	89
B07R20C18	7-18-20	Hs~Ref:NM_001004714.1~uORF:IOH28305	40	47	-7
B07R20C19	7-19-20	Hs~MGC:BC038515.1~uORF:IOH27707	473	45	428
B07R20C20	7-20-20	Hs~MGC:BC038515.1~uORF:IOH27707	464	46	418
B07R20C21	7-21-20	Hs~MGC:BC005404.1~uORF:IOH3197	409	46	363
B07R20C22	7-22-20	Hs~MGC:BC005404.1~uORF:IOH3197	502	109	393
B07R21C01	7-1-21	Hs~Ref:NM_002468.2~uORF:IOH9958	168	46	122
B07R21C02	7-2-21	Hs~Ref:NM_002468.2~uORF:IOH9958	139	41	98
B07R21C03	7-3-21	Hs~Ref:NM_016579.1~uORF:IOH4292	2850	39	2811
B07R21C04	7-4-21	Hs~Ref:NM_016579.1~uORF:IOH4292	2894	41	2853
B07R21C05	7-5-21	Hs~MGC:BC009540.1~uORF:IOH9895	239	147	92
B07R21C06	7-6-21	Hs~MGC:BC009540.1~uORF:IOH9895	167	40	127
B07R21C07	7-7-21	Hs~MGC:BC015032.1~uORF:IOH10093	280	39	241
B07R21C08	7-8-21	Hs~MGC:BC015032.1~uORF:IOH10093	404	55	349
B07R21C09	7-9-21	Hs~Ref:NP_001954.2~CAT_10605-H01H-25	38	38	0
B07R21C10	7-10-21	Hs~Ref:NP_001954.2~CAT_10605-H01H-25	39	38	1
B07R21C11	7-11-21	Internal_1007209	40	39	1
B07R21C12	7-12-21	Internal_1007209	41	39	2
B07R21C13	7-13-21	Hs~Ref:NP_057466.1~CAT_10042-H08H-25	38	39	-1
B07R21C14	7-14-21	Hs~Ref:NP_057466.1~CAT_10042-H08H-25	38	39	-1
B07R21C15	7-15-21	Internal_1007209	41	38	3
B07R21C16	7-16-21	Internal_1007209	41	38	3
B07R21C17	7-17-21	Hs~Ref:NP_061947.1~CAT_10171-H02H-25	36	39	-3
B07R21C18	7-18-21	Hs~Ref:NP_061947.1~CAT_10171-H02H-25	37	38	-1
B07R21C19	7-19-21	Internal_1007209	116	40	76
B07R21C20	7-20-21	Internal_1007209	114	42	72
B07R21C21	7-21-21	Internal_1007209	1588	44	1544
B07R21C22	7-22-21	Internal_1007209	1882	43	1839
B07R22C01	7-1-22	ERa~N/A	2411	36	2375
B07R22C02	7-2-22	ERa~N/A	2152	37	2115
B07R22C03	7-3-22	PKCeta~N/A	50	41	9
B07R22C04	7-4-22	PKCeta~N/A	53	40	13
B07R22C05	7-5-22	Calmodulin~N/A	47	40	7
B07R22C06	7-6-22	Calmodulin~N/A	54	41	13
B07R22C07	7-7-22	V5control5~N/A	446	39	407
B07R22C08	7-8-22	V5control5~N/A	459	40	419
B07R22C09	7-9-22	V5control4~N/A	33	36	-3
B07R22C10	7-10-22	V5control4~N/A	37	37	0
B07R22C11	7-11-22	V5control3~N/A	83	38	45
B07R22C12	7-12-22	V5control3~N/A	77	40	37
B07R22C13	7-13-22	V5control2~N/A	82	46	36
B07R22C14	7-14-22	V5control2~N/A	64	45	19
B07R22C15	7-15-22	V5control1~N/A	58	38	20
B07R22C16	7-16-22	V5control1~N/A	57	38	19
B07R22C17	7-17-22	CMK2A~N/A	267	50	217
B07R22C18	7-18-22	CMK2A~N/A	269	54	215
B07R22C19	7-19-22	ERa~N/A	1693	41	1652
B07R22C20	7-20-22	ERa~N/A	1718	40	1678
B07R22C21	7-21-22	AlexaAntiMouseAb~N/A	11748	41	11707
B07R22C22	7-22-22	AlexaAntiMouseAb~N/A	10291	41	10250
B08R01C01	8-1-1	AlexaAntiMouseAb~N/A	37012	46	36966
B08R01C02	8-2-1	AlexaAntiMouseAb~N/A	31168	46	31122
B08R01C03	8-3-1	ERa~N/A	2975	62	2913
B08R01C04	8-4-1	ERa~N/A	2904	69	2835
B08R01C05	8-5-1	HumanIgG1~N/A	753	56	697
B08R01C06	8-6-1	HumanIgG1~N/A	692	52	640
B08R01C07	8-7-1	HumanIgG2~N/A	2169	47	2122
B08R01C08	8-8-1	HumanIgG2~N/A	2194	47	2147
B08R01C09	8-9-1	HumanIgG3~N/A	12158	49	12109
B08R01C10	8-10-1	HumanIgG3~N/A	12527	50	12477
B08R01C11	8-11-1	HumanIgG4~N/A	38908	52	38856
B08R01C12	8-12-1	HumanIgG4~N/A	38841	53	38788
B08R01C13	8-13-1	BiotinAb~N/A	199	57	142
B08R01C14	8-14-1	BiotinAb~N/A	111	60	51
B08R01C15	8-15-1	RanBP2deltaFG~N/A	430	64	366
B08R01C16	8-16-1	RanBP2deltaFG~N/A	264	50	214
B08R01C17	8-17-1	hMDM2~N/A	841	50	791
B08R01C18	8-18-1	hMDM2~N/A	49	54	-5
B08R01C19	8-19-1	PKCeta~N/A	429	58	371
B08R01C20	8-20-1	PKCeta~N/A	283	62	221
B08R01C21	8-21-1	AlexaAntiMouseAb~N/A	36596	62	36534
B08R01C22	8-22-1	AlexaAntiMouseAb~N/A	29475	57	29418
B08R02C01	8-1-2	PKCeta~N/A	904	46	858
B08R02C02	8-2-2	PKCeta~N/A	878	46	832
B08R02C03	8-3-2	Buffer	147	47	100
B08R02C04	8-4-2	Buffer	217	50	167
B08R02C05	8-5-2	HumanIgA~N/A	16424	48	16376
B08R02C06	8-6-2	HumanIgA~N/A	16269	47	16222
B08R02C07	8-7-2	Buffer	69	49	20
B08R02C08	8-8-2	Buffer	78	47	31
B08R02C09	8-9-2	BSA~N/A	8382	46	8336
B08R02C10	8-10-2	BSA~N/A	8596	46	8550
B08R02C11	8-11-2	Hs~MGC:BC032589.1~uORF:IOH21955	681	50	631
B08R02C12	8-12-2	Hs~MGC:BC032589.1~uORF:IOH21955	641	243	398
B08R02C13	8-13-2	Hs~MGC:BC026296.1~uORF:IOH14813	880	333	547
B08R02C14	8-14-2	Hs~MGC:BC026296.1~uORF:IOH14813	453	55	398
B08R02C15	8-15-2	Hs~Ref:NM_021034.1~uORF:IOH58755	862	138	724
B08R02C16	8-16-2	Hs~Ref:NM_021034.1~uORF:IOH58755	556	51	505
B08R02C17	8-17-2	Hs~Ref:NM_006334.2~uORF:IOH58962	501	54	447
B08R02C18	8-18-2	Hs~Ref:NM_006334.2~uORF:IOH58962	60	80	-20
B08R02C19	8-19-2	Hs~MGC:BC006969.1~uORF:IOH7343	313	61	252
B08R02C20	8-20-2	Hs~MGC:BC006969.1~uORF:IOH7343	334	67	267
B08R02C21	8-21-2	Hs~MGC:BC011498.1~uORF:IOH9619	699	72	627
B08R02C22	8-22-2	Hs~MGC:BC011498.1~uORF:IOH9619	611	83	528
B08R03C01	8-1-3	Hs~Ref:NM_004202.1~uORF:IOH11127	78	48	30
B08R03C02	8-2-3	Hs~Ref:NM_004202.1~uORF:IOH11127	54	78	-24
B08R03C03	8-3-3	Hs~Ref:NM_016371.1~uORF:IOH7352	757	141	616
B08R03C04	8-4-3	Hs~Ref:NM_016371.1~uORF:IOH7352	771	460	311
B08R03C05	8-5-3	Hs~Ref:NM_000961.3~uORF:IOH37838	89	66	23
B08R03C06	8-6-3	Hs~Ref:NM_000961.3~uORF:IOH37838	75	51	24
B08R03C07	8-7-3	Hs~Ref:NM_194318.2~uORF:IOH37836	114	49	65
B08R03C08	8-8-3	Hs~Ref:NM_194318.2~uORF:IOH37836	50	49	1
B08R03C09	8-9-3	Hs~Ref:NM_153289.2~uORF:IOH40759	93	48	45
B08R03C10	8-10-3	Hs~Ref:NM_153289.2~uORF:IOH40759	62	50	12
B08R03C11	8-11-3	Hs~Ref:NM_199054.1~uORF:IOH37765	173	50	123
B08R03C12	8-12-3	Hs~Ref:NM_199054.1~uORF:IOH37765	43	54	-11
B08R03C13	8-13-3	Hs~Ref:NM_001985.2~uORF:IOH40972	90	53	37
B08R03C14	8-14-3	Hs~Ref:NM_001985.2~uORF:IOH40972	154	61	93
B08R03C15	8-15-3	Hs~Ref:NM_022908.1~uORF:IOH44482	55	50	5
B08R03C16	8-16-3	Hs~Ref:NM_022908.1~uORF:IOH44482	47	47	0
B08R03C17	8-17-3	Hs~Ref:NM_145311.1~uORF:IOH41041	68	49	19
B08R03C18	8-18-3	Hs~Ref:NM_145311.1~uORF:IOH41041	45	70	-25
B08R03C19	8-19-3	Hs~Ref:NM_145865.1~uORF:IOH35802	294	67	227
B08R03C20	8-20-3	Hs~Ref:NM_145865.1~uORF:IOH35802	61	75	-14
B08R03C21	8-21-3	Hs~MGC:BC029760.1~uORF:IOH22119	379	105	274
B08R03C22	8-22-3	Hs~MGC:BC029760.1~uORF:IOH22119	125	248	-123
B08R04C01	8-1-4	Hs~MGC:BC000026.1~uORF:IOH4716	205	54	151
B08R04C02	8-2-4	Hs~MGC:BC000026.1~uORF:IOH4716	203	60	143
B08R04C03	8-3-4	Hs~MGC:NM_174923.1~uORF:IOH14835	43	68	-25
B08R04C04	8-4-4	Hs~MGC:NM_174923.1~uORF:IOH14835	4062	521	3541
B08R04C05	8-5-4	Hs~Ref:NM_139242.1~uORF:IOH21859	203	51	152
B08R04C06	8-6-4	Hs~Ref:NM_139242.1~uORF:IOH21859	84	51	33
B08R04C07	8-7-4	Hs~Ref:NM_018279.2~uORF:IOH10199	169	52	117
B08R04C08	8-8-4	Hs~Ref:NM_018279.2~uORF:IOH10199	297	66	231
B08R04C09	8-9-4	Hs~MGC:BC010240.1~uORF:IOH10210	216	49	167
B08R04C10	8-10-4	Hs~MGC:BC010240.1~uORF:IOH10210	52	60	-8
B08R04C11	8-11-4	Hs~Ref:NM_058169.1~uORF:IOH10242	39	55	-16
B08R04C12	8-12-4	Hs~Ref:NM_058169.1~uORF:IOH10242	636	65	571
B08R04C13	8-13-4	Hs~Ref:NM_006054.1~uORF:IOH10268	262	48	214
B08R04C14	8-14-4	Hs~Ref:NM_006054.1~uORF:IOH10268	47	64	-17
B08R04C15	8-15-4	Hs~Ref:NM_181349.1~uORF:IOH38225	58	53	5
B08R04C16	8-16-4	Hs~Ref:NM_181349.1~uORF:IOH38225	384	51	333
B08R04C17	8-17-4	Hs~Ref:NM_006403.2~uORF:IOH27637	507	50	457
B08R04C18	8-18-4	Hs~Ref:NM_006403.2~uORF:IOH27637	237	52	185
B08R04C19	8-19-4	Hs~Ref:NM_152716.1~uORF:IOH38079	8810	52	8758
B08R04C20	8-20-4	Hs~Ref:NM_152716.1~uORF:IOH38079	7632	60	7572
B08R04C21	8-21-4	Hs~Ref:NM_005338.4~uORF:IOH38605	558	73	485
B08R04C22	8-22-4	Hs~Ref:NM_005338.4~uORF:IOH38605	488	83	405
B08R05C01	8-1-5	Hs~Ref:NM_015833.1~uORF:IOH38242	708	47	661
B08R05C02	8-2-5	Hs~Ref:NM_015833.1~uORF:IOH38242	733	61	672
B08R05C03	8-3-5	Hs~Ref:NM_178425.1~uORF:IOH38634	2499	48	2451
B08R05C04	8-4-5	Hs~Ref:NM_178425.1~uORF:IOH38634	2377	49	2328
B08R05C05	8-5-5	Hs~Ref:NM_001883.2~uORF:IOH29569	58	52	6
B08R05C06	8-6-5	Hs~Ref:NM_001883.2~uORF:IOH29569	164	49	115
B08R05C07	8-7-5	Hs~Ref:NM_000697.1~uORF:IOH38131	258	62	196
B08R05C08	8-8-5	Hs~Ref:NM_000697.1~uORF:IOH38131	236	80	156
B08R05C09	8-9-5	Hs~Ref:NM_004071.1~N/A	402	52	350
B08R05C10	8-10-5	Hs~Ref:NM_004071.1~N/A	362	50	312
B08R05C11	8-11-5	Hs~Ref:NM_002344.1~N/A	251	49	202
B08R05C12	8-12-5	Hs~Ref:NM_002344.1~N/A	123	72	51
B08R05C13	8-13-5	Hs~Ref:NM_002748.2~N/A	472	57	415
B08R05C14	8-14-5	Hs~Ref:NM_002748.2~N/A	496	64	432
B08R05C15	8-15-5	Hs~Ref:NM_004431.1~N/A	341	50	291
B08R05C16	8-16-5	Hs~Ref:NM_004431.1~N/A	41	82	-41
B08R05C17	8-17-5	Hs~Ref:NM_003691.1~N/A	87	93	-6
B08R05C18	8-18-5	Hs~Ref:NM_003691.1~N/A	529	65	464
B08R05C19	8-19-5	Hs~Ref:NM_006257.1~N/A	260	64	196
B08R05C20	8-20-5	Hs~Ref:NM_006257.1~N/A	501	85	416
B08R05C21	8-21-5	Hs~Ref:NM_012395.1~N/A	63	130	-67
B08R05C22	8-22-5	Hs~Ref:NM_012395.1~N/A	259	68	191
B08R06C01	8-1-6	Hs~Ref:NM_005307.1~N/A	685	39	646
B08R06C02	8-2-6	Hs~Ref:NM_005307.1~N/A	722	43	679
B08R06C03	8-3-6	Hs~Ref:NM_002053.1~uORF:IOH5246	624	44	580
B08R06C04	8-4-6	Hs~Ref:NM_002053.1~uORF:IOH5246	750	48	702
B08R06C05	8-5-6	Hs~MGC:BC033689.1~uORF:IOH21871	1674	47	1627
B08R06C06	8-6-6	Hs~MGC:BC033689.1~uORF:IOH21871	1551	47	1504
B08R06C07	8-7-6	Hs~MGC:BC036910.1~uORF:IOH25910	1416	47	1369
B08R06C08	8-8-6	Hs~MGC:BC036910.1~uORF:IOH25910	1384	46	1338
B08R06C09	8-9-6	Hs~Ref:NM_031452.1~uORF:IOH3904	486	46	440
B08R06C10	8-10-6	Hs~Ref:NM_031452.1~uORF:IOH3904	54	56	-2
B08R06C11	8-11-6	Hs~MGC:BC010458.1~uORF:IOH9663	1066	50	1016
B08R06C12	8-12-6	Hs~MGC:BC010458.1~uORF:IOH9663	1092	52	1040
B08R06C13	8-13-6	Hs~MGC:BC025407.1~uORF:IOH11128	76	70	6
B08R06C14	8-14-6	Hs~MGC:BC025407.1~uORF:IOH11128	1118	53	1065
B08R06C15	8-15-6	Hs~MGC:BC029652.1~uORF:IOH22862	1449	323	1126
B08R06C16	8-16-6	Hs~MGC:BC029652.1~uORF:IOH22862	1448	114	1334
B08R06C17	8-17-6	Hs~MGC:BC029566.1~uORF:IOH21579	1146	52	1094
B08R06C18	8-18-6	Hs~MGC:BC029566.1~uORF:IOH21579	1067	50	1017
B08R06C19	8-19-6	Hs~MGC:BC040020.2~uORF:IOH26263	5329	58	5271
B08R06C20	8-20-6	Hs~MGC:BC040020.2~uORF:IOH26263	4839	71	4768
B08R06C21	8-21-6	Hs~MGC:BC014924.1~uORF:IOH25747	1926	76	1850
B08R06C22	8-22-6	Hs~MGC:BC014924.1~uORF:IOH25747	2106	55	2051
B08R07C01	8-1-7	Hs~MGC:BC038113.1~uORF:IOH26873	255	43	212
B08R07C02	8-2-7	Hs~MGC:BC038113.1~uORF:IOH26873	238	62	176
B08R07C03	8-3-7	Hs~MGC:BC006354.1~uORF:IOH6429	506	46	460
B08R07C04	8-4-7	Hs~MGC:BC006354.1~uORF:IOH6429	548	48	500
B08R07C05	8-5-7	Hs~Ref:NM_052820.1~uORF:IOH4591	2289	51	2238
B08R07C06	8-6-7	Hs~Ref:NM_052820.1~uORF:IOH4591	2094	58	2036
B08R07C07	8-7-7	Hs~Ref:NM_145914.2~uORF:IOH26562	1137	50	1087
B08R07C08	8-8-7	Hs~Ref:NM_145914.2~uORF:IOH26562	1153	45	1108
B08R07C09	8-9-7	Hs~MGC:BC020616.1~uORF:IOH27932	199	42	157
B08R07C10	8-10-7	Hs~MGC:BC020616.1~uORF:IOH27932	150	50	100
B08R07C11	8-11-7	Hs~MGC:BC005008.1~uORF:IOH5603	42	69	-27
B08R07C12	8-12-7	Hs~MGC:BC005008.1~uORF:IOH5603	40	62	-22
B08R07C13	8-13-7	Hs~Ref:NM_003897.2~uORF:IOH6603	88	51	37
B08R07C14	8-14-7	Hs~Ref:NM_003897.2~uORF:IOH6603	228	51	177
B08R07C15	8-15-7	Hs~Ref:NM_000199.2~uORF:IOH26596	58	54	4
B08R07C16	8-16-7	Hs~Ref:NM_000199.2~uORF:IOH26596	40	48	-8
B08R07C17	8-17-7	Hs~Ref:NM_033307.1~uORF:IOH45758	152	44	108
B08R07C18	8-18-7	Hs~Ref:NM_033307.1~uORF:IOH45758	107	45	62
B08R07C19	8-19-7	Hs~MGC:BC035970.1~uORF:IOH27975	64	56	8
B08R07C20	8-20-7	Hs~MGC:BC035970.1~uORF:IOH27975	84	54	30
B08R07C21	8-21-7	Hs~Ref:NM_004850.2~N/A	190	57	133
B08R07C22	8-22-7	Hs~Ref:NM_004850.2~N/A	199	68	131
B08R08C01	8-1-8	Hs~Ref:NM_000208.1~N/A	438	42	396
B08R08C02	8-2-8	Hs~Ref:NM_000208.1~N/A	422	45	377
B08R08C03	8-3-8	Hs~Ref:NM_004445.1~N/A	759	46	713
B08R08C04	8-4-8	Hs~Ref:NM_004445.1~N/A	769	53	716
B08R08C05	8-5-8	Hs~Ref:NM_001896.1~N/A	2766	58	2708
B08R08C06	8-6-8	Hs~Ref:NM_001896.1~N/A	2845	62	2783
B08R08C07	8-7-8	Hs~Ref:NM_003146.2~uORF:IOH4845	549	94	455
B08R08C08	8-8-8	Hs~Ref:NM_003146.2~uORF:IOH4845	581	63	518
B08R08C09	8-9-8	Hs~MGC:BC034937.1~uORF:IOH23263	70	53	17
B08R08C10	8-10-8	Hs~MGC:BC034937.1~uORF:IOH23263	43	58	-15
B08R08C11	8-11-8	Hs~MGC:BC003666.2~uORF:IOH6106	429	62	367
B08R08C12	8-12-8	Hs~MGC:BC003666.2~uORF:IOH6106	408	67	341
B08R08C13	8-13-8	Hs~MGC:BC033195.1~uORF:IOH23247	195	54	141
B08R08C14	8-14-8	Hs~MGC:BC033195.1~uORF:IOH23247	200	57	143
B08R08C15	8-15-8	Hs~Ref:NM_003808.2~uORF:IOH43552	87	57	30
B08R08C16	8-16-8	Hs~Ref:NM_003808.2~uORF:IOH43552	585	53	532
B08R08C17	8-17-8	Hs~MGC:BC033677.1~uORF:IOH40219	1034	46	988
B08R08C18	8-18-8	Hs~MGC:BC033677.1~uORF:IOH40219	855	44	811
B08R08C19	8-19-8	Hs~Ref:NM_058238.1~uORF:IOH23284	274	42	232
B08R08C20	8-20-8	Hs~Ref:NM_058238.1~uORF:IOH23284	254	44	210
B08R08C21	8-21-8	Hs~Ref:NM_006047.4~uORF:IOH13731	3179	49	3130
B08R08C22	8-22-8	Hs~Ref:NM_006047.4~uORF:IOH13731	2974	50	2924
B08R09C01	8-1-9	Hs~Ref:NM_001007072.1~uORF:IOH59911	338	41	297
B08R09C02	8-2-9	Hs~Ref:NM_001007072.1~uORF:IOH59911	399	47	352
B08R09C03	8-3-9	Hs~Ref:NM_033377.1~uORF:IOH58752	15712	59	15653
B08R09C04	8-4-9	Hs~Ref:NM_033377.1~uORF:IOH58752	16349	68	16281
B08R09C05	8-5-9	Hs~Ref:NM_181838.1~uORF:IOH58950	303	49	254
B08R09C06	8-6-9	Hs~Ref:NM_181838.1~uORF:IOH58950	306	52	254
B08R09C07	8-7-9	Hs~Ref:NM_139274.1~uORF:IOH52437	321	48	273
B08R09C08	8-8-9	Hs~Ref:NM_139274.1~uORF:IOH52437	269	49	220
B08R09C09	8-9-9	Hs~Ref:NM_022445.2~uORF:IOH53866	287	45	242
B08R09C10	8-10-9	Hs~Ref:NM_022445.2~uORF:IOH53866	45	117	-72
B08R09C11	8-11-9	Hs~Ref:NM_014972.1~uORF:IOH55892	581	66	515
B08R09C12	8-12-9	Hs~Ref:NM_014972.1~uORF:IOH55892	652	74	578
B08R09C13	8-13-9	Hs~Ref:NM_005335.3~uORF:IOH57089	922	53	869
B08R09C14	8-14-9	Hs~Ref:NM_005335.3~uORF:IOH57089	931	47	884
B08R09C15	8-15-9	Hs~Ref:NM_001011700.1~uORF:IOH54583	426	49	377
B08R09C16	8-16-9	Hs~Ref:NM_001011700.1~uORF:IOH54583	476	49	427
B08R09C17	8-17-9	Hs~MGC:BC028424.1~uORF:IOH11463	43	62	-19
B08R09C18	8-18-9	Hs~MGC:BC028424.1~uORF:IOH11463	42	57	-15
B08R09C19	8-19-9	Hs~Ref:NM_032693.1~uORF:IOH6370	190	46	144
B08R09C20	8-20-9	Hs~Ref:NM_032693.1~uORF:IOH6370	191	49	142
B08R09C21	8-21-9	Hs~Ref:NM_004596.1~uORF:IOH6628	2891	52	2839
B08R09C22	8-22-9	Hs~Ref:NM_004596.1~uORF:IOH6628	2260	46	2214
B08R10C01	8-1-10	Hs~MGC:BC007242.1~uORF:IOH6808	497	40	457
B08R10C02	8-2-10	Hs~MGC:BC007242.1~uORF:IOH6808	525	43	482
B08R10C03	8-3-10	Hs~Ref:NM_024316.1~uORF:IOH12150	44514	46	44468
B08R10C04	8-4-10	Hs~Ref:NM_024316.1~uORF:IOH12150	45770	45	45725
B08R10C05	8-5-10	Hs~MGC:BC007862.2~uORF:IOH6770	479	43	436
B08R10C06	8-6-10	Hs~MGC:BC007862.2~uORF:IOH6770	604	41	563
B08R10C07	8-7-10	Hs~Ref:NM_016485.3~uORF:IOH7511	531	42	489
B08R10C08	8-8-10	Hs~Ref:NM_016485.3~uORF:IOH7511	501	41	460
B08R10C09	8-9-10	Hs~Ref:NM_006406.1~uORF:IOH7551	506	41	465
B08R10C10	8-10-10	Hs~Ref:NM_006406.1~uORF:IOH7551	69	48	21
B08R10C11	8-11-10	GST1	45	43	2
B08R10C12	8-12-10	GST1	43	42	1
B08R10C13	8-13-10	GST2	52	47	5
B08R10C14	8-14-10	GST2	48	42	6
B08R10C15	8-15-10	GST3	45	45	0
B08R10C16	8-16-10	GST3	54	44	10
B08R10C17	8-17-10	GST4	156	43	113
B08R10C18	8-18-10	GST4	47	50	-3
B08R10C19	8-19-10	Anti-HumanIgA1~N/A	6812	45	6767
B08R10C20	8-20-10	Anti-HumanIgA1~N/A	6728	46	6682
B08R10C21	8-21-10	Anti-HumanIgA2~N/A	12398	49	12349
B08R10C22	8-22-10	Anti-HumanIgA2~N/A	12443	48	12395
B08R11C01	8-1-11	AlexaAntiMouseAb~N/A	27393	40	27353
B08R11C02	8-2-11	AlexaAntiMouseAb~N/A	25297	40	25257
B08R11C03	8-3-11	MAPKAP~N/A	93	39	54
B08R11C04	8-4-11	MAPKAP~N/A	89	39	50
B08R11C05	8-5-11	Buffer	100	39	61
B08R11C06	8-6-11	Buffer	129	47	82
B08R11C07	8-7-11	BSA~N/A	7825	40	7785
B08R11C08	8-8-11	BSA~N/A	7631	40	7591
B08R11C09	8-9-11	Anti-HumanIgG1~N/A	1412	40	1372
B08R11C10	8-10-11	Anti-HumanIgG1~N/A	1299	45	1254
B08R11C11	8-11-11	Anti-HumanIgG2~N/A	2658	45	2613
B08R11C12	8-12-11	Anti-HumanIgG2~N/A	2584	43	2541
B08R11C13	8-13-11	Anti-HumanIgG3~N/A	4859	45	4814
B08R11C14	8-14-11	Anti-HumanIgG3~N/A	4764	44	4720
B08R11C15	8-15-11	Anti-HumanIgG4~N/A	8117	47	8070
B08R11C16	8-16-11	Anti-HumanIgG4~N/A	9244	46	9198
B08R11C17	8-17-11	AntiBiotinAb~N/A	9869	44	9825
B08R11C18	8-18-11	AntiBiotinAb~N/A	9662	45	9617
B08R11C19	8-19-11	Buffer	53	43	10
B08R11C20	8-20-11	Buffer	138	44	94
B08R11C21	8-21-11	Hs~Ref:NM_017444.2~uORF:IOH10035	298	89	209
B08R11C22	8-22-11	Hs~Ref:NM_017444.2~uORF:IOH10035	126	69	57
B08R12C01	8-1-12	Hs~Ref:NM_003420.2~uORF:IOH9658	567	43	524
B08R12C02	8-2-12	Hs~Ref:NM_003420.2~uORF:IOH9658	603	44	559
B08R12C03	8-3-12	Hs~MGC:BC016148.1~uORF:IOH10092	467	41	426
B08R12C04	8-4-12	Hs~MGC:BC016148.1~uORF:IOH10092	472	40	432
B08R12C05	8-5-12	Hs~Ref:NM_006653.1~uORF:IOH9654	758	40	718
B08R12C06	8-6-12	Hs~Ref:NM_006653.1~uORF:IOH9654	758	40	718
B08R12C07	8-7-12	Hs~Ref:NM_003338.2~uORF:IOH7482	526	41	485
B08R12C08	8-8-12	Hs~Ref:NM_003338.2~uORF:IOH7482	580	46	534
B08R12C09	8-9-12	Hs~Ref:NM_002966.1~uORF:IOH14651	584	46	538
B08R12C10	8-10-12	Hs~Ref:NM_002966.1~uORF:IOH14651	706	121	585
B08R12C11	8-11-12	Hs~MGC:BC005339.1~uORF:IOH7206	990	52	938
B08R12C12	8-12-12	Hs~MGC:BC005339.1~uORF:IOH7206	871	46	825
B08R12C13	8-13-12	Hs~MGC:BC007102.1~uORF:IOH7474	1190	51	1139
B08R12C14	8-14-12	Hs~MGC:BC007102.1~uORF:IOH7474	958	47	911
B08R12C15	8-15-12	Hs~MGC:BC065522.1~uORF:IOH39948	45	57	-12
B08R12C16	8-16-12	Hs~MGC:BC065522.1~uORF:IOH39948	41	67	-26
B08R12C17	8-17-12	Hs~Ref:NM_002427.2~uORF:IOH40173	46	52	-6
B08R12C18	8-18-12	Hs~Ref:NM_002427.2~uORF:IOH40173	54	46	8
B08R12C19	8-19-12	Hs~MGC:BC067822.1~uORF:IOH40096	826	45	781
B08R12C20	8-20-12	Hs~MGC:BC067822.1~uORF:IOH40096	909	46	863
B08R12C21	8-21-12	Hs~Ref:NM_013347.1~uORF:IOH40374	391	49	342
B08R12C22	8-22-12	Hs~Ref:NM_013347.1~uORF:IOH40374	352	55	297
B08R13C01	8-1-13	Hs~MGC:BC031469.1~uORF:IOH21458	399	41	358
B08R13C02	8-2-13	Hs~MGC:BC031469.1~uORF:IOH21458	434	44	390
B08R13C03	8-3-13	Hs~MGC:BC020985.1~uORF:IOH21447	426	43	383
B08R13C04	8-4-13	Hs~MGC:BC020985.1~uORF:IOH21447	418	43	375
B08R13C05	8-5-13	Hs~Ref:NM_021709.1~uORF:IOH21450	373	40	333
B08R13C06	8-6-13	Hs~Ref:NM_021709.1~uORF:IOH21450	402	41	361
B08R13C07	8-7-13	Hs~MGC:BC013112.2~uORF:IOH21474	500	48	452
B08R13C08	8-8-13	Hs~MGC:BC013112.2~uORF:IOH21474	505	54	451
B08R13C09	8-9-13	Hs~MGC:BC019045.1~uORF:IOH14378	2045	44	2001
B08R13C10	8-10-13	Hs~MGC:BC019045.1~uORF:IOH14378	1906	47	1859
B08R13C11	8-11-13	Hs~MGC:BC017888.1~uORF:IOH13193	95	41	54
B08R13C12	8-12-13	Hs~MGC:BC017888.1~uORF:IOH13193	58	45	13
B08R13C13	8-13-13	Hs~MGC:BC013161.1~uORF:IOH10686	53	49	4
B08R13C14	8-14-13	Hs~MGC:BC013161.1~uORF:IOH10686	201	42	159
B08R13C15	8-15-13	Hs~Ref:NM_144586.1~uORF:IOH13321	959	51	908
B08R13C16	8-16-13	Hs~Ref:NM_144586.1~uORF:IOH13321	1089	55	1034
B08R13C17	8-17-13	Hs~MGC:BC005033.1~uORF:IOH6631	74	50	24
B08R13C18	8-18-13	Hs~MGC:BC005033.1~uORF:IOH6631	273	46	227
B08R13C19	8-19-13	Hs~MGC:BC017305.1~uORF:IOH12450	294	44	250
B08R13C20	8-20-13	Hs~MGC:BC017305.1~uORF:IOH12450	285	44	241
B08R13C21	8-21-13	Hs~MGC:BC013955.2~uORF:IOH29308	1054	46	1008
B08R13C22	8-22-13	Hs~MGC:BC013955.2~uORF:IOH29308	1015	588	427
B08R14C01	8-1-14	Hs~MGC:BC003400.1~uORF:IOH3003	298	40	258
B08R14C02	8-2-14	Hs~MGC:BC003400.1~uORF:IOH3003	355	41	314
B08R14C03	8-3-14	Hs~Ref:NM_014188.2~uORF:IOH5813	459	42	417
B08R14C04	8-4-14	Hs~Ref:NM_014188.2~uORF:IOH5813	448	41	407
B08R14C05	8-5-14	Hs~Ref:NM_020804.2~uORF:IOH27387	570	40	530
B08R14C06	8-6-14	Hs~Ref:NM_020804.2~uORF:IOH27387	628	40	588
B08R14C07	8-7-14	Hs~MGC:BC002448.2~uORF:IOH4300	23291	48	23243
B08R14C08	8-8-14	Hs~MGC:BC002448.2~uORF:IOH4300	22886	51	22835
B08R14C09	8-9-14	Hs~Ref:NM_003953.4~uORF:IOH6689	682	45	637
B08R14C10	8-10-14	Hs~Ref:NM_003953.4~uORF:IOH6689	780	42	738
B08R14C11	8-11-14	Hs~MGC:BC012746.1~uORF:IOH14565	218	44	174
B08R14C12	8-12-14	Hs~MGC:BC012746.1~uORF:IOH14565	211	45	166
B08R14C13	8-13-14	Hs~Ref:NM_005205.2~uORF:IOH27397	523	43	480
B08R14C14	8-14-14	Hs~Ref:NM_005205.2~uORF:IOH27397	397	43	354
B08R14C15	8-15-14	Hs~MGC:BC045167.2~uORF:IOH25851	540	44	496
B08R14C16	8-16-14	Hs~MGC:BC045167.2~uORF:IOH25851	58	46	12
B08R14C17	8-17-14	Hs~MGC:NM_198395.1~uORF:IOH7337	10007	45	9962
B08R14C18	8-18-14	Hs~MGC:NM_198395.1~uORF:IOH7337	10034	43	9991
B08R14C19	8-19-14	Hs~MGC:BC051874.1~uORF:IOH27064	1379	46	1333
B08R14C20	8-20-14	Hs~MGC:BC051874.1~uORF:IOH27064	1291	51	1240
B08R14C21	8-21-14	Hs~Ref:NM_001008710.1~uORF:IOH59674	137	59	78
B08R14C22	8-22-14	Hs~Ref:NM_001008710.1~uORF:IOH59674	43	90	-47
B08R15C01	8-1-15	Hs~Ref:NM_024506.3~uORF:IOH41839	312	39	273
B08R15C02	8-2-15	Hs~Ref:NM_024506.3~uORF:IOH41839	302	40	262
B08R15C03	8-3-15	Hs~MGC:BC053876.1~uORF:IOH28964	312	47	265
B08R15C04	8-4-15	Hs~MGC:BC053876.1~uORF:IOH28964	230	41	189
B08R15C05	8-5-15	Hs~Ref:NM_000998.3~uORF:IOH1576	633	40	593
B08R15C06	8-6-15	Hs~Ref:NM_000998.3~uORF:IOH1576	639	41	598
B08R15C07	8-7-15	Hs~Ref:NM_015364.2~uORF:IOH12176	521	41	480
B08R15C08	8-8-15	Hs~Ref:NM_015364.2~uORF:IOH12176	441	41	400
B08R15C09	8-9-15	Hs~Ref:NM_152677.1~uORF:IOH34851	2631	42	2589
B08R15C10	8-10-15	Hs~Ref:NM_152677.1~uORF:IOH34851	2810	44	2766
B08R15C11	8-11-15	Hs~Ref:NM_001005339.1~uORF:IOH13018	558	50	508
B08R15C12	8-12-15	Hs~Ref:NM_001005339.1~uORF:IOH13018	544	49	495
B08R15C13	8-13-15	Hs~Ref:NM_000061.1~CAT:PV3363	1148	40	1108
B08R15C14	8-14-15	Hs~Ref:NM_000061.1~CAT:PV3363	1144	42	1102
B08R15C15	8-15-15	Hs~N/A:NM_004972.2~CAT:PV4210	38	42	-4
B08R15C16	8-16-15	Hs~N/A:NM_004972.2~CAT:PV4210	46	47	-1
B08R15C17	8-17-15	Hs~IVGN:NM_004465~CAT_PHG0204~N/A	50	44	6
B08R15C18	8-18-15	Hs~IVGN:NM_004465~CAT_PHG0204~N/A	713	44	669
B08R15C19	8-19-15	Hs~Ref:NM_004972.2~CAT:PV4393	45	51	-6
B08R15C20	8-20-15	Hs~Ref:NM_004972.2~CAT:PV4393	51	57	-6
B08R15C21	8-21-15	Hs~MGC:NM_002746.1~CAT:PV3311	44	55	-11
B08R15C22	8-22-15	Hs~MGC:NM_002746.1~CAT:PV3311	41	64	-23
B08R16C01	8-1-16	Hs~N/A:NM_000594.2~CAT_PHC3016	60	40	20
B08R16C02	8-2-16	Hs~N/A:NM_000594.2~CAT_PHC3016	56	39	17
B08R16C03	8-3-16	Hs~Ref:NM_002314.2~CAT:PV4337	1719	42	1677
B08R16C04	8-4-16	Hs~Ref:NM_002314.2~CAT:PV4337	886	45	841
B08R16C05	8-5-16	Hs~Ref:NM_003656.3~CAT:PV4391	39	43	-4
B08R16C06	8-6-16	Hs~Ref:NM_003656.3~CAT:PV4391	44	43	1
B08R16C07	8-7-16	Hs~Ref:NM_001011554.1~uORF:IOH55456	47	45	2
B08R16C08	8-8-16	Hs~Ref:NM_001011554.1~uORF:IOH55456	99	43	56
B08R16C09	8-9-16	Hs~MGC:BC101303.1~uORF:IOH63567	161	43	118
B08R16C10	8-10-16	Hs~MGC:BC101303.1~uORF:IOH63567	93	46	47
B08R16C11	8-11-16	Hs~MGC:BC100863.2~uORF:IOH63510	52	51	1
B08R16C12	8-12-16	Hs~MGC:BC100863.2~uORF:IOH63510	42	75	-33
B08R16C13	8-13-16	Hs~MGC:BC101304.1~uORF:IOH63568	74	48	26
B08R16C14	8-14-16	Hs~MGC:BC101304.1~uORF:IOH63568	68	44	24
B08R16C15	8-15-16	Hs~Ref:NM_001006666.1~uORF:IOH58588	511	46	465
B08R16C16	8-16-16	Hs~Ref:NM_001006666.1~uORF:IOH58588	292	49	243
B08R16C17	8-17-16	Hs~Ref:NM_130463.2~uORF:IOH58658	1113	46	1067
B08R16C18	8-18-16	Hs~Ref:NM_130463.2~uORF:IOH58658	1218	44	1174
B08R16C19	8-19-16	Hs~Ref:NM_031457.1~uORF:IOH53868	86	60	26
B08R16C20	8-20-16	Hs~Ref:NM_031457.1~uORF:IOH53868	52	67	-15
B08R16C21	8-21-16	Hs~Ref:NM_182723.1~uORF:IOH58590	431	82	349
B08R16C22	8-22-16	Hs~Ref:NM_182723.1~uORF:IOH58590	316	44	272
B08R17C01	8-1-17	Hs~MGC:BC038381.1~uORF:IOH62022	170	46	124
B08R17C02	8-2-17	Hs~MGC:BC038381.1~uORF:IOH62022	130	45	85
B08R17C03	8-3-17	Hs~MGC:BC034963.1~uORF:IOH62055	161	104	57
B08R17C04	8-4-17	Hs~MGC:BC034963.1~uORF:IOH62055	191	69	122
B08R17C05	8-5-17	Hs~Ref:NM_182894.1~uORF:IOH34885	80	43	37
B08R17C06	8-6-17	Hs~Ref:NM_182894.1~uORF:IOH34885	206	59	147
B08R17C07	8-7-17	Hs~MGC:BC026069.1~uORF:IOH62080	46	49	-3
B08R17C08	8-8-17	Hs~MGC:BC026069.1~uORF:IOH62080	59	56	3
B08R17C09	8-9-17	Hs~MGC:BC002650.1~uORF:IOH5270	836	43	793
B08R17C10	8-10-17	Hs~MGC:BC002650.1~uORF:IOH5270	57	47	10
B08R17C11	8-11-17	Hs~Ref:NM_001032293.1~uORF:IOH3584	4964	48	4916
B08R17C12	8-12-17	Hs~Ref:NM_001032293.1~uORF:IOH3584	5138	49	5089
B08R17C13	8-13-17	Hs~Ref:NM_005735.2~uORF:IOH5572	501	48	453
B08R17C14	8-14-17	Hs~Ref:NM_005735.2~uORF:IOH5572	647	42	605
B08R17C15	8-15-17	Hs~Ref:NM_002631.2~uORF:IOH3407	760	46	714
B08R17C16	8-16-17	Hs~Ref:NM_002631.2~uORF:IOH3407	750	47	703
B08R17C17	8-17-17	Hs~Ref:NM_003211.1~uORF:IOH27535	386	45	341
B08R17C18	8-18-17	Hs~Ref:NM_003211.1~uORF:IOH27535	357	44	313
B08R17C19	8-19-17	Hs~Ref:NM_004196.2~N/A	1097	50	1047
B08R17C20	8-20-17	Hs~Ref:NM_004196.2~N/A	1240	48	1192
B08R17C21	8-21-17	Hs~Ref:NM_018413.2~uORF:IOH12727	54	50	4
B08R17C22	8-22-17	Hs~Ref:NM_018413.2~uORF:IOH12727	59	46	13
B08R18C01	8-1-18	Hs~Ref:NM_145169.1~uORF:IOH14571	207	40	167
B08R18C02	8-2-18	Hs~Ref:NM_145169.1~uORF:IOH14571	335	48	287
B08R18C03	8-3-18	Hs~MGC:BC028917.1~uORF:IOH22195	549	42	507
B08R18C04	8-4-18	Hs~MGC:BC028917.1~uORF:IOH22195	548	41	507
B08R18C05	8-5-18	Hs~Ref:NM_006687.2~uORF:IOH10967	426	40	386
B08R18C06	8-6-18	Hs~Ref:NM_006687.2~uORF:IOH10967	390	44	346
B08R18C07	8-7-18	Hs~Ref:NM_014399.2~uORF:IOH21837	48	50	-2
B08R18C08	8-8-18	Hs~Ref:NM_014399.2~uORF:IOH21837	44	51	-7
B08R18C09	8-9-18	Hs~Ref:NM_032037.2~uORF:IOH10991	55	56	-1
B08R18C10	8-10-18	Hs~Ref:NM_032037.2~uORF:IOH10991	167	69	98
B08R18C11	8-11-18	Hs~MGC:BC032715.1~uORF:IOH21958	226	44	182
B08R18C12	8-12-18	Hs~MGC:BC032715.1~uORF:IOH21958	184	43	141
B08R18C13	8-13-18	Hs~Ref:NM_175923.2~uORF:IOH22051	643	42	601
B08R18C14	8-14-18	Hs~Ref:NM_175923.2~uORF:IOH22051	583	41	542
B08R18C15	8-15-18	Hs~Ref:NM_133496.3~uORF:IOH39796	66	56	10
B08R18C16	8-16-18	Hs~Ref:NM_133496.3~uORF:IOH39796	48	55	-7
B08R18C17	8-17-18	Hs~MGC:NM_181533.3~uORF:IOH22363	56	48	8
B08R18C18	8-18-18	Hs~MGC:NM_181533.3~uORF:IOH22363	245	56	189
B08R18C19	8-19-18	Hs~MGC:BC001321.1~uORF:IOH3117	845	82	763
B08R18C20	8-20-18	Hs~MGC:BC001321.1~uORF:IOH3117	163	52	111
B08R18C21	8-21-18	Hs~MGC:BC022379.1~uORF:IOH12058	343	74	269
B08R18C22	8-22-18	Hs~MGC:BC022379.1~uORF:IOH12058	315	53	262
B08R19C01	8-1-19	Hs~MGC:BC008919.1~uORF:IOH7021	514	39	475
B08R19C02	8-2-19	Hs~MGC:BC008919.1~uORF:IOH7021	506	42	464
B08R19C03	8-3-19	Hs~MGC:BC042193.1~uORF:IOH26104	873	39	834
B08R19C04	8-4-19	Hs~MGC:BC042193.1~uORF:IOH26104	774	38	736
B08R19C05	8-5-19	Hs~MGC:BC000479.1~uORF:IOH3692	185	39	146
B08R19C06	8-6-19	Hs~MGC:BC000479.1~uORF:IOH3692	156	92	64
B08R19C07	8-7-19	Hs~Ref:NM_018064.1~uORF:IOH6070	59	45	14
B08R19C08	8-8-19	Hs~Ref:NM_018064.1~uORF:IOH6070	43	61	-18
B08R19C09	8-9-19	Hs~MGC:BC022363.1~uORF:IOH23061	42	58	-16
B08R19C10	8-10-19	Hs~MGC:BC022363.1~uORF:IOH23061	82	50	32
B08R19C11	8-11-19	Hs~Ref:NM_004215.2~uORF:IOH10322	114	44	70
B08R19C12	8-12-19	Hs~Ref:NM_004215.2~uORF:IOH10322	181	56	125
B08R19C13	8-13-19	Hs~Ref:NM_178539.3~uORF:IOH42328	309	133	176
B08R19C14	8-14-19	Hs~Ref:NM_178539.3~uORF:IOH42328	232	61	171
B08R19C15	8-15-19	Hs~Ref:NM_020168.3~uORF:IOH20961	808	48	760
B08R19C16	8-16-19	Hs~Ref:NM_020168.3~uORF:IOH20961	950	45	905
B08R19C17	8-17-19	Hs~Ref:NM_145810.1~uORF:IOH11712	630	45	585
B08R19C18	8-18-19	Hs~Ref:NM_145810.1~uORF:IOH11712	50	55	-5
B08R19C19	8-19-19	Hs~Ref:NM_139355.1~uORF:IOH4506	4132	49	4083
B08R19C20	8-20-19	Hs~Ref:NM_139355.1~uORF:IOH4506	4219	47	4172
B08R19C21	8-21-19	Hs~Ref:NM_019613.2~uORF:IOH6706	75	53	22
B08R19C22	8-22-19	Hs~Ref:NM_019613.2~uORF:IOH6706	60	66	-6
B08R20C01	8-1-20	Hs~MGC:BC009674.1~uORF:IOH9894	209	40	169
B08R20C02	8-2-20	Hs~MGC:BC009674.1~uORF:IOH9894	365	49	316
B08R20C03	8-3-20	Empty	41	40	1
B08R20C04	8-4-20	Empty	39	38	1
B08R20C05	8-5-20	Empty	39	38	1
B08R20C06	8-6-20	Empty	41	40	1
B08R20C07	8-7-20	Hs~Ref:NM_030579.1~uORF:IOH5585	914	64	850
B08R20C08	8-8-20	Hs~Ref:NM_030579.1~uORF:IOH5585	100	43	57
B08R20C09	8-9-20	Hs~MGC:BC014020.1~uORF:IOH13375	2064	48	2016
B08R20C10	8-10-20	Hs~MGC:BC014020.1~uORF:IOH13375	2741	47	2694
B08R20C11	8-11-20	Hs~Ref:NM_001039724.1~uORF:IOH63165	1670	44	1626
B08R20C12	8-12-20	Hs~Ref:NM_001039724.1~uORF:IOH63165	1625	43	1582
B08R20C13	8-13-20	Hs~MGC:BC073791.1~uORF:IOH63073	10595	42	10553
B08R20C14	8-14-20	Hs~MGC:BC073791.1~uORF:IOH63073	10561	42	10519
B08R20C15	8-15-20	Hs~Ref:NM_178812.2~uORF:IOH25883	625	50	575
B08R20C16	8-16-20	Hs~Ref:NM_178812.2~uORF:IOH25883	536	44	492
B08R20C17	8-17-20	Hs~Ref:NM_001009938.1~uORF:IOH57338	90	45	45
B08R20C18	8-18-20	Hs~Ref:NM_001009938.1~uORF:IOH57338	54	46	8
B08R20C19	8-19-20	Hs~Ref:NM_001017370.1~uORF:IOH41134	47	49	-2
B08R20C20	8-20-20	Hs~Ref:NM_001017370.1~uORF:IOH41134	53	45	8
B08R20C21	8-21-20	Hs~Ref:NM_207332.1~uORF:IOH25915	115	47	68
B08R20C22	8-22-20	Hs~Ref:NM_207332.1~uORF:IOH25915	120	56	64
B08R21C01	8-1-21	Hs~Ref:ENST00000338534~uORF:IOH41020	142	41	101
B08R21C02	8-2-21	Hs~Ref:ENST00000338534~uORF:IOH41020	89	42	47
B08R21C03	8-3-21	Hs~MGC:BC025340.1~uORF:IOH12714	274	46	228
B08R21C04	8-4-21	Hs~MGC:BC025340.1~uORF:IOH12714	286	59	227
B08R21C05	8-5-21	Hs~MGC:BC033219.1~uORF:IOH23261	989	39	950
B08R21C06	8-6-21	Hs~MGC:BC033219.1~uORF:IOH23261	994	38	956
B08R21C07	8-7-21	Hs~Ref:NM_033012.2~uORF:IOH41061	428	42	386
B08R21C08	8-8-21	Hs~Ref:NM_033012.2~uORF:IOH41061	422	40	382
B08R21C09	8-9-21	Hs~Ref:P14151-1~CAT_11838-H08H-25	430	40	390
B08R21C10	8-10-21	Hs~Ref:P14151-1~CAT_11838-H08H-25	794	42	752
B08R21C11	8-11-21	Internal_1007209	80	43	37
B08R21C12	8-12-21	Internal_1007209	56	50	6
B08R21C13	8-13-21	Hs~Ref:Q02297-1~CAT_13499-H08H-25	37	38	-1
B08R21C14	8-14-21	Hs~Ref:Q02297-1~CAT_13499-H08H-25	37	38	-1
B08R21C15	8-15-21	Internal_1007209	46	40	6
B08R21C16	8-16-21	Internal_1007209	38	40	-2
B08R21C17	8-17-21	Hs~Ref:NP_001822.2~CAT_11297-H08H-25	39	40	-1
B08R21C18	8-18-21	Hs~Ref:NP_001822.2~CAT_11297-H08H-25	40	40	0
B08R21C19	8-19-21	Internal_1007209	41	46	-5
B08R21C20	8-20-21	Internal_1007209	40	40	0
B08R21C21	8-21-21	Internal_1007209	44	40	4
B08R21C22	8-22-21	Internal_1007209	41	40	1
B08R22C01	8-1-22	ERa~N/A	1959	39	1920
B08R22C02	8-2-22	ERa~N/A	2240	40	2200
B08R22C03	8-3-22	PKCeta~N/A	120	47	73
B08R22C04	8-4-22	PKCeta~N/A	46	40	6
B08R22C05	8-5-22	Calmodulin~N/A	47	39	8
B08R22C06	8-6-22	Calmodulin~N/A	72	39	33
B08R22C07	8-7-22	V5control5~N/A	40	42	-2
B08R22C08	8-8-22	V5control5~N/A	73	42	31
B08R22C09	8-9-22	V5control4~N/A	40	39	1
B08R22C10	8-10-22	V5control4~N/A	39	40	-1
B08R22C11	8-11-22	V5control3~N/A	59	40	19
B08R22C12	8-12-22	V5control3~N/A	57	39	18
B08R22C13	8-13-22	V5control2~N/A	54	42	12
B08R22C14	8-14-22	V5control2~N/A	51	39	12
B08R22C15	8-15-22	V5control1~N/A	43	38	5
B08R22C16	8-16-22	V5control1~N/A	46	39	7
B08R22C17	8-17-22	CMK2A~N/A	183	40	143
B08R22C18	8-18-22	CMK2A~N/A	215	41	174
B08R22C19	8-19-22	ERa~N/A	2195	41	2154
B08R22C20	8-20-22	ERa~N/A	2251	40	2211
B08R22C21	8-21-22	AlexaAntiMouseAb~N/A	7945	39	7906
B08R22C22	8-22-22	AlexaAntiMouseAb~N/A	7993	40	7953
B09R01C01	9-1-1	AlexaAntiMouseAb~N/A	30970	35	30935
B09R01C02	9-2-1	AlexaAntiMouseAb~N/A	29817	34	29783
B09R01C03	9-3-1	ERa~N/A	2119	33	2086
B09R01C04	9-4-1	ERa~N/A	1923	33	1890
B09R01C05	9-5-1	HumanIgG1~N/A	1138	33	1105
B09R01C06	9-6-1	HumanIgG1~N/A	1127	34	1093
B09R01C07	9-7-1	HumanIgG2~N/A	3042	34	3008
B09R01C08	9-8-1	HumanIgG2~N/A	2913	34	2879
B09R01C09	9-9-1	HumanIgG3~N/A	14422	34	14388
B09R01C10	9-10-1	HumanIgG3~N/A	11639	35	11604
B09R01C11	9-11-1	HumanIgG4~N/A	36941	37	36904
B09R01C12	9-12-1	HumanIgG4~N/A	38556	35	38521
B09R01C13	9-13-1	BiotinAb~N/A	323	33	290
B09R01C14	9-14-1	BiotinAb~N/A	303	33	270
B09R01C15	9-15-1	RanBP2deltaFG~N/A	323	34	289
B09R01C16	9-16-1	RanBP2deltaFG~N/A	349	35	314
B09R01C17	9-17-1	hMDM2~N/A	760	34	726
B09R01C18	9-18-1	hMDM2~N/A	724	34	690
B09R01C19	9-19-1	PKCeta~N/A	469	33	436
B09R01C20	9-20-1	PKCeta~N/A	447	37	410
B09R01C21	9-21-1	AlexaAntiMouseAb~N/A	33443	44	33399
B09R01C22	9-22-1	AlexaAntiMouseAb~N/A	30863	39	30824
B09R02C01	9-1-2	PKCeta~N/A	1490	34	1456
B09R02C02	9-2-2	PKCeta~N/A	1532	35	1497
B09R02C03	9-3-2	Buffer	269	35	234
B09R02C04	9-4-2	Buffer	298	36	262
B09R02C05	9-5-2	HumanIgA~N/A	19606	35	19571
B09R02C06	9-6-2	HumanIgA~N/A	19149	38	19111
B09R02C07	9-7-2	Buffer	131	70	61
B09R02C08	9-8-2	Buffer	80	37	43
B09R02C09	9-9-2	BSA~N/A	11229	35	11194
B09R02C10	9-10-2	BSA~N/A	11820	38	11782
B09R02C11	9-11-2	Hs~MGC:BC031617.1~uORF:IOH22754	413	39	374
B09R02C12	9-12-2	Hs~MGC:BC031617.1~uORF:IOH22754	400	36	364
B09R02C13	9-13-2	Hs~Ref:NM_006228.2~uORF:IOH22728	448	34	414
B09R02C14	9-14-2	Hs~Ref:NM_006228.2~uORF:IOH22728	423	34	389
B09R02C15	9-15-2	Hs~Ref:NM_005145.1~uORF:IOH12762	210	156	54
B09R02C16	9-16-2	Hs~Ref:NM_005145.1~uORF:IOH12762	288	47	241
B09R02C17	9-17-2	Hs~MGC:BC008699.1~uORF:IOH6051	499	36	463
B09R02C18	9-18-2	Hs~MGC:BC008699.1~uORF:IOH6051	484	35	449
B09R02C19	9-19-2	Hs~MGC:BC030538.2~uORF:IOH21627	501	35	466
B09R02C20	9-20-2	Hs~MGC:BC030538.2~uORF:IOH21627	536	40	496
B09R02C21	9-21-2	Hs~Ref:NM_014303.2~uORF:IOH21738	1529	134	1395
B09R02C22	9-22-2	Hs~Ref:NM_014303.2~uORF:IOH21738	1165	46	1119
B09R03C01	9-1-3	Hs~MGC:BC034229.1~uORF:IOH21596	477	33	444
B09R03C02	9-2-3	Hs~MGC:BC034229.1~uORF:IOH21596	474	34	440
B09R03C03	9-3-3	Hs~Ref:NM_002012.1~uORF:IOH21676	430	36	394
B09R03C04	9-4-3	Hs~Ref:NM_002012.1~uORF:IOH21676	450	36	414
B09R03C05	9-5-3	Hs~MGC:BC010175.1~uORF:IOH13983	385	35	350
B09R03C06	9-6-3	Hs~MGC:BC010175.1~uORF:IOH13983	404	38	366
B09R03C07	9-7-3	Hs~Ref:NM_007002.1~uORF:IOH13967	227	138	89
B09R03C08	9-8-3	Hs~Ref:NM_007002.1~uORF:IOH13967	132	49	83
B09R03C09	9-9-3	Hs~Ref:NM_000860.1~uORF:IOH14612	345	39	306
B09R03C10	9-10-3	Hs~Ref:NM_000860.1~uORF:IOH14612	355	41	314
B09R03C11	9-11-3	Hs~MGC:BC017407.1~uORF:IOH14158	409	42	367
B09R03C12	9-12-3	Hs~MGC:BC017407.1~uORF:IOH14158	421	39	382
B09R03C13	9-13-3	Hs~MGC:BC017079.1~uORF:IOH10377	639	34	605
B09R03C14	9-14-3	Hs~MGC:BC017079.1~uORF:IOH10377	617	34	583
B09R03C15	9-15-3	Hs~Ref:NM_005617.2~uORF:IOH10433	480	38	442
B09R03C16	9-16-3	Hs~Ref:NM_005617.2~uORF:IOH10433	477	38	439
B09R03C17	9-17-3	Hs~Ref:NM_018683.2~uORF:IOH10466	381	38	343
B09R03C18	9-18-3	Hs~Ref:NM_018683.2~uORF:IOH10466	391	38	353
B09R03C19	9-19-3	Hs~Ref:NM_018200.2~uORF:IOH10020	403	37	366
B09R03C20	9-20-3	Hs~Ref:NM_018200.2~uORF:IOH10020	446	59	387
B09R03C21	9-21-3	Hs~Ref:NM_001673.2~uORF:IOH5751	498	42	456
B09R03C22	9-22-3	Hs~Ref:NM_001673.2~uORF:IOH5751	511	39	472
B09R04C01	9-1-4	Hs~MGC:BC018766.1~uORF:IOH13547	664	33	631
B09R04C02	9-2-4	Hs~MGC:BC018766.1~uORF:IOH13547	673	34	639
B09R04C03	9-3-4	Hs~Ref:NM_002028.2~uORF:IOH14750	533	35	498
B09R04C04	9-4-4	Hs~Ref:NM_002028.2~uORF:IOH14750	530	36	494
B09R04C05	9-5-4	Hs~Ref:NM_004051.1~uORF:IOH5792	786	35	751
B09R04C06	9-6-4	Hs~Ref:NM_004051.1~uORF:IOH5792	755	35	720
B09R04C07	9-7-4	Hs~MGC:BC024187.2~uORF:IOH10699	5425	42	5383
B09R04C08	9-8-4	Hs~MGC:BC024187.2~uORF:IOH10699	5469	39	5430
B09R04C09	9-9-4	Hs~Ref:NM_001637.1~uORF:IOH10670	611	37	574
B09R04C10	9-10-4	Hs~Ref:NM_001637.1~uORF:IOH10670	629	42	587
B09R04C11	9-11-4	Hs~MGC:BC011936.1~uORF:IOH12777	337	214	123
B09R04C12	9-12-4	Hs~MGC:BC011936.1~uORF:IOH12777	215	50	165
B09R04C13	9-13-4	Hs~Ref:NM_032122.2~uORF:IOH13153	662	35	627
B09R04C14	9-14-4	Hs~Ref:NM_032122.2~uORF:IOH13153	642	35	607
B09R04C15	9-15-4	Hs~Ref:NM_145018.2~uORF:IOH27254	315	36	279
B09R04C16	9-16-4	Hs~Ref:NM_145018.2~uORF:IOH27254	333	37	296
B09R04C17	9-17-4	Hs~Ref:NM_007242.3~uORF:IOH3925	965	37	928
B09R04C18	9-18-4	Hs~Ref:NM_007242.3~uORF:IOH3925	982	38	944
B09R04C19	9-19-4	Hs~MGC:BC050683.1~uORF:IOH27027	346	37	309
B09R04C20	9-20-4	Hs~MGC:BC050683.1~uORF:IOH27027	409	39	370
B09R04C21	9-21-4	Hs~Ref:NM_031213.2~uORF:IOH21446	170	38	132
B09R04C22	9-22-4	Hs~Ref:NM_031213.2~uORF:IOH21446	265	80	185
B09R05C01	9-1-5	Hs~MGC:BC063463.1~uORF:IOH39865	337	34	303
B09R05C02	9-2-5	Hs~MGC:BC063463.1~uORF:IOH39865	366	34	332
B09R05C03	9-3-5	Hs~MGC:BC036572.2~uORF:IOH28725	413	34	379
B09R05C04	9-4-5	Hs~MGC:BC036572.2~uORF:IOH28725	398	36	362
B09R05C05	9-5-5	Hs~Ref:NM_031279.2~uORF:IOH10786	459	36	423
B09R05C06	9-6-5	Hs~Ref:NM_031279.2~uORF:IOH10786	438	37	401
B09R05C07	9-7-5	Hs~Ref:NM_001615.2~uORF:IOH13748	296	37	259
B09R05C08	9-8-5	Hs~Ref:NM_001615.2~uORF:IOH13748	286	36	250
B09R05C09	9-9-5	Hs~Ref:NM_005627.1~uORF:IOH3192	1261	35	1226
B09R05C10	9-10-5	Hs~Ref:NM_005627.1~uORF:IOH3192	1348	36	1312
B09R05C11	9-11-5	Hs~Ref:NM_014891.1~uORF:IOH4282	6009	43	5966
B09R05C12	9-12-5	Hs~Ref:NM_014891.1~uORF:IOH4282	6049	40	6009
B09R05C13	9-13-5	Hs~Ref:NM_002638.1~uORF:IOH13658	694	36	658
B09R05C14	9-14-5	Hs~Ref:NM_002638.1~uORF:IOH13658	679	41	638
B09R05C15	9-15-5	Hs~Ref:NM_080671.1~uORF:IOH12642	550	45	505
B09R05C16	9-16-5	Hs~Ref:NM_080671.1~uORF:IOH12642	515	42	473
B09R05C17	9-17-5	Hs~Ref:NM_144659.1~uORF:IOH21795	563	36	527
B09R05C18	9-18-5	Hs~Ref:NM_144659.1~uORF:IOH21795	528	38	490
B09R05C19	9-19-5	Hs~Ref:NM_152736.2~uORF:IOH14153	922	37	885
B09R05C20	9-20-5	Hs~Ref:NM_152736.2~uORF:IOH14153	984	39	945
B09R05C21	9-21-5	Hs~Ref:NM_001219.2~uORF:IOH14786	878	43	835
B09R05C22	9-22-5	Hs~Ref:NM_001219.2~uORF:IOH14786	777	38	739
B09R06C01	9-1-6	Hs~MGC:NM_177999.1~uORF:IOH4544	670	39	631
B09R06C02	9-2-6	Hs~MGC:NM_177999.1~uORF:IOH4544	760	38	722
B09R06C03	9-3-6	Hs~Ref:NM_025165.1~uORF:IOH12994	354	36	318
B09R06C04	9-4-6	Hs~Ref:NM_025165.1~uORF:IOH12994	426	38	388
B09R06C05	9-5-6	Hs~MGC:NM_178585.1~uORF:IOH12602	536	37	499
B09R06C06	9-6-6	Hs~MGC:NM_178585.1~uORF:IOH12602	518	38	480
B09R06C07	9-7-6	Hs~Ref:NM_004346.2~uORF:IOH11204	378	40	338
B09R06C08	9-8-6	Hs~Ref:NM_004346.2~uORF:IOH11204	328	39	289
B09R06C09	9-9-6	Hs~Ref:NM_018135.2~uORF:IOH12060	615	35	580
B09R06C10	9-10-6	Hs~Ref:NM_018135.2~uORF:IOH12060	646	35	611
B09R06C11	9-11-6	Hs~Ref:NM_014062.1~uORF:IOH39919	3475	34	3441
B09R06C12	9-12-6	Hs~Ref:NM_014062.1~uORF:IOH39919	3709	37	3672
B09R06C13	9-13-6	Hs~MGC:BC067132.1~uORF:IOH39989	145	45	100
B09R06C14	9-14-6	Hs~MGC:BC067132.1~uORF:IOH39989	249	49	200
B09R06C15	9-15-6	Hs~Ref:NM_013975.1~uORF:IOH40893	1500	48	1452
B09R06C16	9-16-6	Hs~Ref:NM_013975.1~uORF:IOH40893	1445	42	1403
B09R06C17	9-17-6	Hs~Ref:NM_145716.2~uORF:IOH39990	998	38	960
B09R06C18	9-18-6	Hs~Ref:NM_145716.2~uORF:IOH39990	1102	41	1061
B09R06C19	9-19-6	Hs~MGC:BC010033.1~uORF:IOH27835	526	44	482
B09R06C20	9-20-6	Hs~MGC:BC010033.1~uORF:IOH27835	555	41	514
B09R06C21	9-21-6	Hs~MGC:BC040946.1~uORF:IOH26289	756	44	712
B09R06C22	9-22-6	Hs~MGC:BC040946.1~uORF:IOH26289	613	39	574
B09R07C01	9-1-7	Hs~Ref:NM_005675.2~uORF:IOH26597	401	44	357
B09R07C02	9-2-7	Hs~Ref:NM_005675.2~uORF:IOH26597	401	39	362
B09R07C03	9-3-7	Hs~MGC:NM_173806.2~uORF:IOH26314	370	43	327
B09R07C04	9-4-7	Hs~MGC:NM_173806.2~uORF:IOH26314	376	43	333
B09R07C05	9-5-7	Hs~MGC:BC003383.1~uORF:IOH2969	262	50	212
B09R07C06	9-6-7	Hs~MGC:BC003383.1~uORF:IOH2969	358	48	310
B09R07C07	9-7-7	Hs~MGC:NM_181795.1~uORF:IOH27983	148	40	108
B09R07C08	9-8-7	Hs~MGC:NM_181795.1~uORF:IOH27983	237	55	182
B09R07C09	9-9-7	Hs~Ref:NM_000181.1~uORF:IOH29680	274	39	235
B09R07C10	9-10-7	Hs~Ref:NM_000181.1~uORF:IOH29680	297	39	258
B09R07C11	9-11-7	Hs~MGC:BC001149.1~uORF:IOH4457	455	37	418
B09R07C12	9-12-7	Hs~MGC:BC001149.1~uORF:IOH4457	423	40	383
B09R07C13	9-13-7	Hs~Ref:NM_005746.1~uORF:IOH44532	430	46	384
B09R07C14	9-14-7	Hs~Ref:NM_005746.1~uORF:IOH44532	445	41	404
B09R07C15	9-15-7	Hs~Ref:NM_178154.1~uORF:IOH44218	742	35	707
B09R07C16	9-16-7	Hs~Ref:NM_178154.1~uORF:IOH44218	679	35	644
B09R07C17	9-17-7	Hs~Ref:NM_012170.2~uORF:IOH42104	609	35	574
B09R07C18	9-18-7	Hs~Ref:NM_012170.2~uORF:IOH42104	577	39	538
B09R07C19	9-19-7	Hs~Ref:NM_052936.2~uORF:IOH42076	281	144	137
B09R07C20	9-20-7	Hs~Ref:NM_052936.2~uORF:IOH42076	219	54	165
B09R07C21	9-21-7	Hs~MGC:BC024269.1~uORF:IOH13934	714	40	674
B09R07C22	9-22-7	Hs~MGC:BC024269.1~uORF:IOH13934	759	40	719
B09R08C01	9-1-8	Hs~Ref:NM_016641.2~uORF:IOH14021	882	40	842
B09R08C02	9-2-8	Hs~Ref:NM_016641.2~uORF:IOH14021	845	39	806
B09R08C03	9-3-8	Hs~MGC:BC011779.2~uORF:IOH14539	685	38	647
B09R08C04	9-4-8	Hs~MGC:BC011779.2~uORF:IOH14539	600	40	560
B09R08C05	9-5-8	Hs~MGC:BC010081.2~uORF:IOH13727	556	43	513
B09R08C06	9-6-8	Hs~MGC:BC010081.2~uORF:IOH13727	516	41	475
B09R08C07	9-7-8	Hs~Ref:NM_005268.1~uORF:IOH5587	924	37	887
B09R08C08	9-8-8	Hs~Ref:NM_005268.1~uORF:IOH5587	896	38	858
B09R08C09	9-9-8	Hs~Ref:NM_004155.2~uORF:IOH4093	262	42	220
B09R08C10	9-10-8	Hs~Ref:NM_004155.2~uORF:IOH4093	183	75	108
B09R08C11	9-11-8	Hs~Ref:NM_005666.1~uORF:IOH13657	386	47	339
B09R08C12	9-12-8	Hs~Ref:NM_005666.1~uORF:IOH13657	399	38	361
B09R08C13	9-13-8	Hs~MGC:BC010451.1~uORF:IOH9645	2337	36	2301
B09R08C14	9-14-8	Hs~MGC:BC010451.1~uORF:IOH9645	2427	34	2393
B09R08C15	9-15-8	Hs~Ref:NM_018105.1~uORF:IOH10776	607	34	573
B09R08C16	9-16-8	Hs~Ref:NM_018105.1~uORF:IOH10776	576	34	542
B09R08C17	9-17-8	Hs~MGC:BC037780.2~uORF:IOH27748	390	34	356
B09R08C18	9-18-8	Hs~MGC:BC037780.2~uORF:IOH27748	369	35	334
B09R08C19	9-19-8	Hs~MGC:BC036077.1~uORF:IOH27290	380	50	330
B09R08C20	9-20-8	Hs~MGC:BC036077.1~uORF:IOH27290	397	45	352
B09R08C21	9-21-8	Hs~MGC:BC030530.1~uORF:IOH21699	343	38	305
B09R08C22	9-22-8	Hs~MGC:BC030530.1~uORF:IOH21699	369	40	329
B09R09C01	9-1-9	Hs~MGC:BC001487.2~uORF:IOH12155	833	43	790
B09R09C02	9-2-9	Hs~MGC:BC001487.2~uORF:IOH12155	804	40	764
B09R09C03	9-3-9	Hs~Ref:NM_145699.2~uORF:IOH35258	614	37	577
B09R09C04	9-4-9	Hs~Ref:NM_145699.2~uORF:IOH35258	553	36	517
B09R09C05	9-5-9	Hs~Ref:NM_005118.2~uORF:IOH35359	670	36	634
B09R09C06	9-6-9	Hs~Ref:NM_005118.2~uORF:IOH35359	620	35	585
B09R09C07	9-7-9	Hs~Ref:NM_006634.2~uORF:IOH12607	531	36	495
B09R09C08	9-8-9	Hs~Ref:NM_006634.2~uORF:IOH12607	578	38	540
B09R09C09	9-9-9	Hs~Ref:NM_000371.1~uORF:IOH14065	205	43	162
B09R09C10	9-10-9	Hs~Ref:NM_000371.1~uORF:IOH14065	461	100	361
B09R09C11	9-11-9	Hs~MGC:BC017981.1~uORF:IOH13989	414	35	379
B09R09C12	9-12-9	Hs~MGC:BC017981.1~uORF:IOH13989	405	34	371
B09R09C13	9-13-9	Hs~MGC:BC028711.2~uORF:IOH11814	603	34	569
B09R09C14	9-14-9	Hs~MGC:BC028711.2~uORF:IOH11814	604	34	570
B09R09C15	9-15-9	Hs~MGC:BC022888.1~uORF:IOH14209	290	36	254
B09R09C16	9-16-9	Hs~MGC:BC022888.1~uORF:IOH14209	339	37	302
B09R09C17	9-17-9	Hs~MGC:BC006192.1~uORF:IOH6274	763	34	729
B09R09C18	9-18-9	Hs~MGC:BC006192.1~uORF:IOH6274	768	35	733
B09R09C19	9-19-9	Hs~MGC:BC006252.1~uORF:IOH6330	397	41	356
B09R09C20	9-20-9	Hs~MGC:BC006252.1~uORF:IOH6330	379	43	336
B09R09C21	9-21-9	Hs~MGC:NM_175630.1~uORF:IOH27070	305	42	263
B09R09C22	9-22-9	Hs~MGC:NM_175630.1~uORF:IOH27070	270	41	229
B09R10C01	9-1-10	Hs~MGC:BC051790.1~uORF:IOH26984	511	41	470
B09R10C02	9-2-10	Hs~MGC:BC051790.1~uORF:IOH26984	614	37	577
B09R10C03	9-3-10	Hs~MGC:BC021995.1~uORF:IOH14627	688	35	653
B09R10C04	9-4-10	Hs~MGC:BC021995.1~uORF:IOH14627	770	34	736
B09R10C05	9-5-10	Hs~Ref:NM_000431.1~uORF:IOH10122	612	34	578
B09R10C06	9-6-10	Hs~Ref:NM_000431.1~uORF:IOH10122	656	34	622
B09R10C07	9-7-10	Hs~Ref:NM_022369.2~uORF:IOH13935	721	37	684
B09R10C08	9-8-10	Hs~Ref:NM_022369.2~uORF:IOH13935	764	37	727
B09R10C09	9-9-10	Hs~MGC:BC012381.1~uORF:IOH10496	851	38	813
B09R10C10	9-10-10	Hs~MGC:BC012381.1~uORF:IOH10496	816	36	780
B09R10C11	9-11-10	GST1	37	33	4
B09R10C12	9-12-10	GST1	37	34	3
B09R10C13	9-13-10	GST2	36	33	3
B09R10C14	9-14-10	GST2	37	34	3
B09R10C15	9-15-10	GST3	47	35	12
B09R10C16	9-16-10	GST3	310	38	272
B09R10C17	9-17-10	GST4	66	35	31
B09R10C18	9-18-10	GST4	54	34	20
B09R10C19	9-19-10	Anti-HumanIgA1~N/A	8681	36	8645
B09R10C20	9-20-10	Anti-HumanIgA1~N/A	8861	36	8825
B09R10C21	9-21-10	Anti-HumanIgA2~N/A	15871	40	15831
B09R10C22	9-22-10	Anti-HumanIgA2~N/A	16316	38	16278
B09R11C01	9-1-11	AlexaAntiMouseAb~N/A	22047	36	22011
B09R11C02	9-2-11	AlexaAntiMouseAb~N/A	22480	36	22444
B09R11C03	9-3-11	MAPKAP~N/A	48	38	10
B09R11C04	9-4-11	MAPKAP~N/A	55	35	20
B09R11C05	9-5-11	Buffer	574	33	541
B09R11C06	9-6-11	Buffer	537	34	503
B09R11C07	9-7-11	BSA~N/A	9865	35	9830
B09R11C08	9-8-11	BSA~N/A	9453	35	9418
B09R11C09	9-9-11	Anti-HumanIgG1~N/A	1796	34	1762
B09R11C10	9-10-11	Anti-HumanIgG1~N/A	1528	35	1493
B09R11C11	9-11-11	Anti-HumanIgG2~N/A	3561	34	3527
B09R11C12	9-12-11	Anti-HumanIgG2~N/A	3512	35	3477
B09R11C13	9-13-11	Anti-HumanIgG3~N/A	6588	36	6552
B09R11C14	9-14-11	Anti-HumanIgG3~N/A	6278	36	6242
B09R11C15	9-15-11	Anti-HumanIgG4~N/A	11814	37	11777
B09R11C16	9-16-11	Anti-HumanIgG4~N/A	11214	37	11177
B09R11C17	9-17-11	AntiBiotinAb~N/A	13444	36	13408
B09R11C18	9-18-11	AntiBiotinAb~N/A	13019	34	12985
B09R11C19	9-19-11	Buffer	62	33	29
B09R11C20	9-20-11	Buffer	55	33	22
B09R11C21	9-21-11	Hs~MGC:BC026175.1~uORF:IOH12735	77	38	39
B09R11C22	9-22-11	Hs~MGC:BC026175.1~uORF:IOH12735	158	40	118
B09R12C01	9-1-12	Hs~Ref:NM_024633.2~uORF:IOH6971	442	36	406
B09R12C02	9-2-12	Hs~Ref:NM_024633.2~uORF:IOH6971	463	37	426
B09R12C03	9-3-12	Hs~MGC:BC035878.1~uORF:IOH25903	387	36	351
B09R12C04	9-4-12	Hs~MGC:BC035878.1~uORF:IOH25903	426	37	389
B09R12C05	9-5-12	Hs~Ref:NM_001832.2~uORF:IOH7303	471	37	434
B09R12C06	9-6-12	Hs~Ref:NM_001832.2~uORF:IOH7303	464	39	425
B09R12C07	9-7-12	Hs~MGC:BC057779.1~uORF:IOH29149	499	37	462
B09R12C08	9-8-12	Hs~MGC:BC057779.1~uORF:IOH29149	536	37	499
B09R12C09	9-9-12	Hs~MGC:BC058843.1~uORF:IOH29501	774	37	737
B09R12C10	9-10-12	Hs~MGC:BC058843.1~uORF:IOH29501	791	37	754
B09R12C11	9-11-12	Hs~MGC:BC052639.1~uORF:IOH29043	582	37	545
B09R12C12	9-12-12	Hs~MGC:BC052639.1~uORF:IOH29043	528	40	488
B09R12C13	9-13-12	Hs~MGC:BC024038.1~uORF:IOH27782	477	42	435
B09R12C14	9-14-12	Hs~MGC:BC024038.1~uORF:IOH27782	459	40	419
B09R12C15	9-15-12	Hs~MGC:BC005220.1~uORF:IOH7383	241	91	150
B09R12C16	9-16-12	Hs~MGC:BC005220.1~uORF:IOH7383	178	110	68
B09R12C17	9-17-12	Hs~Ref:NM_014463.1~uORF:IOH7376	216	138	78
B09R12C18	9-18-12	Hs~Ref:NM_014463.1~uORF:IOH7376	132	36	96
B09R12C19	9-19-12	Hs~MGC:BC054892.1~uORF:IOH29485	95	34	61
B09R12C20	9-20-12	Hs~MGC:BC054892.1~uORF:IOH29485	107	35	72
B09R12C21	9-21-12	Hs~Ref:NM_000594.2~uORF:IOH21536	680	39	641
B09R12C22	9-22-12	Hs~Ref:NM_000594.2~uORF:IOH21536	142	62	80
B09R13C01	9-1-13	Hs~Ref:NM_004633.3~uORF:IOH26113	550	36	514
B09R13C02	9-2-13	Hs~Ref:NM_004633.3~uORF:IOH26113	549	38	511
B09R13C03	9-3-13	Hs~Ref:NM_032332.2~uORF:IOH6146	1096	37	1059
B09R13C04	9-4-13	Hs~Ref:NM_032332.2~uORF:IOH6146	1098	37	1061
B09R13C05	9-5-13	Hs~Ref:NM_000326.3~uORF:IOH5232	232	44	188
B09R13C06	9-6-13	Hs~Ref:NM_000326.3~uORF:IOH5232	268	80	188
B09R13C07	9-7-13	Hs~Ref:NM_000889.1~uORF:IOH12535	326	42	284
B09R13C08	9-8-13	Hs~Ref:NM_000889.1~uORF:IOH12535	287	71	216
B09R13C09	9-9-13	Hs~Ref:NM_002952.2~uORF:IOH10056	341	41	300
B09R13C10	9-10-13	Hs~Ref:NM_002952.2~uORF:IOH10056	334	39	295
B09R13C11	9-11-13	Hs~Ref:NM_018091.2~uORF:IOH3126	246	40	206
B09R13C12	9-12-13	Hs~Ref:NM_018091.2~uORF:IOH3126	288	50	238
B09R13C13	9-13-13	Hs~MGC:BC005056.1~uORF:IOH6527	479	44	435
B09R13C14	9-14-13	Hs~MGC:BC005056.1~uORF:IOH6527	466	40	426
B09R13C15	9-15-13	Hs~MGC:BC002877.2~uORF:IOH5717	253	38	215
B09R13C16	9-16-13	Hs~MGC:BC002877.2~uORF:IOH5717	309	62	247
B09R13C17	9-17-13	Hs~Ref:NM_006215.2~uORF:IOH12257	453	37	416
B09R13C18	9-18-13	Hs~Ref:NM_006215.2~uORF:IOH12257	448	37	411
B09R13C19	9-19-13	Hs~MGC:BC014452.1~uORF:IOH14883	400	35	365
B09R13C20	9-20-13	Hs~MGC:BC014452.1~uORF:IOH14883	386	36	350
B09R13C21	9-21-13	Hs~Ref:NM_002395.2~uORF:IOH12418	402	38	364
B09R13C22	9-22-13	Hs~Ref:NM_002395.2~uORF:IOH12418	400	38	362
B09R14C01	9-1-14	Hs~MGC:BC028151.1~uORF:IOH11514	421	37	384
B09R14C02	9-2-14	Hs~MGC:BC028151.1~uORF:IOH11514	372	41	331
B09R14C03	9-3-14	Hs~Ref:NM_144970.1~uORF:IOH12670	186	132	54
B09R14C04	9-4-14	Hs~Ref:NM_144970.1~uORF:IOH12670	139	39	100
B09R14C05	9-5-14	Hs~Ref:NM_152420.1~uORF:IOH23039	582	39	543
B09R14C06	9-6-14	Hs~Ref:NM_152420.1~uORF:IOH23039	553	41	512
B09R14C07	9-7-14	Hs~MGC:BC070125.1~uORF:IOH40801	346	39	307
B09R14C08	9-8-14	Hs~MGC:BC070125.1~uORF:IOH40801	366	43	323
B09R14C09	9-9-14	Hs~MGC:BC001152.1~uORF:IOH4425	838	43	795
B09R14C10	9-10-14	Hs~MGC:BC001152.1~uORF:IOH4425	852	40	812
B09R14C11	9-11-14	Hs~Ref:NM_032019.4~uORF:IOH42550	386	37	349
B09R14C12	9-12-14	Hs~Ref:NM_032019.4~uORF:IOH42550	404	38	366
B09R14C13	9-13-14	Hs~Ref:NM_175634.1~uORF:IOH42249	532	38	494
B09R14C14	9-14-14	Hs~Ref:NM_175634.1~uORF:IOH42249	532	37	495
B09R14C15	9-15-14	Hs~Ref:NM_003945.3~uORF:IOH41102	265	37	228
B09R14C16	9-16-14	Hs~Ref:NM_003945.3~uORF:IOH41102	261	41	220
B09R14C17	9-17-14	Hs~Ref:NM_016203.2~uORF:IOH42382	587	36	551
B09R14C18	9-18-14	Hs~Ref:NM_016203.2~uORF:IOH42382	656	35	621
B09R14C19	9-19-14	Hs~Ref:NM_033064.1~uORF:IOH11249	693	36	657
B09R14C20	9-20-14	Hs~Ref:NM_033064.1~uORF:IOH11249	673	35	638
B09R14C21	9-21-14	Hs~MGC:BC029609.1~uORF:IOH21622	331	40	291
B09R14C22	9-22-14	Hs~MGC:BC029609.1~uORF:IOH21622	289	40	249
B09R15C01	9-1-15	Hs~Ref:NM_005750.2~uORF:IOH34751	41	37	4
B09R15C02	9-2-15	Hs~Ref:NM_005750.2~uORF:IOH34751	144	43	101
B09R15C03	9-3-15	Hs~Ref:NM_001425.1~uORF:IOH9872	371	42	329
B09R15C04	9-4-15	Hs~Ref:NM_001425.1~uORF:IOH9872	359	39	320
B09R15C05	9-5-15	Hs~Ref:NM_013354.4~uORF:IOH45495	553	35	518
B09R15C06	9-6-15	Hs~Ref:NM_013354.4~uORF:IOH45495	572	35	537
B09R15C07	9-7-15	Hs~Ref:NM_006062.1~uORF:IOH45944	432	37	395
B09R15C08	9-8-15	Hs~Ref:NM_006062.1~uORF:IOH45944	438	37	401
B09R15C09	9-9-15	Hs~Ref:NM_201443.1~uORF:IOH45504	1263	39	1224
B09R15C10	9-10-15	Hs~Ref:NM_201443.1~uORF:IOH45504	1293	37	1256
B09R15C11	9-11-15	Hs~Ref:NM_201278.1~uORF:IOH45482	613	37	576
B09R15C12	9-12-15	Hs~Ref:NM_201278.1~uORF:IOH45482	674	37	637
B09R15C13	9-13-15	Hs~IVGN:PM_2151~Ext:Ro-52~N/A	307	37	270
B09R15C14	9-14-15	Hs~IVGN:PM_2151~Ext:Ro-52~N/A	302	37	265
B09R15C15	9-15-15	Hs~Ref:NP_004374~CAT:P2927	54	40	14
B09R15C16	9-16-15	Hs~Ref:NP_004374~CAT:P2927	59	38	21
B09R15C17	9-17-15	Hs~Ref:NM_000222.1~CAT:P3081	478	34	444
B09R15C18	9-18-15	Hs~Ref:NM_000222.1~CAT:P3081	487	34	453
B09R15C19	9-19-15	Hs~Ref:NM_001014796.1~CAT:PV3870	669	37	632
B09R15C20	9-20-15	Hs~Ref:NM_001014796.1~CAT:PV3870	647	36	611
B09R15C21	9-21-15	Hs~Ref:NM_144685.3~CAT:PV3852	209	50	159
B09R15C22	9-22-15	Hs~Ref:NM_144685.3~CAT:PV3852	247	38	209
B09R16C01	9-1-16	Hs~Ref:NM_003993.2~CAT:PV4201	50	40	10
B09R16C02	9-2-16	Hs~Ref:NM_003993.2~CAT:PV4201	48	40	8
B09R16C03	9-3-16	Hs~Ref:NM_006251.4~CAT:PV4672	56	34	22
B09R16C04	9-4-16	Hs~Ref:NM_006251.4~CAT:PV4672	60	34	26
B09R16C05	9-5-16	Hs~N/A:NM_005228.3~CAT:PV4879	313	35	278
B09R16C06	9-6-16	Hs~N/A:NM_005228.3~CAT:PV4879	299	35	264
B09R16C07	9-7-16	Hs~MGC:BC033817.1~uORF:IOH21867	225	37	188
B09R16C08	9-8-16	Hs~MGC:BC033817.1~uORF:IOH21867	217	41	176
B09R16C09	9-9-16	Hs~MGC:BC011892.1~uORF:IOH14730	141	49	92
B09R16C10	9-10-16	Hs~MGC:BC011892.1~uORF:IOH14730	122	44	78
B09R16C11	9-11-16	Hs~Ref:NM_018243.1~uORF:IOH5880	344	130	214
B09R16C12	9-12-16	Hs~Ref:NM_018243.1~uORF:IOH5880	257	39	218
B09R16C13	9-13-16	Hs~MGC:BC007363.1~uORF:IOH21168	486	37	449
B09R16C14	9-14-16	Hs~MGC:BC007363.1~uORF:IOH21168	522	38	484
B09R16C15	9-15-16	Hs~MGC:BC059947.1~uORF:IOH39895	15006	38	14968
B09R16C16	9-16-16	Hs~MGC:BC059947.1~uORF:IOH39895	15347	38	15309
B09R16C17	9-17-16	Hs~Ref:NM_001008896.1~uORF:IOH50198	870	37	833
B09R16C18	9-18-16	Hs~Ref:NM_001008896.1~uORF:IOH50198	904	36	868
B09R16C19	9-19-16	Hs~Ref:NM_139168.1~uORF:IOH37855	485	36	449
B09R16C20	9-20-16	Hs~Ref:NM_139168.1~uORF:IOH37855	489	36	453
B09R16C21	9-21-16	Hs~MGC:BC067301.1~uORF:IOH40043	856	35	821
B09R16C22	9-22-16	Hs~MGC:BC067301.1~uORF:IOH40043	827	34	793
B09R17C01	9-1-17	Hs~MGC:BC011414.1~uORF:IOH9720	1759	40	1719
B09R17C02	9-2-17	Hs~MGC:BC011414.1~uORF:IOH9720	1539	38	1501
B09R17C03	9-3-17	Hs~Ref:NM_198513.1~uORF:IOH11823	555	35	520
B09R17C04	9-4-17	Hs~Ref:NM_198513.1~uORF:IOH11823	517	36	481
B09R17C05	9-5-17	Hs~Ref:NM_006252.2~uORF:IOH29876	537	36	501
B09R17C06	9-6-17	Hs~Ref:NM_006252.2~uORF:IOH29876	558	36	522
B09R17C07	9-7-17	Hs~MGC:BC028244.1~uORF:IOH11643	464	36	428
B09R17C08	9-8-17	Hs~MGC:BC028244.1~uORF:IOH11643	489	36	453
B09R17C09	9-9-17	Hs~MGC:BC010056.2~uORF:IOH13015	530	37	493
B09R17C10	9-10-17	Hs~MGC:BC010056.2~uORF:IOH13015	532	38	494
B09R17C11	9-11-17	Hs~MGC:BC036031.1~uORF:IOH27208	534	37	497
B09R17C12	9-12-17	Hs~MGC:BC036031.1~uORF:IOH27208	637	37	600
B09R17C13	9-13-17	Hs~Ref:NM_139010.1~uORF:IOH35167	537	37	500
B09R17C14	9-14-17	Hs~Ref:NM_139010.1~uORF:IOH35167	543	37	506
B09R17C15	9-15-17	Hs~Ref:XM_496191.1~uORF:IOH35170	547	36	511
B09R17C16	9-16-17	Hs~Ref:XM_496191.1~uORF:IOH35170	566	37	529
B09R17C17	9-17-17	Hs~Ref:NM_001786.2~uORF:IOH14583	895	37	858
B09R17C18	9-18-17	Hs~Ref:NM_001786.2~uORF:IOH14583	901	35	866
B09R17C19	9-19-17	Hs~MGC:BC027900.1~uORF:IOH27306	660	35	625
B09R17C20	9-20-17	Hs~MGC:BC027900.1~uORF:IOH27306	663	35	628
B09R17C21	9-21-17	Hs~MGC:BC035006.2~uORF:IOH27161	653	36	617
B09R17C22	9-22-17	Hs~MGC:BC035006.2~uORF:IOH27161	682	35	647
B09R18C01	9-1-18	Hs~Ref:NM_178552.2~uORF:IOH27375	776	36	740
B09R18C02	9-2-18	Hs~Ref:NM_178552.2~uORF:IOH27375	865	37	828
B09R18C03	9-3-18	Hs~MGC:BC062422.1~uORF:IOH40746	415	37	378
B09R18C04	9-4-18	Hs~MGC:BC062422.1~uORF:IOH40746	416	38	378
B09R18C05	9-5-18	Hs~Ref:NM_024567.2~uORF:IOH40784	415	39	376
B09R18C06	9-6-18	Hs~Ref:NM_024567.2~uORF:IOH40784	418	39	379
B09R18C07	9-7-18	Hs~MGC:BC062663.1~uORF:IOH40734	387	36	351
B09R18C08	9-8-18	Hs~MGC:BC062663.1~uORF:IOH40734	427	36	391
B09R18C09	9-9-18	Hs~Ref:NM_001008218.1~uORF:IOH40716	352	37	315
B09R18C10	9-10-18	Hs~Ref:NM_001008218.1~uORF:IOH40716	420	38	382
B09R18C11	9-11-18	Hs~Ref:NM_182943.2~uORF:IOH41898	403	38	365
B09R18C12	9-12-18	Hs~Ref:NM_182943.2~uORF:IOH41898	424	39	385
B09R18C13	9-13-18	Hs~MGC:BC030262.1~uORF:IOH21525	364	39	325
B09R18C14	9-14-18	Hs~MGC:BC030262.1~uORF:IOH21525	358	39	319
B09R18C15	9-15-18	Hs~Ref:NM_003862.1~uORF:IOH6319	521	37	484
B09R18C16	9-16-18	Hs~Ref:NM_003862.1~uORF:IOH6319	554	43	511
B09R18C17	9-17-18	Hs~Ref:NM_014044.4~uORF:IOH11358	624	47	577
B09R18C18	9-18-18	Hs~Ref:NM_014044.4~uORF:IOH11358	565	43	522
B09R18C19	9-19-18	Hs~MGC:BC017702.1~uORF:IOH11854	486	36	450
B09R18C20	9-20-18	Hs~MGC:BC017702.1~uORF:IOH11854	481	35	446
B09R18C21	9-21-18	Hs~MGC:BC057393.1~uORF:IOH28895	565	36	529
B09R18C22	9-22-18	Hs~MGC:BC057393.1~uORF:IOH28895	530	35	495
B09R19C01	9-1-19	Hs~MGC:BC054893.1~uORF:IOH29495	8032	34	7998
B09R19C02	9-2-19	Hs~MGC:BC054893.1~uORF:IOH29495	8244	39	8205
B09R19C03	9-3-19	Hs~MGC:BC013013.2~uORF:IOH12505	410	41	369
B09R19C04	9-4-19	Hs~MGC:BC013013.2~uORF:IOH12505	402	36	366
B09R19C05	9-5-19	Hs~MGC:BC027617.1~uORF:IOH12034	387	40	347
B09R19C06	9-6-19	Hs~MGC:BC027617.1~uORF:IOH12034	378	42	336
B09R19C07	9-7-19	Hs~Ref:NM_015895.2~uORF:IOH7292	511	35	476
B09R19C08	9-8-19	Hs~Ref:NM_015895.2~uORF:IOH7292	514	36	478
B09R19C09	9-9-19	Hs~MGC:BC022054.1~uORF:IOH13695	222	38	184
B09R19C10	9-10-19	Hs~MGC:BC022054.1~uORF:IOH13695	207	46	161
B09R19C11	9-11-19	Hs~MGC:BC012124.1~uORF:IOH12569	363	40	323
B09R19C12	9-12-19	Hs~MGC:BC012124.1~uORF:IOH12569	369	41	328
B09R19C13	9-13-19	Hs~Ref:NM_007029.1~uORF:IOH6398	317	112	205
B09R19C14	9-14-19	Hs~Ref:NM_007029.1~uORF:IOH6398	320	110	210
B09R19C15	9-15-19	Hs~Ref:NM_001422.1~uORF:IOH22142	499	38	461
B09R19C16	9-16-19	Hs~Ref:NM_001422.1~uORF:IOH22142	529	40	489
B09R19C17	9-17-19	Hs~MGC:NM_175887.2~uORF:IOH27336	1703	54	1649
B09R19C18	9-18-19	Hs~MGC:NM_175887.2~uORF:IOH27336	1712	44	1668
B09R19C19	9-19-19	Hs~MGC:BC029795.1~uORF:IOH22708	390	38	352
B09R19C20	9-20-19	Hs~MGC:BC029795.1~uORF:IOH22708	412	38	374
B09R19C21	9-21-19	Hs~MGC:BC015993.1~uORF:IOH14875	400	35	365
B09R19C22	9-22-19	Hs~MGC:BC015993.1~uORF:IOH14875	381	35	346
B09R20C01	9-1-20	Hs~MGC:BC012535.1~uORF:IOH14189	406	35	371
B09R20C02	9-2-20	Hs~MGC:BC012535.1~uORF:IOH14189	512	41	471
B09R20C03	9-3-20	Hs~MGC:BC000702.1~uORF:IOH4311	384	66	318
B09R20C04	9-4-20	Hs~MGC:BC000702.1~uORF:IOH4311	301	38	263
B09R20C05	9-5-20	Hs~Ref:NM_006746.1~uORF:IOH22321	301	41	260
B09R20C06	9-6-20	Hs~Ref:NM_006746.1~uORF:IOH22321	341	43	298
B09R20C07	9-7-20	Hs~MGC:BC030592.2~uORF:IOH22341	6588	35	6553
B09R20C08	9-8-20	Hs~MGC:BC030592.2~uORF:IOH22341	6574	35	6539
B09R20C09	9-9-20	Hs~MGC:BC000001.1~uORF:IOH4593	332	38	294
B09R20C10	9-10-20	Hs~MGC:BC000001.1~uORF:IOH4593	317	38	279
B09R20C11	9-11-20	Hs~MGC:BC000082.1~uORF:IOH4680	375	38	337
B09R20C12	9-12-20	Hs~MGC:BC000082.1~uORF:IOH4680	435	37	398
B09R20C13	9-13-20	Hs~Ref:NM_001004299.1~uORF:IOH45686	489	37	452
B09R20C14	9-14-20	Hs~Ref:NM_001004299.1~uORF:IOH45686	509	36	473
B09R20C15	9-15-20	Hs~MGC:BC011875.2~uORF:IOH13282	381	36	345
B09R20C16	9-16-20	Hs~MGC:BC011875.2~uORF:IOH13282	352	35	317
B09R20C17	9-17-20	Hs~MGC:BC008466.1~uORF:IOH7445	308	62	246
B09R20C18	9-18-20	Hs~MGC:BC008466.1~uORF:IOH7445	184	37	147
B09R20C19	9-19-20	Hs~MGC:BC005294.1~uORF:IOH46087	54	42	12
B09R20C20	9-20-20	Hs~MGC:BC005294.1~uORF:IOH46087	562	47	515
B09R20C21	9-21-20	Hs~Ref:ENST00000356268~uORF:IOH50085	591	36	555
B09R20C22	9-22-20	Hs~Ref:ENST00000356268~uORF:IOH50085	566	35	531
B09R21C01	9-1-21	Hs~Ref:NM_182484.1~uORF:IOH43085	290	34	256
B09R21C02	9-2-21	Hs~Ref:NM_182484.1~uORF:IOH43085	342	35	307
B09R21C03	9-3-21	Hs~Ref:NM_003120.1~uORF:IOH41504	375	37	338
B09R21C04	9-4-21	Hs~Ref:NM_003120.1~uORF:IOH41504	345	40	305
B09R21C05	9-5-21	Hs~Ref:NM_205849.1~uORF:IOH41618	485	36	449
B09R21C06	9-6-21	Hs~Ref:NM_205849.1~uORF:IOH41618	496	36	460
B09R21C07	9-7-21	Hs~Ref:NM_145756.1~uORF:IOH43556	285	37	248
B09R21C08	9-8-21	Hs~Ref:NM_145756.1~uORF:IOH43556	315	39	276
B09R21C09	9-9-21	Hs~Ref:NP_079515.2~CAT_10292-H03H-25	35	34	1
B09R21C10	9-10-21	Hs~Ref:NP_079515.2~CAT_10292-H03H-25	34	33	1
B09R21C11	9-11-21	Internal_1007209	48	34	14
B09R21C12	9-12-21	Internal_1007209	54	34	20
B09R21C13	9-13-21	Hs~Ref:NP_000607.1~CAT_10400-H08H-25	43	33	10
B09R21C14	9-14-21	Hs~Ref:NP_000607.1~CAT_10400-H08H-25	49	33	16
B09R21C15	9-15-21	Internal_1007209	135	38	97
B09R21C16	9-16-21	Internal_1007209	69	34	35
B09R21C17	9-17-21	Hs~Ref:NP_059112.1~CAT_10156-H08H-25	35	33	2
B09R21C18	9-18-21	Hs~Ref:NP_059112.1~CAT_10156-H08H-25	32	33	-1
B09R21C19	9-19-21	Internal_1007209	94	34	60
B09R21C20	9-20-21	Internal_1007209	1220	35	1185
B09R21C21	9-21-21	Hs~IVGN:IGFBP6_Recombinant~CAT_PHC9621~N/A	5519	36	5483
B09R21C22	9-22-21	Hs~IVGN:IGFBP6_Recombinant~CAT_PHC9621~N/A	5799	34	5765
B09R22C01	9-1-22	ERa~N/A	2610	34	2576
B09R22C02	9-2-22	ERa~N/A	2786	33	2753
B09R22C03	9-3-22	PKCeta~N/A	322	34	288
B09R22C04	9-4-22	PKCeta~N/A	369	34	335
B09R22C05	9-5-22	Calmodulin~N/A	222	34	188
B09R22C06	9-6-22	Calmodulin~N/A	254	34	220
B09R22C07	9-7-22	V5control5~N/A	593	34	559
B09R22C08	9-8-22	V5control5~N/A	614	34	580
B09R22C09	9-9-22	V5control4~N/A	190	35	155
B09R22C10	9-10-22	V5control4~N/A	203	35	168
B09R22C11	9-11-22	V5control3~N/A	125	58	67
B09R22C12	9-12-22	V5control3~N/A	119	39	80
B09R22C13	9-13-22	V5control2~N/A	87	34	53
B09R22C14	9-14-22	V5control2~N/A	109	61	48
B09R22C15	9-15-22	V5control1~N/A	171	56	115
B09R22C16	9-16-22	V5control1~N/A	152	37	115
B09R22C17	9-17-22	CMK2A~N/A	532	34	498
B09R22C18	9-18-22	CMK2A~N/A	554	33	521
B09R22C19	9-19-22	ERa~N/A	2382	33	2349
B09R22C20	9-20-22	ERa~N/A	2199	34	2165
B09R22C21	9-21-22	AlexaAntiMouseAb~N/A	8936	35	8901
B09R22C22	9-22-22	AlexaAntiMouseAb~N/A	9745	35	9710
B10R01C01	10-1-1	AlexaAntiMouseAb~N/A	40674	35	40639
B10R01C02	10-2-1	AlexaAntiMouseAb~N/A	41505	36	41469
B10R01C03	10-3-1	ERa~N/A	1147	37	1110
B10R01C04	10-4-1	ERa~N/A	1314	48	1266
B10R01C05	10-5-1	HumanIgG1~N/A	1709	51	1658
B10R01C06	10-6-1	HumanIgG1~N/A	1715	47	1668
B10R01C07	10-7-1	HumanIgG2~N/A	3837	46	3791
B10R01C08	10-8-1	HumanIgG2~N/A	3979	42	3937
B10R01C09	10-9-1	HumanIgG3~N/A	15652	40	15612
B10R01C10	10-10-1	HumanIgG3~N/A	15474	40	15434
B10R01C11	10-11-1	HumanIgG4~N/A	50033	40	49993
B10R01C12	10-12-1	HumanIgG4~N/A	55178	38	55140
B10R01C13	10-13-1	BiotinAb~N/A	410	36	374
B10R01C14	10-14-1	BiotinAb~N/A	474	36	438
B10R01C15	10-15-1	RanBP2deltaFG~N/A	312	36	276
B10R01C16	10-16-1	RanBP2deltaFG~N/A	278	36	242
B10R01C17	10-17-1	hMDM2~N/A	735	37	698
B10R01C18	10-18-1	hMDM2~N/A	701	37	664
B10R01C19	10-19-1	PKCeta~N/A	283	36	247
B10R01C20	10-20-1	PKCeta~N/A	306	37	269
B10R01C21	10-21-1	AlexaAntiMouseAb~N/A	36001	37	35964
B10R01C22	10-22-1	AlexaAntiMouseAb~N/A	39294	38	39256
B10R02C01	10-1-2	PKCeta~N/A	902	35	867
B10R02C02	10-2-2	PKCeta~N/A	988	36	952
B10R02C03	10-3-2	Buffer	104	55	49
B10R02C04	10-4-2	Buffer	118	46	72
B10R02C05	10-5-2	HumanIgA~N/A	20658	49	20609
B10R02C06	10-6-2	HumanIgA~N/A	20526	46	20480
B10R02C07	10-7-2	Buffer	86	52	34
B10R02C08	10-8-2	Buffer	79	50	29
B10R02C09	10-9-2	BSA~N/A	12594	41	12553
B10R02C10	10-10-2	BSA~N/A	12301	40	12261
B10R02C11	10-11-2	Hs~Ref:NM_138451.1~uORF:IOH10717	166	65	101
B10R02C12	10-12-2	Hs~Ref:NM_138451.1~uORF:IOH10717	171	41	130
B10R02C13	10-13-2	Hs~MGC:BC017717.1~uORF:IOH11300	333	39	294
B10R02C14	10-14-2	Hs~MGC:BC017717.1~uORF:IOH11300	339	39	300
B10R02C15	10-15-2	Hs~Ref:NM_021943.1~uORF:IOH22137	413	38	375
B10R02C16	10-16-2	Hs~Ref:NM_021943.1~uORF:IOH22137	402	38	364
B10R02C17	10-17-2	Hs~MGC:BC017769.1~uORF:IOH13448	659	38	621
B10R02C18	10-18-2	Hs~MGC:BC017769.1~uORF:IOH13448	688	39	649
B10R02C19	10-19-2	Hs~Ref:NM_005324.3~uORF:IOH5791	502	39	463
B10R02C20	10-20-2	Hs~Ref:NM_005324.3~uORF:IOH5791	452	39	413
B10R02C21	10-21-2	Hs~MGC:BC002526.1~uORF:IOH4058	296	39	257
B10R02C22	10-22-2	Hs~MGC:BC002526.1~uORF:IOH4058	299	37	262
B10R03C01	10-1-3	Hs~Ref:NM_001707.2~uORF:IOH3200	244	37	207
B10R03C02	10-2-3	Hs~Ref:NM_001707.2~uORF:IOH3200	236	38	198
B10R03C03	10-3-3	Hs~MGC:BC000686.1~uORF:IOH4305	386	37	349
B10R03C04	10-4-3	Hs~MGC:BC000686.1~uORF:IOH4305	388	44	344
B10R03C05	10-5-3	Hs~Ref:NM_002620.1~uORF:IOH34711	228	52	176
B10R03C06	10-6-3	Hs~Ref:NM_002620.1~uORF:IOH34711	218	106	112
B10R03C07	10-7-3	Hs~Ref:NM_002824.4~uORF:IOH44357	75	52	23
B10R03C08	10-8-3	Hs~Ref:NM_002824.4~uORF:IOH44357	68	47	21
B10R03C09	10-9-3	Hs~Ref:NM_006664.2~uORF:IOH34759	166	54	112
B10R03C10	10-10-3	Hs~Ref:NM_006664.2~uORF:IOH34759	147	43	104
B10R03C11	10-11-3	Hs~Ref:NM_001012979.1~uORF:IOH41536	231	114	117
B10R03C12	10-12-3	Hs~Ref:NM_001012979.1~uORF:IOH41536	323	107	216
B10R03C13	10-13-3	Hs~Ref:XM_378350.2~uORF:IOH43457	28812	49	28763
B10R03C14	10-14-3	Hs~Ref:XM_378350.2~uORF:IOH43457	28438	43	28395
B10R03C15	10-15-3	Hs~Ref:NM_001008393.1~uORF:IOH43514	217	42	175
B10R03C16	10-16-3	Hs~Ref:NM_001008393.1~uORF:IOH43514	226	42	184
B10R03C17	10-17-3	Hs~Ref:NM_016174.3~uORF:IOH42094	81	38	43
B10R03C18	10-18-3	Hs~Ref:NM_016174.3~uORF:IOH42094	96	53	43
B10R03C19	10-19-3	Hs~Ref:NM_001009609.1~uORF:IOH44772	804	41	763
B10R03C20	10-20-3	Hs~Ref:NM_001009609.1~uORF:IOH44772	825	39	786
B10R03C21	10-21-3	Hs~MGC:BC009762.2~uORF:IOH14113	829	37	792
B10R03C22	10-22-3	Hs~MGC:BC009762.2~uORF:IOH14113	775	36	739
B10R04C01	10-1-4	Hs~Ref:NM_031472.1~uORF:IOH5640	1791	36	1755
B10R04C02	10-2-4	Hs~Ref:NM_031472.1~uORF:IOH5640	1734	36	1698
B10R04C03	10-3-4	Hs~Ref:NM_003278.1~uORF:IOH14450	312	35	277
B10R04C04	10-4-4	Hs~Ref:NM_003278.1~uORF:IOH14450	301	41	260
B10R04C05	10-5-4	Hs~Ref:NM_016401.2~uORF:IOH3734	365	139	226
B10R04C06	10-6-4	Hs~Ref:NM_016401.2~uORF:IOH3734	250	65	185
B10R04C07	10-7-4	Hs~MGC:BC020568.1~uORF:IOH10333	307	47	260
B10R04C08	10-8-4	Hs~MGC:BC020568.1~uORF:IOH10333	334	45	289
B10R04C09	10-9-4	Hs~MGC:BC005922.1~uORF:IOH7526	538	51	487
B10R04C10	10-10-4	Hs~MGC:BC005922.1~uORF:IOH7526	448	62	386
B10R04C11	10-11-4	Hs~Ref:NM_000039.1~uORF:IOH7318	69	48	21
B10R04C12	10-12-4	Hs~Ref:NM_000039.1~uORF:IOH7318	66	45	21
B10R04C13	10-13-4	Hs~Ref:NM_018668.2~uORF:IOH10175	10045	42	10003
B10R04C14	10-14-4	Hs~Ref:NM_018668.2~uORF:IOH10175	9603	41	9562
B10R04C15	10-15-4	Hs~MGC:BC004259.1~uORF:IOH5453	904	42	862
B10R04C16	10-16-4	Hs~MGC:BC004259.1~uORF:IOH5453	833	41	792
B10R04C17	10-17-4	Hs~MGC:NM_152769.1~uORF:IOH21544	375	38	337
B10R04C18	10-18-4	Hs~MGC:NM_152769.1~uORF:IOH21544	374	38	336
B10R04C19	10-19-4	Hs~Ref:NM_016607.1~uORF:IOH7393	469	37	432
B10R04C20	10-20-4	Hs~Ref:NM_016607.1~uORF:IOH7393	430	36	394
B10R04C21	10-21-4	Hs~Ref:NM_004159.1~uORF:IOH3858	357	37	320
B10R04C22	10-22-4	Hs~Ref:NM_004159.1~uORF:IOH3858	333	36	297
B10R05C01	10-1-5	Hs~Ref:NM_003746.1~uORF:IOH43452	215	34	181
B10R05C02	10-2-5	Hs~Ref:NM_003746.1~uORF:IOH43452	209	36	173
B10R05C03	10-3-5	Hs~Ref:XM_378822.1~uORF:IOH43360	166	39	127
B10R05C04	10-4-5	Hs~Ref:XM_378822.1~uORF:IOH43360	204	48	156
B10R05C05	10-5-5	Hs~Ref:NM_031296.1~uORF:IOH43454	3104	68	3036
B10R05C06	10-6-5	Hs~Ref:NM_031296.1~uORF:IOH43454	3237	61	3176
B10R05C07	10-7-5	Hs~Ref:NM_001169.2~uORF:IOH43240	121	49	72
B10R05C08	10-8-5	Hs~Ref:NM_001169.2~uORF:IOH43240	131	45	86
B10R05C09	10-9-5	Hs~MGC:BC067755.1~uORF:IOH40120	4518	52	4466
B10R05C10	10-10-5	Hs~MGC:BC067755.1~uORF:IOH40120	3942	51	3891
B10R05C11	10-11-5	Hs~MGC:BC032416.1~uORF:IOH40215	321	52	269
B10R05C12	10-12-5	Hs~MGC:BC032416.1~uORF:IOH40215	63	53	10
B10R05C13	10-13-5	Hs~MGC:BC035143.1~uORF:IOH40223	1618	45	1573
B10R05C14	10-14-5	Hs~MGC:BC035143.1~uORF:IOH40223	1628	41	1587
B10R05C15	10-15-5	Hs~MGC:BC068594.1~uORF:IOH40084	563	42	521
B10R05C16	10-16-5	Hs~MGC:BC068594.1~uORF:IOH40084	549	41	508
B10R05C17	10-17-5	Hs~Ref:NM_206918.1~uORF:IOH39844	125	39	86
B10R05C18	10-18-5	Hs~Ref:NM_206918.1~uORF:IOH39844	193	38	155
B10R05C19	10-19-5	Hs~MGC:BC024194.2~uORF:IOH40195	541	38	503
B10R05C20	10-20-5	Hs~MGC:BC024194.2~uORF:IOH40195	464	37	427
B10R05C21	10-21-5	Hs~Ref:NM_173517.3~uORF:IOH40649	229	38	191
B10R05C22	10-22-5	Hs~Ref:NM_173517.3~uORF:IOH40649	209	38	171
B10R06C01	10-1-6	Hs~MGC:BC005286.1~uORF:IOH7309	189	39	150
B10R06C02	10-2-6	Hs~MGC:BC005286.1~uORF:IOH7309	175	40	135
B10R06C03	10-3-6	Hs~Ref:NM_001005404.3~uORF:IOH58661	1014	43	971
B10R06C04	10-4-6	Hs~Ref:NM_001005404.3~uORF:IOH58661	967	42	925
B10R06C05	10-5-6	Hs~Ref:NM_001876.2~uORF:IOH52786	290	41	249
B10R06C06	10-6-6	Hs~Ref:NM_001876.2~uORF:IOH52786	366	57	309
B10R06C07	10-7-6	Hs~Ref:NM_206853.1~uORF:IOH59363	176	52	124
B10R06C08	10-8-6	Hs~Ref:NM_206853.1~uORF:IOH59363	179	48	131
B10R06C09	10-9-6	Hs~Ref:NM_080820.3~uORF:IOH54776	618	45	573
B10R06C10	10-10-6	Hs~Ref:NM_080820.3~uORF:IOH54776	510	40	470
B10R06C11	10-11-6	Hs~MGC:BC000108.1~uORF:IOH4735	2951	43	2908
B10R06C12	10-12-6	Hs~MGC:BC000108.1~uORF:IOH4735	2911	47	2864
B10R06C13	10-13-6	Hs~MGC:BC000084.1~uORF:IOH4697	543	45	498
B10R06C14	10-14-6	Hs~MGC:BC000084.1~uORF:IOH4697	549	44	505
B10R06C15	10-15-6	Hs~MGC:BC017296.2~uORF:IOH13381	512	42	470
B10R06C16	10-16-6	Hs~MGC:BC017296.2~uORF:IOH13381	521	41	480
B10R06C17	10-17-6	Hs~MGC:BC009956.1~uORF:IOH12720	517	40	477
B10R06C18	10-18-6	Hs~MGC:BC009956.1~uORF:IOH12720	362	40	322
B10R06C19	10-19-6	Hs~Ref:NM_022491.2~uORF:IOH62643	337	38	299
B10R06C20	10-20-6	Hs~Ref:NM_022491.2~uORF:IOH62643	338	38	300
B10R06C21	10-21-6	Hs~Ref:NM_001003892.1~uORF:IOH60467	188	39	149
B10R06C22	10-22-6	Hs~Ref:NM_001003892.1~uORF:IOH60467	194	39	155
B10R07C01	10-1-7	Hs~MGC:BC006818.1~uORF:IOH3186	230	40	190
B10R07C02	10-2-7	Hs~MGC:BC006818.1~uORF:IOH3186	235	39	196
B10R07C03	10-3-7	Hs~MGC:BC004395.1~uORF:IOH5579	291	38	253
B10R07C04	10-4-7	Hs~MGC:BC004395.1~uORF:IOH5579	292	37	255
B10R07C05	10-5-7	Hs~Ref:NM_152991.1~uORF:IOH41083	764	39	725
B10R07C06	10-6-7	Hs~Ref:NM_152991.1~uORF:IOH41083	791	48	743
B10R07C07	10-7-7	Hs~Ref:XM_098030.3~uORF:IOH41314	410	54	356
B10R07C08	10-8-7	Hs~Ref:XM_098030.3~uORF:IOH41314	403	50	353
B10R07C09	10-9-7	Hs~Ref:NM_058229.2~uORF:IOH41318	279	50	229
B10R07C10	10-10-7	Hs~Ref:NM_058229.2~uORF:IOH41318	390	41	349
B10R07C11	10-11-7	Hs~Ref:NM_001010971.1~uORF:IOH41645	223	46	177
B10R07C12	10-12-7	Hs~Ref:NM_001010971.1~uORF:IOH41645	184	41	143
B10R07C13	10-13-7	Hs~MGC:BC024725.1~uORF:IOH11143	1317	42	1275
B10R07C14	10-14-7	Hs~MGC:BC024725.1~uORF:IOH11143	1271	42	1229
B10R07C15	10-15-7	Hs~MGC:BC022964.1~uORF:IOH10646	494	45	449
B10R07C16	10-16-7	Hs~MGC:BC022964.1~uORF:IOH10646	496	44	452
B10R07C17	10-17-7	Hs~Ref:NM_002827.2~uORF:IOH14245	426	52	374
B10R07C18	10-18-7	Hs~Ref:NM_002827.2~uORF:IOH14245	302	69	233
B10R07C19	10-19-7	Hs~Ref:NM_003907.1~uORF:IOH9815	500	40	460
B10R07C20	10-20-7	Hs~Ref:NM_003907.1~uORF:IOH9815	494	39	455
B10R07C21	10-21-7	Hs~MGC:BC062302.1~uORF:IOH62980	309	39	270
B10R07C22	10-22-7	Hs~MGC:BC062302.1~uORF:IOH62980	306	38	268
B10R08C01	10-1-8	Hs~MGC:BC013277.2~uORF:IOH62917	332	36	296
B10R08C02	10-2-8	Hs~MGC:BC013277.2~uORF:IOH62917	433	44	389
B10R08C03	10-3-8	Hs~MGC:BC045681.1~uORF:IOH62334	452	48	404
B10R08C04	10-4-8	Hs~MGC:BC045681.1~uORF:IOH62334	461	96	365
B10R08C05	10-5-8	Hs~MGC:BC067226.1~uORF:IOH62859	28912	38	28874
B10R08C06	10-6-8	Hs~MGC:BC067226.1~uORF:IOH62859	28163	46	28117
B10R08C07	10-7-8	Hs~MGC:BC030773.2~uORF:IOH22301	603	53	550
B10R08C08	10-8-8	Hs~MGC:BC030773.2~uORF:IOH22301	726	46	680
B10R08C09	10-9-8	Hs~MGC:BC028983.1~uORF:IOH22379	286	45	241
B10R08C10	10-10-8	Hs~MGC:BC028983.1~uORF:IOH22379	495	164	331
B10R08C11	10-11-8	Hs~MGC:BC013005.2~uORF:IOH13631	544	38	506
B10R08C12	10-12-8	Hs~MGC:BC013005.2~uORF:IOH13631	471	60	411
B10R08C13	10-13-8	Hs~MGC:BC013796.1~uORF:IOH21478	509	38	471
B10R08C14	10-14-8	Hs~MGC:BC013796.1~uORF:IOH21478	540	38	502
B10R08C15	10-15-8	Hs~Ref:NM_004089.1~uORF:IOH10420	1148	41	1107
B10R08C16	10-16-8	Hs~Ref:NM_004089.1~uORF:IOH10420	1137	42	1095
B10R08C17	10-17-8	Hs~MGC:BC018028.1~uORF:IOH11035	493	44	449
B10R08C18	10-18-8	Hs~MGC:BC018028.1~uORF:IOH11035	507	111	396
B10R08C19	10-19-8	Hs~MGC:BC025791.1~uORF:IOH10822	365	41	324
B10R08C20	10-20-8	Hs~MGC:BC025791.1~uORF:IOH10822	359	43	316
B10R08C21	10-21-8	Hs~Ref:NM_138463.1~uORF:IOH12071	501	42	459
B10R08C22	10-22-8	Hs~Ref:NM_138463.1~uORF:IOH12071	471	40	431
B10R09C01	10-1-9	Hs~Ref:NM_020247.3~uORF:IOH40578	254	42	212
B10R09C02	10-2-9	Hs~Ref:NM_020247.3~uORF:IOH40578	316	165	151
B10R09C03	10-3-9	Hs~MGC:BC064939.1~uORF:IOH40487	208	37	171
B10R09C04	10-4-9	Hs~MGC:BC064939.1~uORF:IOH40487	224	36	188
B10R09C05	10-5-9	Hs~Ref:NM_032625.1~uORF:IOH40804	215	36	179
B10R09C06	10-6-9	Hs~Ref:NM_032625.1~uORF:IOH40804	170	43	127
B10R09C07	10-7-9	Hs~Ref:NM_001004312.1~uORF:IOH40785	216	60	156
B10R09C08	10-8-9	Hs~Ref:NM_001004312.1~uORF:IOH40785	267	45	222
B10R09C09	10-9-9	Hs~MGC:BC044567.1~uORF:IOH26762	271	91	180
B10R09C10	10-10-9	Hs~MGC:BC044567.1~uORF:IOH26762	216	120	96
B10R09C11	10-11-9	Hs~Ref:NM_021644.2~uORF:IOH26282	409	37	372
B10R09C12	10-12-9	Hs~Ref:NM_021644.2~uORF:IOH26282	59	40	19
B10R09C13	10-13-9	Hs~MGC:BC044569.1~uORF:IOH26901	112	37	75
B10R09C14	10-14-9	Hs~MGC:BC044569.1~uORF:IOH26901	197	46	151
B10R09C15	10-15-9	Hs~MGC:NM_173642.1~uORF:IOH26158	247	38	209
B10R09C16	10-16-9	Hs~MGC:NM_173642.1~uORF:IOH26158	266	38	228
B10R09C17	10-17-9	Hs~Ref:NM_145061.1~uORF:IOH12828	363	43	320
B10R09C18	10-18-9	Hs~Ref:NM_145061.1~uORF:IOH12828	400	51	349
B10R09C19	10-19-9	Hs~MGC:BC009510.1~uORF:IOH12049	661	42	619
B10R09C20	10-20-9	Hs~MGC:BC009510.1~uORF:IOH12049	653	41	612
B10R09C21	10-21-9	Hs~Ref:NM_053050.2~uORF:IOH13265	449	43	406
B10R09C22	10-22-9	Hs~Ref:NM_053050.2~uORF:IOH13265	523	42	481
B10R10C01	10-1-10	Hs~MGC:BC012330.1~uORF:IOH13295	259	74	185
B10R10C02	10-2-10	Hs~MGC:BC012330.1~uORF:IOH13295	326	170	156
B10R10C03	10-3-10	Hs~MGC:BC056917.1~uORF:IOH29050	219	38	181
B10R10C04	10-4-10	Hs~MGC:BC056917.1~uORF:IOH29050	165	35	130
B10R10C05	10-5-10	Hs~MGC:BC021670.1~uORF:IOH27879	296	36	260
B10R10C06	10-6-10	Hs~MGC:BC021670.1~uORF:IOH27879	281	36	245
B10R10C07	10-7-10	Hs~MGC:BC061697.1~uORF:IOH29493	526	46	480
B10R10C08	10-8-10	Hs~MGC:BC061697.1~uORF:IOH29493	581	47	534
B10R10C09	10-9-10	Hs~MGC:BC056270.1~uORF:IOH29486	302	42	260
B10R10C10	10-10-10	Hs~MGC:BC056270.1~uORF:IOH29486	155	38	117
B10R10C11	10-11-10	GST1	38	36	2
B10R10C12	10-12-10	GST1	36	36	0
B10R10C13	10-13-10	GST2	40	36	4
B10R10C14	10-14-10	GST2	39	36	3
B10R10C15	10-15-10	GST3	44	37	7
B10R10C16	10-16-10	GST3	36	38	-2
B10R10C17	10-17-10	GST4	38	38	0
B10R10C18	10-18-10	GST4	57	38	19
B10R10C19	10-19-10	Anti-HumanIgA1~N/A	9113	37	9076
B10R10C20	10-20-10	Anti-HumanIgA1~N/A	8643	38	8605
B10R10C21	10-21-10	Anti-HumanIgA2~N/A	17770	40	17730
B10R10C22	10-22-10	Anti-HumanIgA2~N/A	16936	40	16896
B10R11C01	10-1-11	AlexaAntiMouseAb~N/A	26592	38	26554
B10R11C02	10-2-11	AlexaAntiMouseAb~N/A	27209	37	27172
B10R11C03	10-3-11	MAPKAP~N/A	90	35	55
B10R11C04	10-4-11	MAPKAP~N/A	81	35	46
B10R11C05	10-5-11	Buffer	331	191	140
B10R11C06	10-6-11	Buffer	283	42	241
B10R11C07	10-7-11	BSA~N/A	10605	45	10560
B10R11C08	10-8-11	BSA~N/A	9932	44	9888
B10R11C09	10-9-11	Anti-HumanIgG1~N/A	1944	39	1905
B10R11C10	10-10-11	Anti-HumanIgG1~N/A	1909	38	1871
B10R11C11	10-11-11	Anti-HumanIgG2~N/A	3488	36	3452
B10R11C12	10-12-11	Anti-HumanIgG2~N/A	3199	37	3162
B10R11C13	10-13-11	Anti-HumanIgG3~N/A	4442	38	4404
B10R11C14	10-14-11	Anti-HumanIgG3~N/A	5940	36	5904
B10R11C15	10-15-11	Anti-HumanIgG4~N/A	11532	38	11494
B10R11C16	10-16-11	Anti-HumanIgG4~N/A	11671	38	11633
B10R11C17	10-17-11	AntiBiotinAb~N/A	14549	38	14511
B10R11C18	10-18-11	AntiBiotinAb~N/A	13201	38	13163
B10R11C19	10-19-11	Buffer	64	37	27
B10R11C20	10-20-11	Buffer	62	38	24
B10R11C21	10-21-11	Hs~MGC:BC042038.1~uORF:IOH26441	338	39	299
B10R11C22	10-22-11	Hs~MGC:BC042038.1~uORF:IOH26441	209	39	170
B10R12C01	10-1-12	Hs~MGC:BC017269.2~uORF:IOH29346	357	82	275
B10R12C02	10-2-12	Hs~MGC:BC017269.2~uORF:IOH29346	348	43	305
B10R12C03	10-3-12	Hs~MGC:BC057775.1~uORF:IOH29278	274	65	209
B10R12C04	10-4-12	Hs~MGC:BC057775.1~uORF:IOH29278	214	39	175
B10R12C05	10-5-12	Hs~MGC:BC046152.1~uORF:IOH28874	394	45	349
B10R12C06	10-6-12	Hs~MGC:BC046152.1~uORF:IOH28874	675	49	626
B10R12C07	10-7-12	Hs~Ref:NM_006279.2~uORF:IOH26679	845	55	790
B10R12C08	10-8-12	Hs~Ref:NM_006279.2~uORF:IOH26679	725	46	679
B10R12C09	10-9-12	Hs~Ref:NM_032632.3~uORF:IOH27195	2148	43	2105
B10R12C10	10-10-12	Hs~Ref:NM_032632.3~uORF:IOH27195	2207	42	2165
B10R12C11	10-11-12	Hs~MGC:BC038104.2~uORF:IOH27177	516	39	477
B10R12C12	10-12-12	Hs~MGC:BC038104.2~uORF:IOH27177	589	39	550
B10R12C13	10-13-12	Hs~MGC:BC042674.1~uORF:IOH27340	151	43	108
B10R12C14	10-14-12	Hs~MGC:BC042674.1~uORF:IOH27340	379	39	340
B10R12C15	10-15-12	Hs~MGC:BC100950.1~uORF:IOH63434	219	39	180
B10R12C16	10-16-12	Hs~MGC:BC100950.1~uORF:IOH63434	241	43	198
B10R12C17	10-17-12	Hs~Ref:NM_022406.1~uORF:IOH13122	216	48	168
B10R12C18	10-18-12	Hs~Ref:NM_022406.1~uORF:IOH13122	272	212	60
B10R12C19	10-19-12	Hs~Ref:NM_018330.2~uORF:IOH12545	133	62	71
B10R12C20	10-20-12	Hs~Ref:NM_018330.2~uORF:IOH12545	129	45	84
B10R12C21	10-21-12	Hs~MGC:NM_152670.1~uORF:IOH22560	301	91	210
B10R12C22	10-22-12	Hs~MGC:NM_152670.1~uORF:IOH22560	134	42	92
B10R13C01	10-1-13	Hs~MGC:BC030950.1~uORF:IOH23190	181	44	137
B10R13C02	10-2-13	Hs~MGC:BC030950.1~uORF:IOH23190	185	45	140
B10R13C03	10-3-13	Hs~MGC:BC014949.1~uORF:IOH13331	580	42	538
B10R13C04	10-4-13	Hs~MGC:BC014949.1~uORF:IOH13331	545	42	503
B10R13C05	10-5-13	Hs~Ref:NM_003910.2~uORF:IOH23209	923	51	872
B10R13C06	10-6-13	Hs~Ref:NM_003910.2~uORF:IOH23209	892	58	834
B10R13C07	10-7-13	Hs~Ref:NM_021999.2~uORF:IOH4165	4306	54	4252
B10R13C08	10-8-13	Hs~Ref:NM_021999.2~uORF:IOH4165	4361	52	4309
B10R13C09	10-9-13	Hs~Ref:NM_006072.4~uORF:IOH40395	296	59	237
B10R13C10	10-10-13	Hs~Ref:NM_006072.4~uORF:IOH40395	193	64	129
B10R13C11	10-11-13	Hs~MGC:BC063111.1~uORF:IOH40740	185	41	144
B10R13C12	10-12-13	Hs~MGC:BC063111.1~uORF:IOH40740	260	41	219
B10R13C13	10-13-13	Hs~MGC:BC065041.1~uORF:IOH39974	210	43	167
B10R13C14	10-14-13	Hs~MGC:BC065041.1~uORF:IOH39974	301	50	251
B10R13C15	10-15-13	Hs~Ref:NM_033332.1~uORF:IOH37777	112	43	69
B10R13C16	10-16-13	Hs~Ref:NM_033332.1~uORF:IOH37777	176	61	115
B10R13C17	10-17-13	Hs~MGC:BC004233.1~uORF:IOH5231	286	51	235
B10R13C18	10-18-13	Hs~MGC:BC004233.1~uORF:IOH5231	449	45	404
B10R13C19	10-19-13	Hs~Ref:NM_005000.2~uORF:IOH3084	236	100	136
B10R13C20	10-20-13	Hs~Ref:NM_005000.2~uORF:IOH3084	237	40	197
B10R13C21	10-21-13	Hs~Ref:NM_005333.1~uORF:IOH3923	214	68	146
B10R13C22	10-22-13	Hs~Ref:NM_005333.1~uORF:IOH3923	110	44	66
B10R14C01	10-1-14	Hs~MGC:BC015066.1~uORF:IOH13784	211	39	172
B10R14C02	10-2-14	Hs~MGC:BC015066.1~uORF:IOH13784	278	138	140
B10R14C03	10-3-14	Hs~Ref:NM_001001787.1~uORF:IOH59280	236	41	195
B10R14C04	10-4-14	Hs~Ref:NM_001001787.1~uORF:IOH59280	187	39	148
B10R14C05	10-5-14	Hs~Ref:NM_053031.2~uORF:IOH59941	2847	39	2808
B10R14C06	10-6-14	Hs~Ref:NM_053031.2~uORF:IOH59941	2958	38	2920
B10R14C07	10-7-14	Hs~Ref:NM_000618.2~uORF:IOH58981	231	45	186
B10R14C08	10-8-14	Hs~Ref:NM_000618.2~uORF:IOH58981	195	55	140
B10R14C09	10-9-14	Hs~Ref:NM_005808.2~uORF:IOH53465	149	48	101
B10R14C10	10-10-14	Hs~Ref:NM_005808.2~uORF:IOH53465	199	41	158
B10R14C11	10-11-14	Hs~MGC:BC104212.1~uORF:IOH63625	109	85	24
B10R14C12	10-12-14	Hs~MGC:BC104212.1~uORF:IOH63625	134	41	93
B10R14C13	10-13-14	Hs~MGC:BC013396.2~uORF:IOH60266	240	47	193
B10R14C14	10-14-14	Hs~MGC:BC013396.2~uORF:IOH60266	248	45	203
B10R14C15	10-15-14	Hs~MGC:BC027951.1~uORF:IOH11889	1619	41	1578
B10R14C16	10-16-14	Hs~MGC:BC027951.1~uORF:IOH11889	1640	39	1601
B10R14C17	10-17-14	Hs~Ref:NM_004635.2~N/A	121	37	84
B10R14C18	10-18-14	Hs~Ref:NM_004635.2~N/A	256	80	176
B10R14C19	10-19-14	Hs~Ref:NM_172201.1~uORF:IOH44398	448	39	409
B10R14C20	10-20-14	Hs~Ref:NM_172201.1~uORF:IOH44398	459	38	421
B10R14C21	10-21-14	Hs~MGC:BC001632.1~uORF:IOH4852	223	39	184
B10R14C22	10-22-14	Hs~MGC:BC001632.1~uORF:IOH4852	223	41	182
B10R15C01	10-1-15	Hs~Ref:NM_014373.1~uORF:IOH60812	592	165	427
B10R15C02	10-2-15	Hs~Ref:NM_014373.1~uORF:IOH60812	538	36	502
B10R15C03	10-3-15	Hs~MGC:BC103695.1~uORF:IOH63601	197	36	161
B10R15C04	10-4-15	Hs~MGC:BC103695.1~uORF:IOH63601	199	37	162
B10R15C05	10-5-15	Hs~MGC:BC041339.1~uORF:IOH25831	337	90	247
B10R15C06	10-6-15	Hs~MGC:BC041339.1~uORF:IOH25831	286	37	249
B10R15C07	10-7-15	Hs~MGC:BC031999.1~uORF:IOH22178	469	55	414
B10R15C08	10-8-15	Hs~MGC:BC031999.1~uORF:IOH22178	457	57	400
B10R15C09	10-9-15	Hs~MGC:BC036015.1~uORF:IOH27212	381	51	330
B10R15C10	10-10-15	Hs~MGC:BC036015.1~uORF:IOH27212	364	53	311
B10R15C11	10-11-15	Hs~MGC:NM_178863.2~uORF:IOH27502	468	39	429
B10R15C12	10-12-15	Hs~MGC:NM_178863.2~uORF:IOH27502	496	37	459
B10R15C13	10-13-15	Hs~IVGN:PM_2132~Ext:myeloperoxidase_Sigma~N/A	43	41	2
B10R15C14	10-14-15	Hs~IVGN:PM_2132~Ext:myeloperoxidase_Sigma~N/A	62	39	23
B10R15C15	10-15-15	Hs~Ref:NM_002378.2~CAT:PV3370	2543	37	2506
B10R15C16	10-16-15	Hs~Ref:NM_002378.2~CAT:PV3370	2418	37	2381
B10R15C17	10-17-15	Hs~Ref:NM_005923.3~CAT:PV3809	86	35	51
B10R15C18	10-18-15	Hs~Ref:NM_005923.3~CAT:PV3809	101	36	65
B10R15C19	10-19-15	Hs~Ref:NM_033118.2~CAT:PV3757	165	59	106
B10R15C20	10-20-15	Hs~Ref:NM_033118.2~CAT:PV3757	101	40	61
B10R15C21	10-21-15	Hs~Ref:NM_033141.2~CAT:PV3787	42	43	-1
B10R15C22	10-22-15	Hs~Ref:NM_033141.2~CAT:PV3787	141	41	100
B10R16C01	10-1-16	Hs~Ref:NM_001039468.1~CAT:PV3878	1979	35	1944
B10R16C02	10-2-16	Hs~Ref:NM_001039468.1~CAT:PV3878	2046	35	2011
B10R16C03	10-3-16	Hs~Ref:NM_000576.1~CAT_PHC0816	51	34	17
B10R16C04	10-4-16	Hs~Ref:NM_000576.1~CAT_PHC0816	52	35	17
B10R16C05	10-5-16	Hs~IVGN:NM_001099691~CAT_PHG0051~N/A	103	39	64
B10R16C06	10-6-16	Hs~IVGN:NM_001099691~CAT_PHG0051~N/A	122	38	84
B10R16C07	10-7-16	Hs~Ref:NM_001002262.1~uORF:IOH53496	274	64	210
B10R16C08	10-8-16	Hs~Ref:NM_001002262.1~uORF:IOH53496	329	60	269
B10R16C09	10-9-16	Hs~Ref:NM_001008711.1~uORF:IOH59712	584	73	511
B10R16C10	10-10-16	Hs~Ref:NM_001008711.1~uORF:IOH59712	511	55	456
B10R16C11	10-11-16	Hs~Ref:NM_145909.1~uORF:IOH45888	968	41	927
B10R16C12	10-12-16	Hs~Ref:NM_145909.1~uORF:IOH45888	970	41	929
B10R16C13	10-13-16	Hs~Ref:NM_015143.1~uORF:IOH59999	299	160	139
B10R16C14	10-14-16	Hs~Ref:NM_015143.1~uORF:IOH59999	314	43	271
B10R16C15	10-15-16	Hs~Ref:NM_000918.2~uORF:IOH9865	264	43	221
B10R16C16	10-16-16	Hs~Ref:NM_000918.2~uORF:IOH9865	169	40	129
B10R16C17	10-17-16	Hs~Ref:NM_018120.3~uORF:IOH13750	36	36	0
B10R16C18	10-18-16	Hs~Ref:NM_018120.3~uORF:IOH13750	37	37	0
B10R16C19	10-19-16	Hs~MGC:BC004872.2~uORF:IOH5609	214	44	170
B10R16C20	10-20-16	Hs~MGC:BC004872.2~uORF:IOH5609	180	46	134
B10R16C21	10-21-16	Hs~MGC:BC008288.1~uORF:IOH6248	135	46	89
B10R16C22	10-22-16	Hs~MGC:BC008288.1~uORF:IOH6248	147	45	102
B10R17C01	10-1-17	Hs~MGC:BC024209.1~uORF:IOH14787	225	118	107
B10R17C02	10-2-17	Hs~MGC:BC024209.1~uORF:IOH14787	254	105	149
B10R17C03	10-3-17	Hs~Ref:NM_001993.2~uORF:IOH13709	105	36	69
B10R17C04	10-4-17	Hs~Ref:NM_001993.2~uORF:IOH13709	93	36	57
B10R17C05	10-5-17	Hs~MGC:BC015821.1~uORF:IOH14398	169	37	132
B10R17C06	10-6-17	Hs~MGC:BC015821.1~uORF:IOH14398	201	39	162
B10R17C07	10-7-17	Hs~Ref:NM_017566.2~uORF:IOH11408	401	74	327
B10R17C08	10-8-17	Hs~Ref:NM_017566.2~uORF:IOH11408	240	60	180
B10R17C09	10-9-17	Hs~MGC:BC001214.1~uORF:IOH4802	93	60	33
B10R17C10	10-10-17	Hs~MGC:BC001214.1~uORF:IOH4802	86	50	36
B10R17C11	10-11-17	Hs~Ref:NM_020992.2~uORF:IOH2948	300	44	256
B10R17C12	10-12-17	Hs~Ref:NM_020992.2~uORF:IOH2948	311	45	266
B10R17C13	10-13-17	Hs~MGC:BC003168.1~uORF:IOH5086	47	48	-1
B10R17C14	10-14-17	Hs~MGC:BC003168.1~uORF:IOH5086	53	43	10
B10R17C15	10-15-17	Hs~MGC:BC005383.1~uORF:IOH7229	106	71	35
B10R17C16	10-16-17	Hs~MGC:BC005383.1~uORF:IOH7229	93	50	43
B10R17C17	10-17-17	Hs~Ref:NM_203418.1~uORF:IOH41499	1289	41	1248
B10R17C18	10-18-17	Hs~Ref:NM_203418.1~uORF:IOH41499	1283	39	1244
B10R17C19	10-19-17	Hs~MGC:BC009763.2~uORF:IOH57084	89	39	50
B10R17C20	10-20-17	Hs~MGC:BC009763.2~uORF:IOH57084	47	45	2
B10R17C21	10-21-17	Hs~MGC:NM_015660.1~uORF:IOH12432	440	42	398
B10R17C22	10-22-17	Hs~MGC:NM_015660.1~uORF:IOH12432	397	41	356
B10R18C01	10-1-18	Hs~MGC:BC098112.1~uORF:IOH63324	411	36	375
B10R18C02	10-2-18	Hs~MGC:BC098112.1~uORF:IOH63324	370	37	333
B10R18C03	10-3-18	Hs~MGC:BC067427.1~uORF:IOH62526	93	36	57
B10R18C04	10-4-18	Hs~MGC:BC067427.1~uORF:IOH62526	87	37	50
B10R18C05	10-5-18	Hs~MGC:BC018203.1~uORF:IOH61506	166	37	129
B10R18C06	10-6-18	Hs~MGC:BC018203.1~uORF:IOH61506	245	39	206
B10R18C07	10-7-18	Hs~MGC:BC069999.1~uORF:IOH61829	563	166	397
B10R18C08	10-8-18	Hs~MGC:BC069999.1~uORF:IOH61829	711	65	646
B10R18C09	10-9-18	Hs~MGC:BC099627.1~uORF:IOH63198	296	64	232
B10R18C10	10-10-18	Hs~MGC:BC099627.1~uORF:IOH63198	189	72	117
B10R18C11	10-11-18	Hs~Ref:NM_002089.1~uORF:IOH13606	481	50	431
B10R18C12	10-12-18	Hs~Ref:NM_002089.1~uORF:IOH13606	489	45	444
B10R18C13	10-13-18	Hs~Ref:NM_203301.1~uORF:IOH28939	799	132	667
B10R18C14	10-14-18	Hs~Ref:NM_203301.1~uORF:IOH28939	240	73	167
B10R18C15	10-15-18	Hs~Ref:NM_001047.1~uORF:IOH7304	647	43	604
B10R18C16	10-16-18	Hs~Ref:NM_001047.1~uORF:IOH7304	424	43	381
B10R18C17	10-17-18	Hs~Ref:NM_173608.1~uORF:IOH9994	534	42	492
B10R18C18	10-18-18	Hs~Ref:NM_173608.1~uORF:IOH9994	475	41	434
B10R18C19	10-19-18	Hs~Ref:NM_002561.1~uORF:IOH29559	231	40	191
B10R18C20	10-20-18	Hs~Ref:NM_002561.1~uORF:IOH29559	472	44	428
B10R18C21	10-21-18	Hs~MGC:BC058890.1~uORF:IOH29083	345	44	301
B10R18C22	10-22-18	Hs~MGC:BC058890.1~uORF:IOH29083	219	47	172
B10R19C01	10-1-19	Hs~MGC:BC035364.1~uORF:IOH28677	386	37	349
B10R19C02	10-2-19	Hs~MGC:BC035364.1~uORF:IOH28677	476	139	337
B10R19C03	10-3-19	Hs~MGC:BC028212.1~uORF:IOH28685	340	37	303
B10R19C04	10-4-19	Hs~MGC:BC028212.1~uORF:IOH28685	285	38	247
B10R19C05	10-5-19	Hs~MGC:BC063416.1~uORF:IOH61550	134	40	94
B10R19C06	10-6-19	Hs~MGC:BC063416.1~uORF:IOH61550	321	46	275
B10R19C07	10-7-19	Hs~Ref:NM_014410.4~uORF:IOH11005	90	62	28
B10R19C08	10-8-19	Hs~Ref:NM_014410.4~uORF:IOH11005	101	60	41
B10R19C09	10-9-19	Hs~Ref:NM_022060.2~uORF:IOH11269	102	55	47
B10R19C10	10-10-19	Hs~Ref:NM_022060.2~uORF:IOH11269	94	52	42
B10R19C11	10-11-19	Hs~Ref:NM_014284.1~uORF:IOH11121	114	46	68
B10R19C12	10-12-19	Hs~Ref:NM_014284.1~uORF:IOH11121	99	43	56
B10R19C13	10-13-19	Hs~Ref:NM_002876.2~uORF:IOH58772	310	42	268
B10R19C14	10-14-19	Hs~Ref:NM_002876.2~uORF:IOH58772	263	50	213
B10R19C15	10-15-19	Hs~Ref:NM_003339.2~uORF:IOH58973	202	48	154
B10R19C16	10-16-19	Hs~Ref:NM_003339.2~uORF:IOH58973	210	46	164
B10R19C17	10-17-19	Hs~MGC:NM_198829.1~uORF:IOH58974	239	43	196
B10R19C18	10-18-19	Hs~MGC:NM_198829.1~uORF:IOH58974	248	164	84
B10R19C19	10-19-19	Hs~Ref:NM_021128.3~uORF:IOH58928	133	45	88
B10R19C20	10-20-19	Hs~Ref:NM_021128.3~uORF:IOH58928	211	47	164
B10R19C21	10-21-19	Hs~Ref:NM_000854.2~uORF:IOH4186	195	65	130
B10R19C22	10-22-19	Hs~Ref:NM_000854.2~uORF:IOH4186	175	61	114
B10R20C01	10-1-20	Hs~MGC:BC008605.1~uORF:IOH3330	214	40	174
B10R20C02	10-2-20	Hs~MGC:BC008605.1~uORF:IOH3330	298	55	243
B10R20C03	10-3-20	Hs~Ref:NM_005620.1~uORF:IOH4079	140	41	99
B10R20C04	10-4-20	Hs~Ref:NM_005620.1~uORF:IOH4079	157	39	118
B10R20C05	10-5-20	Hs~Ref:NM_003662.1~uORF:IOH4076	383	39	344
B10R20C06	10-6-20	Hs~Ref:NM_003662.1~uORF:IOH4076	484	52	432
B10R20C07	10-7-20	Hs~Ref:NM_021805.1~uORF:IOH5038	611	80	531
B10R20C08	10-8-20	Hs~Ref:NM_021805.1~uORF:IOH5038	558	81	477
B10R20C09	10-9-20	Hs~Ref:NM_001197.3~uORF:IOH4916	601	64	537
B10R20C10	10-10-20	Hs~Ref:NM_001197.3~uORF:IOH4916	638	121	517
B10R20C11	10-11-20	Hs~MGC:BC007782.2~uORF:IOH6514	596	58	538
B10R20C12	10-12-20	Hs~MGC:BC007782.2~uORF:IOH6514	594	47	547
B10R20C13	10-13-20	Hs~MGC:NM_178553.2~uORF:IOH25885	2493	41	2452
B10R20C14	10-14-20	Hs~MGC:NM_178553.2~uORF:IOH25885	2600	40	2560
B10R20C15	10-15-20	Hs~Ref:NM_003238.1~uORF:IOH42941	1249	40	1209
B10R20C16	10-16-20	Hs~Ref:NM_003238.1~uORF:IOH42941	1081	40	1041
B10R20C17	10-17-20	Hs~Ref:NM_173083.2~uORF:IOH43221	1033	39	994
B10R20C18	10-18-20	Hs~Ref:NM_173083.2~uORF:IOH43221	1040	39	1001
B10R20C19	10-19-20	Hs~Ref:NM_203283.1~uORF:IOH44496	1982	39	1943
B10R20C20	10-20-20	Hs~Ref:NM_203283.1~uORF:IOH44496	2006	40	1966
B10R20C21	10-21-20	Hs~Ref:NM_138633.1~uORF:IOH44631	214	56	158
B10R20C22	10-22-20	Hs~Ref:NM_138633.1~uORF:IOH44631	215	166	49
B10R21C01	10-1-21	Hs~Ref:NM_181290.1~uORF:IOH50063	682	34	648
B10R21C02	10-2-21	Hs~Ref:NM_181290.1~uORF:IOH50063	696	36	660
B10R21C03	10-3-21	Hs~Ref:NM_001003713.1~uORF:IOH50157	890	37	853
B10R21C04	10-4-21	Hs~Ref:NM_001003713.1~uORF:IOH50157	905	37	868
B10R21C05	10-5-21	Hs~Ref:NM_205839.1~uORF:IOH50101	726	37	689
B10R21C06	10-6-21	Hs~Ref:NM_205839.1~uORF:IOH50101	810	46	764
B10R21C07	10-7-21	Hs~Ref:NM_205838.1~uORF:IOH50083	801	65	736
B10R21C08	10-8-21	Hs~Ref:NM_205838.1~uORF:IOH50083	725	63	662
B10R21C09	10-9-21	Hs~Ref:NP_002474.3~CAT_10823-H08H-25	57	58	-1
B10R21C10	10-10-21	Hs~Ref:NP_002474.3~CAT_10823-H08H-25	53	53	0
B10R21C11	10-11-21	Internal_1007209	350	57	293
B10R21C12	10-12-21	Internal_1007209	316	55	261
B10R21C13	10-13-21	Hs~Ref:NP_057593.3~CAT_10976-H07H-25	41	36	5
B10R21C14	10-14-21	Hs~Ref:NP_057593.3~CAT_10976-H07H-25	40	36	4
B10R21C15	10-15-21	Internal_1007209	50	36	14
B10R21C16	10-16-21	Internal_1007209	48	37	11
B10R21C17	10-17-21	Hs~Ref:NP_075594.1~CAT_10616-H08H-25	37	36	1
B10R21C18	10-18-21	Hs~Ref:NP_075594.1~CAT_10616-H08H-25	35	36	-1
B10R21C19	10-19-21	Internal_1007209	38	36	2
B10R21C20	10-20-21	Internal_1007209	46	41	5
B10R21C21	10-21-21	Internal_1007209	1852	46	1806
B10R21C22	10-22-21	Internal_1007209	1786	44	1742
B10R22C01	10-1-22	ERa~N/A	2639	34	2605
B10R22C02	10-2-22	ERa~N/A	2654	34	2620
B10R22C03	10-3-22	PKCeta~N/A	248	94	154
B10R22C04	10-4-22	PKCeta~N/A	281	52	229
B10R22C05	10-5-22	Calmodulin~N/A	59	43	16
B10R22C06	10-6-22	Calmodulin~N/A	185	43	142
B10R22C07	10-7-22	V5control5~N/A	225	50	175
B10R22C08	10-8-22	V5control5~N/A	294	53	241
B10R22C09	10-9-22	V5control4~N/A	241	91	150
B10R22C10	10-10-22	V5control4~N/A	120	52	68
B10R22C11	10-11-22	V5control3~N/A	102	51	51
B10R22C12	10-12-22	V5control3~N/A	70	40	30
B10R22C13	10-13-22	V5control2~N/A	58	36	22
B10R22C14	10-14-22	V5control2~N/A	51	36	15
B10R22C15	10-15-22	V5control1~N/A	48	36	12
B10R22C16	10-16-22	V5control1~N/A	50	37	13
B10R22C17	10-17-22	CMK2A~N/A	203	41	162
B10R22C18	10-18-22	CMK2A~N/A	254	42	212
B10R22C19	10-19-22	ERa~N/A	1885	36	1849
B10R22C20	10-20-22	ERa~N/A	1713	36	1677
B10R22C21	10-21-22	AlexaAntiMouseAb~N/A	10722	37	10685
B10R22C22	10-22-22	AlexaAntiMouseAb~N/A	10163	37	10126
B11R01C01	11-1-1	AlexaAntiMouseAb~N/A	33122	37	33085
B11R01C02	11-2-1	AlexaAntiMouseAb~N/A	34825	38	34787
B11R01C03	11-3-1	ERa~N/A	1562	38	1524
B11R01C04	11-4-1	ERa~N/A	1600	39	1561
B11R01C05	11-5-1	HumanIgG1~N/A	921	38	883
B11R01C06	11-6-1	HumanIgG1~N/A	1024	38	986
B11R01C07	11-7-1	HumanIgG2~N/A	3512	40	3472
B11R01C08	11-8-1	HumanIgG2~N/A	3583	40	3543
B11R01C09	11-9-1	HumanIgG3~N/A	16784	40	16744
B11R01C10	11-10-1	HumanIgG3~N/A	16788	41	16747
B11R01C11	11-11-1	HumanIgG4~N/A	43487	43	43444
B11R01C12	11-12-1	HumanIgG4~N/A	45059	45	45014
B11R01C13	11-13-1	BiotinAb~N/A	427	150	277
B11R01C14	11-14-1	BiotinAb~N/A	375	42	333
B11R01C15	11-15-1	RanBP2deltaFG~N/A	419	39	380
B11R01C16	11-16-1	RanBP2deltaFG~N/A	390	40	350
B11R01C17	11-17-1	hMDM2~N/A	748	43	705
B11R01C18	11-18-1	hMDM2~N/A	914	43	871
B11R01C19	11-19-1	PKCeta~N/A	605	41	564
B11R01C20	11-20-1	PKCeta~N/A	587	42	545
B11R01C21	11-21-1	AlexaAntiMouseAb~N/A	38676	47	38629
B11R01C22	11-22-1	AlexaAntiMouseAb~N/A	36339	50	36289
B11R02C01	11-1-2	PKCeta~N/A	1772	38	1734
B11R02C02	11-2-2	PKCeta~N/A	1896	39	1857
B11R02C03	11-3-2	Buffer	378	43	335
B11R02C04	11-4-2	Buffer	536	46	490
B11R02C05	11-5-2	HumanIgA~N/A	23201	42	23159
B11R02C06	11-6-2	HumanIgA~N/A	24023	42	23981
B11R02C07	11-7-2	Buffer	139	69	70
B11R02C08	11-8-2	Buffer	147	42	105
B11R02C09	11-9-2	BSA~N/A	12908	42	12866
B11R02C10	11-10-2	BSA~N/A	13360	47	13313
B11R02C11	11-11-2	Hs~MGC:BC034401.1~uORF:IOH22782	854	50	804
B11R02C12	11-12-2	Hs~MGC:BC034401.1~uORF:IOH22782	888	49	839
B11R02C13	11-13-2	Hs~MGC:BC032003.1~uORF:IOH22182	364	46	318
B11R02C14	11-14-2	Hs~MGC:BC032003.1~uORF:IOH22182	416	45	371
B11R02C15	11-15-2	Hs~MGC:BC007228.1~uORF:IOH6059	840	44	796
B11R02C16	11-16-2	Hs~MGC:BC007228.1~uORF:IOH6059	888	45	843
B11R02C17	11-17-2	Hs~MGC:BC029526.1~uORF:IOH22575	669	49	620
B11R02C18	11-18-2	Hs~MGC:BC029526.1~uORF:IOH22575	583	45	538
B11R02C19	11-19-2	Hs~MGC:BC032334.1~uORF:IOH21658	1940	43	1897
B11R02C20	11-20-2	Hs~MGC:BC032334.1~uORF:IOH21658	2216	43	2173
B11R02C21	11-21-2	Hs~Ref:NM_175907.3~uORF:IOH21771	65535	54	65481
B11R02C22	11-22-2	Hs~Ref:NM_175907.3~uORF:IOH21771	65535	49	65486
B11R03C01	11-1-3	Hs~Ref:NM_001008388.1~uORF:IOH21642	288	40	248
B11R03C02	11-2-3	Hs~Ref:NM_001008388.1~uORF:IOH21642	119	51	68
B11R03C03	11-3-3	Hs~MGC:BC030521.2~uORF:IOH21677	211	50	161
B11R03C04	11-4-3	Hs~MGC:BC030521.2~uORF:IOH21677	261	48	213
B11R03C05	11-5-3	Hs~Ref:NM_006578.2~uORF:IOH14466	258	46	212
B11R03C06	11-6-3	Hs~Ref:NM_006578.2~uORF:IOH14466	399	51	348
B11R03C07	11-7-3	Hs~Ref:NM_032837.1~uORF:IOH14641	1636	47	1589
B11R03C08	11-8-3	Hs~Ref:NM_032837.1~uORF:IOH14641	1618	45	1573
B11R03C09	11-9-3	Hs~MGC:BC014008.1~uORF:IOH13883	354	43	311
B11R03C10	11-10-3	Hs~MGC:BC014008.1~uORF:IOH13883	103	56	47
B11R03C11	11-11-3	Hs~MGC:BC017314.2~uORF:IOH14156	274	56	218
B11R03C12	11-12-3	Hs~MGC:BC017314.2~uORF:IOH14156	350	55	295
B11R03C13	11-13-3	Hs~Ref:NM_001250.2~uORF:IOH10427	586	78	508
B11R03C14	11-14-3	Hs~Ref:NM_001250.2~uORF:IOH10427	594	47	547
B11R03C15	11-15-3	Hs~Ref:NM_022110.2~uORF:IOH10458	256	47	209
B11R03C16	11-16-3	Hs~Ref:NM_022110.2~uORF:IOH10458	312	51	261
B11R03C17	11-17-3	Hs~MGC:BC012397.1~uORF:IOH10484	443	44	399
B11R03C18	11-18-3	Hs~MGC:BC012397.1~uORF:IOH10484	453	44	409
B11R03C19	11-19-3	Hs~MGC:BC015944.1~uORF:IOH10042	1538	42	1496
B11R03C20	11-20-3	Hs~MGC:BC015944.1~uORF:IOH10042	1377	43	1334
B11R03C21	11-21-3	Hs~Ref:NM_001561.3~uORF:IOH5753	748	46	702
B11R03C22	11-22-3	Hs~Ref:NM_001561.3~uORF:IOH5753	671	44	627
B11R04C01	11-1-4	Hs~Ref:NM_003794.1~uORF:IOH14878	633	41	592
B11R04C02	11-2-4	Hs~Ref:NM_003794.1~uORF:IOH14878	711	49	662
B11R04C03	11-3-4	Hs~MGC:BC021120.1~uORF:IOH14846	527	55	472
B11R04C04	11-4-4	Hs~MGC:BC021120.1~uORF:IOH14846	551	44	507
B11R04C05	11-5-4	Hs~Ref:NM_004309.2~uORF:IOH5797	1244	53	1191
B11R04C06	11-6-4	Hs~Ref:NM_004309.2~uORF:IOH5797	1233	59	1174
B11R04C07	11-7-4	Hs~MGC:BC025729.1~uORF:IOH10931	697	62	635
B11R04C08	11-8-4	Hs~MGC:BC025729.1~uORF:IOH10931	636	56	580
B11R04C09	11-9-4	Hs~Ref:NM_138722.1~uORF:IOH10975	776	44	732
B11R04C10	11-10-4	Hs~Ref:NM_138722.1~uORF:IOH10975	745	47	698
B11R04C11	11-11-4	Hs~Ref:NM_024610.2~uORF:IOH13320	723	50	673
B11R04C12	11-12-4	Hs~Ref:NM_024610.2~uORF:IOH13320	735	52	683
B11R04C13	11-13-4	Hs~Ref:NM_016310.2~uORF:IOH12571	647	49	598
B11R04C14	11-14-4	Hs~Ref:NM_016310.2~uORF:IOH12571	622	47	575
B11R04C15	11-15-4	Hs~Ref:NM_005148.2~uORF:IOH10962	382	46	336
B11R04C16	11-16-4	Hs~Ref:NM_005148.2~uORF:IOH10962	352	48	304
B11R04C17	11-17-4	Hs~Ref:NM_002739.1~uORF:IOH21330	385	45	340
B11R04C18	11-18-4	Hs~Ref:NM_002739.1~uORF:IOH21330	291	45	246
B11R04C19	11-19-4	Hs~Ref:NM_017861.1~uORF:IOH10774	287	43	244
B11R04C20	11-20-4	Hs~Ref:NM_017861.1~uORF:IOH10774	296	46	250
B11R04C21	11-21-4	Hs~Ref:NM_144770.1~uORF:IOH22581	497	47	450
B11R04C22	11-22-4	Hs~Ref:NM_144770.1~uORF:IOH22581	450	45	405
B11R05C01	11-1-5	Hs~MGC:BC032578.1~uORF:IOH21927	161	44	117
B11R05C02	11-2-5	Hs~MGC:BC032578.1~uORF:IOH21927	307	50	257
B11R05C03	11-3-5	Hs~MGC:BC000897.1~uORF:IOH3214	211	44	167
B11R05C04	11-4-5	Hs~MGC:BC000897.1~uORF:IOH3214	233	46	187
B11R05C05	11-5-5	Hs~Ref:NM_024854.2~uORF:IOH12803	295	70	225
B11R05C06	11-6-5	Hs~Ref:NM_024854.2~uORF:IOH12803	232	52	180
B11R05C07	11-7-5	Hs~Ref:NM_005030.2~uORF:IOH5070	2073	66	2007
B11R05C08	11-8-5	Hs~Ref:NM_005030.2~uORF:IOH5070	2377	57	2320
B11R05C09	11-9-5	Hs~MGC:BC017328.2~uORF:IOH14721	666	42	624
B11R05C10	11-10-5	Hs~MGC:BC017328.2~uORF:IOH14721	486	43	443
B11R05C11	11-11-5	Hs~MGC:BC014851.1~uORF:IOH11293	720	45	675
B11R05C12	11-12-5	Hs~MGC:BC014851.1~uORF:IOH11293	756	46	710
B11R05C13	11-13-5	Hs~Ref:NM_005317.2~uORF:IOH12008	599	45	554
B11R05C14	11-14-5	Hs~Ref:NM_005317.2~uORF:IOH12008	590	44	546
B11R05C15	11-15-5	Hs~MGC:BC001135.1~uORF:IOH3862	872	44	828
B11R05C16	11-16-5	Hs~MGC:BC001135.1~uORF:IOH3862	830	44	786
B11R05C17	11-17-5	Hs~MGC:BC052995.2~uORF:IOH28910	1504	46	1458
B11R05C18	11-18-5	Hs~MGC:BC052995.2~uORF:IOH28910	1495	50	1445
B11R05C19	11-19-5	Hs~Ref:NM_016526.3~uORF:IOH28695	431	55	376
B11R05C20	11-20-5	Hs~Ref:NM_016526.3~uORF:IOH28695	818	47	771
B11R05C21	11-21-5	Hs~MGC:BC029360.1~uORF:IOH23138	726	45	681
B11R05C22	11-22-5	Hs~MGC:BC029360.1~uORF:IOH23138	650	47	603
B11R06C01	11-1-6	Hs~Ref:NM_006924.3~uORF:IOH11039	1307	42	1265
B11R06C02	11-2-6	Hs~Ref:NM_006924.3~uORF:IOH11039	1424	42	1382
B11R06C03	11-3-6	Hs~Ref:NM_025099.1~uORF:IOH13233	264	40	224
B11R06C04	11-4-6	Hs~Ref:NM_025099.1~uORF:IOH13233	56	50	6
B11R06C05	11-5-6	Hs~Ref:NM_020374.2~uORF:IOH11080	393	43	350
B11R06C06	11-6-6	Hs~Ref:NM_020374.2~uORF:IOH11080	370	44	326
B11R06C07	11-7-6	Hs~MGC:BC009416.1~uORF:IOH12693	376	121	255
B11R06C08	11-8-6	Hs~MGC:BC009416.1~uORF:IOH12693	283	49	234
B11R06C09	11-9-6	Hs~Ref:NM_014182.2~uORF:IOH12795	291	48	243
B11R06C10	11-10-6	Hs~Ref:NM_014182.2~uORF:IOH12795	239	49	190
B11R06C11	11-11-6	Hs~MGC:BC065928.1~uORF:IOH39967	232	48	184
B11R06C12	11-12-6	Hs~MGC:BC065928.1~uORF:IOH39967	147	46	101
B11R06C13	11-13-6	Hs~Ref:NM_021204.1~uORF:IOH40021	258	142	116
B11R06C14	11-14-6	Hs~Ref:NM_021204.1~uORF:IOH40021	147	49	98
B11R06C15	11-15-6	Hs~Ref:NM_183059.1~uORF:IOH39968	456	55	401
B11R06C16	11-16-6	Hs~Ref:NM_183059.1~uORF:IOH39968	442	59	383
B11R06C17	11-17-6	Hs~Ref:NM_005884.2~uORF:IOH2475	1645	48	1597
B11R06C18	11-18-6	Hs~Ref:NM_005884.2~uORF:IOH2475	1629	46	1583
B11R06C19	11-19-6	Hs~Ref:NM_002787.1~uORF:IOH26683	211	49	162
B11R06C20	11-20-6	Hs~Ref:NM_002787.1~uORF:IOH26683	192	47	145
B11R06C21	11-21-6	Hs~Ref:NM_007022.1~uORF:IOH26702	261	53	208
B11R06C22	11-22-6	Hs~Ref:NM_007022.1~uORF:IOH26702	394	140	254
B11R07C01	11-1-7	Hs~MGC:BC039855.1~uORF:IOH26182	205	39	166
B11R07C02	11-2-7	Hs~MGC:BC039855.1~uORF:IOH26182	240	40	200
B11R07C03	11-3-7	Hs~Ref:NM_031477.1~uORF:IOH27026	273	41	232
B11R07C04	11-4-7	Hs~Ref:NM_031477.1~uORF:IOH27026	246	43	203
B11R07C05	11-5-7	Hs~MGC:BC003376.1~uORF:IOH2942	496	42	454
B11R07C06	11-6-7	Hs~MGC:BC003376.1~uORF:IOH2942	454	42	412
B11R07C07	11-7-7	Hs~MGC:BC000961.2~uORF:IOH3037	157	44	113
B11R07C08	11-8-7	Hs~MGC:BC000961.2~uORF:IOH3037	168	67	101
B11R07C09	11-9-7	Hs~MGC:BC002880.1~uORF:IOH5687	551	55	496
B11R07C10	11-10-7	Hs~MGC:BC002880.1~uORF:IOH5687	555	55	500
B11R07C11	11-11-7	Hs~MGC:BC039859.1~uORF:IOH26212	203	45	158
B11R07C12	11-12-7	Hs~MGC:BC039859.1~uORF:IOH26212	281	51	230
B11R07C13	11-13-7	Hs~Ref:XM_171154.3~uORF:IOH43663	938	45	893
B11R07C14	11-14-7	Hs~Ref:XM_171154.3~uORF:IOH43663	902	48	854
B11R07C15	11-15-7	Hs~Ref:NM_017451.1~uORF:IOH42068	2569	55	2514
B11R07C16	11-16-7	Hs~Ref:NM_017451.1~uORF:IOH42068	2562	51	2511
B11R07C17	11-17-7	Hs~Ref:NM_178169.2~uORF:IOH43677	947	44	903
B11R07C18	11-18-7	Hs~Ref:NM_178169.2~uORF:IOH43677	869	45	824
B11R07C19	11-19-7	Hs~Ref:NM_078625.2~uORF:IOH42141	646	45	601
B11R07C20	11-20-7	Hs~Ref:NM_078625.2~uORF:IOH42141	620	48	572
B11R07C21	11-21-7	Hs~Ref:NM_032855.1~uORF:IOH14623	9301	69	9232
B11R07C22	11-22-7	Hs~Ref:NM_032855.1~uORF:IOH14623	9339	62	9277
B11R08C01	11-1-8	Hs~Ref:NM_021822.1~uORF:IOH13894	910	41	869
B11R08C02	11-2-8	Hs~Ref:NM_021822.1~uORF:IOH13894	882	40	842
B11R08C03	11-3-8	Hs~Ref:NM_145063.1~uORF:IOH13839	783	40	743
B11R08C04	11-4-8	Hs~Ref:NM_145063.1~uORF:IOH13839	740	45	695
B11R08C05	11-5-8	Hs~Ref:NM_017706.2~uORF:IOH4301	764	44	720
B11R08C06	11-6-8	Hs~Ref:NM_017706.2~uORF:IOH4301	715	48	667
B11R08C07	11-7-8	Hs~MGC:BC011379.1~uORF:IOH9728	524	48	476
B11R08C08	11-8-8	Hs~MGC:BC011379.1~uORF:IOH9728	486	50	436
B11R08C09	11-9-8	Hs~Ref:NM_145245.1~uORF:IOH12245	632	59	573
B11R08C10	11-10-8	Hs~Ref:NM_145245.1~uORF:IOH12245	619	57	562
B11R08C11	11-11-8	Hs~Ref:NM_004589.1~uORF:IOH10823	450	48	402
B11R08C12	11-12-8	Hs~Ref:NM_004589.1~uORF:IOH10823	461	47	414
B11R08C13	11-13-8	Hs~Ref:NM_139012.1~uORF:IOH4647	235	50	185
B11R08C14	11-14-8	Hs~Ref:NM_139012.1~uORF:IOH4647	238	79	159
B11R08C15	11-15-8	Hs~MGC:BC030519.1~uORF:IOH27533	426	43	383
B11R08C16	11-16-8	Hs~MGC:BC030519.1~uORF:IOH27533	424	42	382
B11R08C17	11-17-8	Hs~MGC:BC029120.1~uORF:IOH22695	206	45	161
B11R08C18	11-18-8	Hs~MGC:BC029120.1~uORF:IOH22695	105	69	36
B11R08C19	11-19-8	Hs~MGC:BC042607.1~uORF:IOH27367	605	56	549
B11R08C20	11-20-8	Hs~MGC:BC042607.1~uORF:IOH27367	340	49	291
B11R08C21	11-21-8	Hs~MGC:BC031828.1~uORF:IOH22203	690	305	385
B11R08C22	11-22-8	Hs~MGC:BC031828.1~uORF:IOH22203	644	54	590
B11R09C01	11-1-9	Hs~Ref:NM_170678.1~uORF:IOH35216	711	465	246
B11R09C02	11-2-9	Hs~Ref:NM_170678.1~uORF:IOH35216	551	43	508
B11R09C03	11-3-9	Hs~Ref:NM_012131.1~uORF:IOH35308	661	40	621
B11R09C04	11-4-9	Hs~Ref:NM_012131.1~uORF:IOH35308	639	72	567
B11R09C05	11-5-9	Hs~Ref:NM_194299.1~uORF:IOH35431	544	48	496
B11R09C06	11-6-9	Hs~Ref:NM_194299.1~uORF:IOH35431	509	53	456
B11R09C07	11-7-9	Hs~Ref:NM_000605.2~uORF:IOH35221	234	104	130
B11R09C08	11-8-9	Hs~Ref:NM_000605.2~uORF:IOH35221	300	85	215
B11R09C09	11-9-9	Hs~Ref:NM_145235.1~uORF:IOH10778	187	139	48
B11R09C10	11-10-9	Hs~Ref:NM_145235.1~uORF:IOH10778	193	57	136
B11R09C11	11-11-9	Hs~MGC:BC022003.1~uORF:IOH11205	335	55	280
B11R09C12	11-12-9	Hs~MGC:BC022003.1~uORF:IOH11205	357	170	187
B11R09C13	11-13-9	Hs~MGC:NM_152391.2~uORF:IOH11899	287	48	239
B11R09C14	11-14-9	Hs~MGC:NM_152391.2~uORF:IOH11899	264	46	218
B11R09C15	11-15-9	Hs~MGC:BC026104.2~uORF:IOH11605	1674	42	1632
B11R09C16	11-16-9	Hs~MGC:BC026104.2~uORF:IOH11605	1660	43	1617
B11R09C17	11-17-9	Hs~Ref:NM_016505.2~uORF:IOH6093	569	48	521
B11R09C18	11-18-9	Hs~Ref:NM_016505.2~uORF:IOH6093	755	49	706
B11R09C19	11-19-9	Hs~MGC:BC000052.1~uORF:IOH4650	418	52	366
B11R09C20	11-20-9	Hs~MGC:BC000052.1~uORF:IOH4650	881	272	609
B11R09C21	11-21-9	Hs~MGC:NM_182553.1~uORF:IOH26395	218	55	163
B11R09C22	11-22-9	Hs~MGC:NM_182553.1~uORF:IOH26395	153	55	98
B11R10C01	11-1-10	Hs~MGC:NM_181707.1~uORF:IOH26565	510	41	469
B11R10C02	11-2-10	Hs~MGC:NM_181707.1~uORF:IOH26565	583	40	543
B11R10C03	11-3-10	Hs~MGC:BC016340.1~uORF:IOH12308	305	44	261
B11R10C04	11-4-10	Hs~MGC:BC016340.1~uORF:IOH12308	854	57	797
B11R10C05	11-5-10	Hs~MGC:BC018349.1~uORF:IOH9679	823	43	780
B11R10C06	11-6-10	Hs~MGC:BC018349.1~uORF:IOH9679	718	45	673
B11R10C07	11-7-10	Hs~Ref:NM_001311.2~uORF:IOH5361	497	109	388
B11R10C08	11-8-10	Hs~Ref:NM_001311.2~uORF:IOH5361	541	55	486
B11R10C09	11-9-10	Hs~MGC:BC014057.1~uORF:IOH14544	563	47	516
B11R10C10	11-10-10	Hs~MGC:BC014057.1~uORF:IOH14544	643	46	597
B11R10C11	11-11-10	GST1	42	40	2
B11R10C12	11-12-10	GST1	44	41	3
B11R10C13	11-13-10	GST2	49	39	10
B11R10C14	11-14-10	GST2	60	43	17
B11R10C15	11-15-10	GST3	53	41	12
B11R10C16	11-16-10	GST3	61	41	20
B11R10C17	11-17-10	GST4	81	40	41
B11R10C18	11-18-10	GST4	90	42	48
B11R10C19	11-19-10	Anti-HumanIgA1~N/A	10576	45	10531
B11R10C20	11-20-10	Anti-HumanIgA1~N/A	9673	46	9627
B11R10C21	11-21-10	Anti-HumanIgA2~N/A	18342	47	18295
B11R10C22	11-22-10	Anti-HumanIgA2~N/A	19028	49	18979
B11R11C01	11-1-11	AlexaAntiMouseAb~N/A	27414	38	27376
B11R11C02	11-2-11	AlexaAntiMouseAb~N/A	24480	39	24441
B11R11C03	11-3-11	MAPKAP~N/A	72	42	30
B11R11C04	11-4-11	MAPKAP~N/A	137	68	69
B11R11C05	11-5-11	Buffer	283	41	242
B11R11C06	11-6-11	Buffer	287	40	247
B11R11C07	11-7-11	BSA~N/A	10800	41	10759
B11R11C08	11-8-11	BSA~N/A	10983	42	10941
B11R11C09	11-9-11	Anti-HumanIgG1~N/A	1831	41	1790
B11R11C10	11-10-11	Anti-HumanIgG1~N/A	1762	41	1721
B11R11C11	11-11-11	Anti-HumanIgG2~N/A	3486	40	3446
B11R11C12	11-12-11	Anti-HumanIgG2~N/A	3495	41	3454
B11R11C13	11-13-11	Anti-HumanIgG3~N/A	6331	41	6290
B11R11C14	11-14-11	Anti-HumanIgG3~N/A	6120	40	6080
B11R11C15	11-15-11	Anti-HumanIgG4~N/A	12303	42	12261
B11R11C16	11-16-11	Anti-HumanIgG4~N/A	12388	42	12346
B11R11C17	11-17-11	AntiBiotinAb~N/A	13995	41	13954
B11R11C18	11-18-11	AntiBiotinAb~N/A	14081	42	14039
B11R11C19	11-19-11	Buffer	56	44	12
B11R11C20	11-20-11	Buffer	56	42	14
B11R11C21	11-21-11	Hs~MGC:BC001553.1~uORF:IOH10899	599	45	554
B11R11C22	11-22-11	Hs~MGC:BC001553.1~uORF:IOH10899	345	66	279
B11R12C01	11-1-12	Hs~Ref:NM_014050.1~uORF:IOH25727	357	40	317
B11R12C02	11-2-12	Hs~Ref:NM_014050.1~uORF:IOH25727	348	41	307
B11R12C03	11-3-12	Hs~Ref:NM_024092.1~uORF:IOH3088	282	44	238
B11R12C04	11-4-12	Hs~Ref:NM_024092.1~uORF:IOH3088	540	44	496
B11R12C05	11-5-12	Hs~MGC:BC020651.1~uORF:IOH12789	608	45	563
B11R12C06	11-6-12	Hs~MGC:BC020651.1~uORF:IOH12789	604	46	558
B11R12C07	11-7-12	Hs~MGC:BC017887.1~uORF:IOH27931	400	43	357
B11R12C08	11-8-12	Hs~MGC:BC017887.1~uORF:IOH27931	512	43	469
B11R12C09	11-9-12	Hs~MGC:BC060512.1~uORF:IOH29424	522	44	478
B11R12C10	11-10-12	Hs~MGC:BC060512.1~uORF:IOH29424	533	43	490
B11R12C11	11-11-12	Hs~MGC:BC021973.2~uORF:IOH27816	532	45	487
B11R12C12	11-12-12	Hs~MGC:BC021973.2~uORF:IOH27816	467	44	423
B11R12C13	11-13-12	Hs~MGC:BC060830.1~uORF:IOH29146	837	43	794
B11R12C14	11-14-12	Hs~MGC:BC060830.1~uORF:IOH29146	678	42	636
B11R12C15	11-15-12	Hs~Ref:NM_024292.2~uORF:IOH7374	587	43	544
B11R12C16	11-16-12	Hs~Ref:NM_024292.2~uORF:IOH7374	595	45	550
B11R12C17	11-17-12	Hs~MGC:BC009699.2~uORF:IOH9878	154	55	99
B11R12C18	11-18-12	Hs~MGC:BC009699.2~uORF:IOH9878	168	43	125
B11R12C19	11-19-12	Hs~MGC:BC005382.1~uORF:IOH7371	141	42	99
B11R12C20	11-20-12	Hs~MGC:BC005382.1~uORF:IOH7371	148	43	105
B11R12C21	11-21-12	Hs~Ref:NM_001258.1~uORF:IOH29645	218	44	174
B11R12C22	11-22-12	Hs~Ref:NM_001258.1~uORF:IOH29645	96	49	47
B11R13C01	11-1-13	Hs~MGC:BC007565.1~uORF:IOH6820	1103	40	1063
B11R13C02	11-2-13	Hs~MGC:BC007565.1~uORF:IOH6820	1079	42	1037
B11R13C03	11-3-13	Hs~MGC:BC040902.1~uORF:IOH26326	107	44	63
B11R13C04	11-4-13	Hs~MGC:BC040902.1~uORF:IOH26326	287	47	240
B11R13C05	11-5-13	Hs~MGC:BC007346.2~uORF:IOH7023	1398	47	1351
B11R13C06	11-6-13	Hs~MGC:BC007346.2~uORF:IOH7023	1381	47	1334
B11R13C07	11-7-13	Hs~Ref:NM_018127.4~uORF:IOH3722	412	43	369
B11R13C08	11-8-13	Hs~Ref:NM_018127.4~uORF:IOH3722	376	45	331
B11R13C09	11-9-13	Hs~Ref:NM_019101.2~uORF:IOH12125	655	45	610
B11R13C10	11-10-13	Hs~Ref:NM_019101.2~uORF:IOH12125	653	43	610
B11R13C11	11-11-13	Hs~MGC:BC030229.1~uORF:IOH22611	235	47	188
B11R13C12	11-12-13	Hs~MGC:BC030229.1~uORF:IOH22611	263	129	134
B11R13C13	11-13-13	Hs~Ref:NM_020529.1~uORF:IOH4138	270	45	225
B11R13C14	11-14-13	Hs~Ref:NM_020529.1~uORF:IOH4138	285	46	239
B11R13C15	11-15-13	Hs~Ref:NM_030588.1~uORF:IOH1868	267	72	195
B11R13C16	11-16-13	Hs~Ref:NM_030588.1~uORF:IOH1868	296	71	225
B11R13C17	11-17-13	Hs~Ref:NM_002945.2~uORF:IOH11757	511	53	458
B11R13C18	11-18-13	Hs~Ref:NM_002945.2~uORF:IOH11757	444	48	396
B11R13C19	11-19-13	Hs~MGC:BC017844.1~uORF:IOH14384	378	48	330
B11R13C20	11-20-13	Hs~MGC:BC017844.1~uORF:IOH14384	300	47	253
B11R13C21	11-21-13	Hs~Ref:NM_001179.2~uORF:IOH14107	307	53	254
B11R13C22	11-22-13	Hs~Ref:NM_001179.2~uORF:IOH14107	426	51	375
B11R14C01	11-1-14	Hs~MGC:NM_153215.1~uORF:IOH11594	436	39	397
B11R14C02	11-2-14	Hs~MGC:NM_153215.1~uORF:IOH11594	415	42	373
B11R14C03	11-3-14	Hs~Ref:NM_138459.2~uORF:IOH12773	398	46	352
B11R14C04	11-4-14	Hs~Ref:NM_138459.2~uORF:IOH12773	424	46	378
B11R14C05	11-5-14	Hs~Ref:NM_032831.1~uORF:IOH40779	409	51	358
B11R14C06	11-6-14	Hs~Ref:NM_032831.1~uORF:IOH40779	420	53	367
B11R14C07	11-7-14	Hs~MGC:BC007840.2~uORF:IOH6710	334	80	254
B11R14C08	11-8-14	Hs~MGC:BC007840.2~uORF:IOH6710	346	64	282
B11R14C09	11-9-14	Hs~Ref:NM_014773.2~uORF:IOH6737	149	43	106
B11R14C10	11-10-14	Hs~Ref:NM_014773.2~uORF:IOH6737	324	42	282
B11R14C11	11-11-14	Hs~Ref:NM_019083.1~uORF:IOH42080	292	41	251
B11R14C12	11-12-14	Hs~Ref:NM_019083.1~uORF:IOH42080	301	44	257
B11R14C13	11-13-14	Hs~Ref:NM_178226.1~uORF:IOH42134	305	44	261
B11R14C14	11-14-14	Hs~Ref:NM_178226.1~uORF:IOH42134	338	43	295
B11R14C15	11-15-14	Hs~Ref:NM_016205.1~uORF:IOH42087	294	46	248
B11R14C16	11-16-14	Hs~Ref:NM_016205.1~uORF:IOH42087	253	43	210
B11R14C17	11-17-14	Hs~Ref:NM_032981.2~uORF:IOH42089	388	60	328
B11R14C18	11-18-14	Hs~Ref:NM_032981.2~uORF:IOH42089	234	47	187
B11R14C19	11-19-14	Hs~MGC:BC047450.1~uORF:IOH26520	357	51	306
B11R14C20	11-20-14	Hs~MGC:BC047450.1~uORF:IOH26520	267	53	214
B11R14C21	11-21-14	Hs~Ref:NM_007311.2~uORF:IOH36669	578	46	532
B11R14C22	11-22-14	Hs~Ref:NM_007311.2~uORF:IOH36669	562	43	519
B11R15C01	11-1-15	Hs~Ref:NM_001086.1~uORF:IOH2181	229	38	191
B11R15C02	11-2-15	Hs~Ref:NM_001086.1~uORF:IOH2181	77	44	33
B11R15C03	11-3-15	Hs~Ref:NM_174939.2~uORF:IOH21601	271	47	224
B11R15C04	11-4-15	Hs~Ref:NM_174939.2~uORF:IOH21601	323	44	279
B11R15C05	11-5-15	Hs~Ref:NM_001008756.1~uORF:IOH45529	408	46	362
B11R15C06	11-6-15	Hs~Ref:NM_001008756.1~uORF:IOH45529	331	44	287
B11R15C07	11-7-15	Hs~Ref:NM_001004285.1~uORF:IOH45460	369	47	322
B11R15C08	11-8-15	Hs~Ref:NM_001004285.1~uORF:IOH45460	341	50	291
B11R15C09	11-9-15	Hs~Ref:NM_130465.3~uORF:IOH45925	429	42	387
B11R15C10	11-10-15	Hs~Ref:NM_130465.3~uORF:IOH45925	372	41	331
B11R15C11	11-11-15	Hs~Ref:NM_006585.2~uORF:IOH45947	424	43	381
B11R15C12	11-12-15	Hs~Ref:NM_006585.2~uORF:IOH45947	436	43	393
B11R15C13	11-13-15	Hs~Ref:NM_002577.3~CAT:PV4565	215	43	172
B11R15C14	11-14-15	Hs~Ref:NM_002577.3~CAT:PV4565	208	43	165
B11R15C15	11-15-15	Hs~Ref:NM_004714.1~CAT:PV4649	1600	42	1558
B11R15C16	11-16-15	Hs~Ref:NM_004714.1~CAT:PV4649	1586	42	1544
B11R15C17	11-17-15	Hs~Ref:NM_032028.2~CAT:PV3505	516	44	472
B11R15C18	11-18-15	Hs~Ref:NM_032028.2~CAT:PV3505	428	43	385
B11R15C19	11-19-15	Hs~Ref:NM_004586.1~CAT:PV3323	145	43	102
B11R15C20	11-20-15	Hs~Ref:NM_004586.1~CAT:PV3323	113	43	70
B11R15C21	11-21-15	Hs~Ref:NM_002253.1~CAT:PV3660	239	184	55
B11R15C22	11-22-15	Hs~Ref:NM_002253.1~CAT:PV3660	263	184	79
B11R16C01	11-1-16	Hs~Ref:NM_004103.2~CAT:PV4567	608	37	571
B11R16C02	11-2-16	Hs~Ref:NM_004103.2~CAT:PV4567	551	38	513
B11R16C03	11-3-16	Hs~Ref:NM_002649.2~CAT:PV4786	373	45	328
B11R16C04	11-4-16	Hs~Ref:NM_002649.2~CAT:PV4786	400	50	350
B11R16C05	11-5-16	Hs~Ref:NM_003954.1~CAT:PV4902	718	41	677
B11R16C06	11-6-16	Hs~Ref:NM_003954.1~CAT:PV4902	618	40	578
B11R16C07	11-7-16	Hs~Ref:NM_016200.2~uORF:IOH5331	192	41	151
B11R16C08	11-8-16	Hs~Ref:NM_016200.2~uORF:IOH5331	140	43	97
B11R16C09	11-9-16	Hs~Ref:NM_019023.1~uORF:IOH2924	174	41	133
B11R16C10	11-10-16	Hs~Ref:NM_019023.1~uORF:IOH2924	197	40	157
B11R16C11	11-11-16	Hs~MGC:BC020523.1~uORF:IOH21466	48	47	1
B11R16C12	11-12-16	Hs~MGC:BC020523.1~uORF:IOH21466	46	40	6
B11R16C13	11-13-16	Hs~Ref:NM_021138.2~uORF:IOH21846	299	42	257
B11R16C14	11-14-16	Hs~Ref:NM_021138.2~uORF:IOH21846	307	45	262
B11R16C15	11-15-16	Hs~Ref:NM_145214.2~uORF:IOH40773	611	45	566
B11R16C16	11-16-16	Hs~Ref:NM_145214.2~uORF:IOH40773	704	46	658
B11R16C17	11-17-16	Hs~Ref:NM_005476.3~uORF:IOH36644	648	49	599
B11R16C18	11-18-16	Hs~Ref:NM_005476.3~uORF:IOH36644	666	49	617
B11R16C19	11-19-16	Hs~Ref:NM_198461.1~uORF:IOH37860	753	351	402
B11R16C20	11-20-16	Hs~Ref:NM_198461.1~uORF:IOH37860	692	44	648
B11R16C21	11-21-16	Hs~Ref:NM_152793.1~uORF:IOH50202	612	43	569
B11R16C22	11-22-16	Hs~Ref:NM_152793.1~uORF:IOH50202	560	41	519
B11R17C01	11-1-17	Hs~Ref:NM_007373.2~uORF:IOH26711	430	38	392
B11R17C02	11-2-17	Hs~Ref:NM_007373.2~uORF:IOH26711	381	42	339
B11R17C03	11-3-17	Hs~MGC:BC050603.1~uORF:IOH27069	565	44	521
B11R17C04	11-4-17	Hs~MGC:BC050603.1~uORF:IOH27069	595	44	551
B11R17C05	11-5-17	Hs~Ref:NM_002591.2~uORF:IOH12383	456	45	411
B11R17C06	11-6-17	Hs~Ref:NM_002591.2~uORF:IOH12383	358	44	314
B11R17C07	11-7-17	Hs~Ref:NM_001860.1~uORF:IOH12315	496	41	455
B11R17C08	11-8-17	Hs~Ref:NM_001860.1~uORF:IOH12315	444	40	404
B11R17C09	11-9-17	Hs~Ref:NM_012341.2~uORF:IOH26105	767	40	727
B11R17C10	11-10-17	Hs~Ref:NM_012341.2~uORF:IOH26105	764	41	723
B11R17C11	11-11-17	Hs~Ref:NM_173610.1~uORF:IOH35028	711	41	670
B11R17C12	11-12-17	Hs~Ref:NM_173610.1~uORF:IOH35028	736	42	694
B11R17C13	11-13-17	Hs~Ref:NM_003784.1~uORF:IOH35656	465	41	424
B11R17C14	11-14-17	Hs~Ref:NM_003784.1~uORF:IOH35656	544	42	502
B11R17C15	11-15-17	Hs~Ref:NM_000891.2~uORF:IOH35746	755	44	711
B11R17C16	11-16-17	Hs~Ref:NM_000891.2~uORF:IOH35746	742	45	697
B11R17C17	11-17-17	Hs~MGC:BC019902.1~uORF:IOH11985	473	51	422
B11R17C18	11-18-17	Hs~MGC:BC019902.1~uORF:IOH11985	395	124	271
B11R17C19	11-19-17	Hs~Ref:NM_032124.3~uORF:IOH27146	722	80	642
B11R17C20	11-20-17	Hs~Ref:NM_032124.3~uORF:IOH27146	719	45	674
B11R17C21	11-21-17	Hs~MGC:BC026274.1~uORF:IOH27920	537	41	496
B11R17C22	11-22-17	Hs~MGC:BC026274.1~uORF:IOH27920	577	39	538
B11R18C01	11-1-18	Hs~Ref:XM_290936.2~uORF:IOH27440	618	40	578
B11R18C02	11-2-18	Hs~Ref:XM_290936.2~uORF:IOH27440	51	47	4
B11R18C03	11-3-18	Hs~Ref:NM_147197.2~uORF:IOH40750	358	44	314
B11R18C04	11-4-18	Hs~Ref:NM_147197.2~uORF:IOH40750	363	45	318
B11R18C05	11-5-18	Hs~MGC:BC067219.1~uORF:IOH40730	547	48	499
B11R18C06	11-6-18	Hs~MGC:BC067219.1~uORF:IOH40730	468	45	423
B11R18C07	11-7-18	Hs~Ref:NM_015963.4~uORF:IOH40797	489	42	447
B11R18C08	11-8-18	Hs~Ref:NM_015963.4~uORF:IOH40797	468	41	427
B11R18C09	11-9-18	Hs~MGC:BC065717.1~uORF:IOH40735	234	41	193
B11R18C10	11-10-18	Hs~MGC:BC065717.1~uORF:IOH40735	283	42	241
B11R18C11	11-11-18	Hs~MGC:BC008406.1~uORF:IOH14434	412	45	367
B11R18C12	11-12-18	Hs~MGC:BC008406.1~uORF:IOH14434	381	47	334
B11R18C13	11-13-18	Hs~MGC:BC032330.1~uORF:IOH21654	439	42	397
B11R18C14	11-14-18	Hs~MGC:BC032330.1~uORF:IOH21654	444	41	403
B11R18C15	11-15-18	Hs~MGC:BC035281.1~uORF:IOH27313	315	44	271
B11R18C16	11-16-18	Hs~MGC:BC035281.1~uORF:IOH27313	356	63	293
B11R18C17	11-17-18	Hs~MGC:BC017716.1~uORF:IOH11983	289	47	242
B11R18C18	11-18-18	Hs~MGC:BC017716.1~uORF:IOH11983	269	45	224
B11R18C19	11-19-18	Hs~MGC:BC060780.1~uORF:IOH29159	381	47	334
B11R18C20	11-20-18	Hs~MGC:BC060780.1~uORF:IOH29159	488	44	444
B11R18C21	11-21-18	Hs~MGC:BC007412.1~uORF:IOH5835	370	42	328
B11R18C22	11-22-18	Hs~MGC:BC007412.1~uORF:IOH5835	370	41	329
B11R19C01	11-1-19	Hs~Ref:NM_004553.1~uORF:IOH26967	327	42	285
B11R19C02	11-2-19	Hs~Ref:NM_004553.1~uORF:IOH26967	315	46	269
B11R19C03	11-3-19	Hs~MGC:BC002707.1~uORF:IOH5356	320	43	277
B11R19C04	11-4-19	Hs~MGC:BC002707.1~uORF:IOH5356	431	50	381
B11R19C05	11-5-19	Hs~MGC:BC008392.1~uORF:IOH7460	191	43	148
B11R19C06	11-6-19	Hs~MGC:BC008392.1~uORF:IOH7460	224	46	178
B11R19C07	11-7-19	Hs~MGC:BC005895.1~uORF:IOH7427	230	43	187
B11R19C08	11-8-19	Hs~MGC:BC005895.1~uORF:IOH7427	222	55	167
B11R19C09	11-9-19	Hs~MGC:BC013902.1~uORF:IOH12236	160	45	115
B11R19C10	11-10-19	Hs~MGC:BC013902.1~uORF:IOH12236	186	43	143
B11R19C11	11-11-19	Hs~Ref:NM_138408.1~uORF:IOH13484	229	45	184
B11R19C12	11-12-19	Hs~Ref:NM_138408.1~uORF:IOH13484	240	42	198
B11R19C13	11-13-19	Hs~Ref:NM_001545.1~uORF:IOH11951	731	41	690
B11R19C14	11-14-19	Hs~Ref:NM_001545.1~uORF:IOH11951	856	42	814
B11R19C15	11-15-19	Hs~Ref:NM_017665.1~uORF:IOH7282	949	44	905
B11R19C16	11-16-19	Hs~Ref:NM_017665.1~uORF:IOH7282	959	47	912
B11R19C17	11-17-19	Hs~Ref:NM_016071.2~uORF:IOH11088	261	169	92
B11R19C18	11-18-19	Hs~Ref:NM_016071.2~uORF:IOH11088	202	46	156
B11R19C19	11-19-19	Hs~Ref:NM_001177.2~uORF:IOH7362	240	49	191
B11R19C20	11-20-19	Hs~Ref:NM_001177.2~uORF:IOH7362	337	47	290
B11R19C21	11-21-19	Hs~Ref:NM_005019.3~uORF:IOH11117	1237	44	1193
B11R19C22	11-22-19	Hs~Ref:NM_005019.3~uORF:IOH11117	1196	42	1154
B11R20C01	11-1-20	Hs~MGC:NM_175840.1~uORF:IOH4308	126	44	82
B11R20C02	11-2-20	Hs~MGC:NM_175840.1~uORF:IOH4308	185	43	142
B11R20C03	11-3-20	Hs~Ref:NM_016483.3~uORF:IOH22255	564	43	521
B11R20C04	11-4-20	Hs~Ref:NM_016483.3~uORF:IOH22255	601	42	559
B11R20C05	11-5-20	Hs~MGC:BC029785.1~uORF:IOH22702	420	42	378
B11R20C06	11-6-20	Hs~MGC:BC029785.1~uORF:IOH22702	373	43	330
B11R20C07	11-7-20	Hs~MGC:BC024272.1~uORF:IOH12488	419	43	376
B11R20C08	11-8-20	Hs~MGC:BC024272.1~uORF:IOH12488	444	44	400
B11R20C09	11-9-20	Hs~Ref:NM_015696.2~uORF:IOH21874	170	45	125
B11R20C10	11-10-20	Hs~Ref:NM_015696.2~uORF:IOH21874	240	43	197
B11R20C11	11-11-20	Hs~Ref:NM_203302.2~uORF:IOH45642	482	42	440
B11R20C12	11-12-20	Hs~Ref:NM_203302.2~uORF:IOH45642	597	43	554
B11R20C13	11-13-20	Hs~Ref:NM_145333.1~uORF:IOH37873	606	43	563
B11R20C14	11-14-20	Hs~Ref:NM_145333.1~uORF:IOH37873	644	43	601
B11R20C15	11-15-20	Hs~Ref:NM_023943.1~uORF:IOH4185	303	89	214
B11R20C16	11-16-20	Hs~Ref:NM_023943.1~uORF:IOH4185	349	52	297
B11R20C17	11-17-20	Hs~Ref:NM_031478.3~uORF:IOH6714	205	45	160
B11R20C18	11-18-20	Hs~Ref:NM_031478.3~uORF:IOH6714	149	45	104
B11R20C19	11-19-20	Hs~Ref:NM_198257.1~uORF:IOH50064	537	44	493
B11R20C20	11-20-20	Hs~Ref:NM_198257.1~uORF:IOH50064	505	41	464
B11R20C21	11-21-20	Hs~Ref:NM_001009614.1~uORF:IOH50116	801	40	761
B11R20C22	11-22-20	Hs~Ref:NM_001009614.1~uORF:IOH50116	850	39	811
B11R21C01	11-1-21	Hs~Ref:NM_152658.1~uORF:IOH43611	103	40	63
B11R21C02	11-2-21	Hs~Ref:NM_152658.1~uORF:IOH43611	194	70	124
B11R21C03	11-3-21	Hs~Ref:NM_144947.1~uORF:IOH43587	179	43	136
B11R21C04	11-4-21	Hs~Ref:NM_144947.1~uORF:IOH43587	189	40	149
B11R21C05	11-5-21	Hs~Ref:NM_178190.1~uORF:IOH41667	121	43	78
B11R21C06	11-6-21	Hs~Ref:NM_178190.1~uORF:IOH41667	200	50	150
B11R21C07	11-7-21	Hs~Ref:XM_380135.2~uORF:IOH42441	613	43	570
B11R21C08	11-8-21	Hs~Ref:XM_380135.2~uORF:IOH42441	571	42	529
B11R21C09	11-9-21	Hs~Ref:AAF19370.1~CAT_10301-H09E-25	41	41	0
B11R21C10	11-10-21	Hs~Ref:AAF19370.1~CAT_10301-H09E-25	37	39	-2
B11R21C11	11-11-21	Internal_1007209	40	38	2
B11R21C12	11-12-21	Internal_1007209	41	40	1
B11R21C13	11-13-21	Hs~Ref:NP_003801.1~CAT_10409-HNAE-25	42	39	3
B11R21C14	11-14-21	Hs~Ref:NP_003801.1~CAT_10409-HNAE-25	44	38	6
B11R21C15	11-15-21	Internal_1007209	53	39	14
B11R21C16	11-16-21	Internal_1007209	69	50	19
B11R21C17	11-17-21	Hs~Ref:NP_005371.1~CAT_10169-H08H-25	44	39	5
B11R21C18	11-18-21	Hs~Ref:NP_005371.1~CAT_10169-H08H-25	40	39	1
B11R21C19	11-19-21	Internal_1007209	40	38	2
B11R21C20	11-20-21	Internal_1007209	39	37	2
B11R21C21	11-21-21	Internal_1007209	46	37	9
B11R21C22	11-22-21	Internal_1007209	44	38	6
B11R22C01	11-1-22	ERa~N/A	1672	38	1634
B11R22C02	11-2-22	ERa~N/A	2098	38	2060
B11R22C03	11-3-22	PKCeta~N/A	265	42	223
B11R22C04	11-4-22	PKCeta~N/A	304	45	259
B11R22C05	11-5-22	Calmodulin~N/A	69	44	25
B11R22C06	11-6-22	Calmodulin~N/A	60	44	16
B11R22C07	11-7-22	V5control5~N/A	381	41	340
B11R22C08	11-8-22	V5control5~N/A	371	42	329
B11R22C09	11-9-22	V5control4~N/A	147	40	107
B11R22C10	11-10-22	V5control4~N/A	117	42	75
B11R22C11	11-11-22	V5control3~N/A	37	45	-8
B11R22C12	11-12-22	V5control3~N/A	89	72	17
B11R22C13	11-13-22	V5control2~N/A	60	40	20
B11R22C14	11-14-22	V5control2~N/A	68	43	25
B11R22C15	11-15-22	V5control1~N/A	57	39	18
B11R22C16	11-16-22	V5control1~N/A	57	39	18
B11R22C17	11-17-22	CMK2A~N/A	519	41	478
B11R22C18	11-18-22	CMK2A~N/A	613	41	572
B11R22C19	11-19-22	ERa~N/A	1948	38	1910
B11R22C20	11-20-22	ERa~N/A	1885	38	1847
B11R22C21	11-21-22	AlexaAntiMouseAb~N/A	9321	39	9282
B11R22C22	11-22-22	AlexaAntiMouseAb~N/A	10225	39	10186
B12R01C01	12-1-1	AlexaAntiMouseAb~N/A	39962	40	39922
B12R01C02	12-2-1	AlexaAntiMouseAb~N/A	37514	42	37472
B12R01C03	12-3-1	ERa~N/A	2700	43	2657
B12R01C04	12-4-1	ERa~N/A	2181	42	2139
B12R01C05	12-5-1	HumanIgG1~N/A	689	42	647
B12R01C06	12-6-1	HumanIgG1~N/A	749	43	706
B12R01C07	12-7-1	HumanIgG2~N/A	2697	42	2655
B12R01C08	12-8-1	HumanIgG2~N/A	2762	42	2720
B12R01C09	12-9-1	HumanIgG3~N/A	12620	44	12576
B12R01C10	12-10-1	HumanIgG3~N/A	13346	43	13303
B12R01C11	12-11-1	HumanIgG4~N/A	48220	45	48175
B12R01C12	12-12-1	HumanIgG4~N/A	52639	44	52595
B12R01C13	12-13-1	BiotinAb~N/A	84	46	38
B12R01C14	12-14-1	BiotinAb~N/A	72	45	27
B12R01C15	12-15-1	RanBP2deltaFG~N/A	249	40	209
B12R01C16	12-16-1	RanBP2deltaFG~N/A	294	41	253
B12R01C17	12-17-1	hMDM2~N/A	877	51	826
B12R01C18	12-18-1	hMDM2~N/A	345	228	117
B12R01C19	12-19-1	PKCeta~N/A	162	49	113
B12R01C20	12-20-1	PKCeta~N/A	243	42	201
B12R01C21	12-21-1	AlexaAntiMouseAb~N/A	31249	44	31205
B12R01C22	12-22-1	AlexaAntiMouseAb~N/A	30432	44	30388
B12R02C01	12-1-2	PKCeta~N/A	1125	41	1084
B12R02C02	12-2-2	PKCeta~N/A	1301	45	1256
B12R02C03	12-3-2	Buffer	239	103	136
B12R02C04	12-4-2	Buffer	200	96	104
B12R02C05	12-5-2	HumanIgA~N/A	7054	48	7006
B12R02C06	12-6-2	HumanIgA~N/A	19310	44	19266
B12R02C07	12-7-2	Buffer	50	44	6
B12R02C08	12-8-2	Buffer	64	43	21
B12R02C09	12-9-2	BSA~N/A	9542	45	9497
B12R02C10	12-10-2	BSA~N/A	10520	45	10475
B12R02C11	12-11-2	Hs~MGC:BC016905.1~uORF:IOH10994	579	52	527
B12R02C12	12-12-2	Hs~MGC:BC016905.1~uORF:IOH10994	565	47	518
B12R02C13	12-13-2	Hs~MGC:BC020569.1~uORF:IOH10736	485	72	413
B12R02C14	12-14-2	Hs~MGC:BC020569.1~uORF:IOH10736	63	45	18
B12R02C15	12-15-2	Hs~Ref:NM_019062.1~uORF:IOH23145	3492	40	3452
B12R02C16	12-16-2	Hs~Ref:NM_019062.1~uORF:IOH23145	3568	41	3527
B12R02C17	12-17-2	Hs~MGC:BC020233.1~uORF:IOH14752	35328	61	35267
B12R02C18	12-18-2	Hs~MGC:BC020233.1~uORF:IOH14752	36447	237	36210
B12R02C19	12-19-2	Hs~MGC:BC045641.1~uORF:IOH25886	392	51	341
B12R02C20	12-20-2	Hs~MGC:BC045641.1~uORF:IOH25886	505	44	461
B12R02C21	12-21-2	Hs~Ref:NM_024039.1~uORF:IOH4379	252	53	199
B12R02C22	12-22-2	Hs~Ref:NM_024039.1~uORF:IOH4379	239	58	181
B12R03C01	12-1-3	Hs~Ref:NM_015400.1~uORF:IOH3643	459	44	415
B12R03C02	12-2-3	Hs~Ref:NM_015400.1~uORF:IOH3643	510	63	447
B12R03C03	12-3-3	Hs~MGC:BC000507.1~uORF:IOH3546	443	59	384
B12R03C04	12-4-3	Hs~MGC:BC000507.1~uORF:IOH3546	524	396	128
B12R03C05	12-5-3	Hs~Ref:NM_018226.3~uORF:IOH44724	199	49	150
B12R03C06	12-6-3	Hs~Ref:NM_018226.3~uORF:IOH44724	276	56	220
B12R03C07	12-7-3	Hs~Ref:NM_001001935.1~uORF:IOH45901	269	43	226
B12R03C08	12-8-3	Hs~Ref:NM_001001935.1~uORF:IOH45901	226	46	180
B12R03C09	12-9-3	Hs~Ref:NM_007045.2~uORF:IOH44725	185	48	137
B12R03C10	12-10-3	Hs~Ref:NM_007045.2~uORF:IOH44725	246	47	199
B12R03C11	12-11-3	Hs~Ref:NM_198086.1~uORF:IOH45877	401	63	338
B12R03C12	12-12-3	Hs~Ref:NM_198086.1~uORF:IOH45877	285	51	234
B12R03C13	12-13-3	Hs~Ref:XM_374292.2~uORF:IOH44754	225	44	181
B12R03C14	12-14-3	Hs~Ref:XM_374292.2~uORF:IOH44754	217	42	175
B12R03C15	12-15-3	Hs~Ref:NM_172211.1~uORF:IOH43696	139	41	98
B12R03C16	12-16-3	Hs~Ref:NM_172211.1~uORF:IOH43696	133	42	91
B12R03C17	12-17-3	Hs~Ref:NM_198325.1~uORF:IOH43467	767	56	711
B12R03C18	12-18-3	Hs~Ref:NM_198325.1~uORF:IOH43467	764	66	698
B12R03C19	12-19-3	Hs~Ref:NM_014276.2~uORF:IOH43732	80	47	33
B12R03C20	12-20-3	Hs~Ref:NM_014276.2~uORF:IOH43732	130	41	89
B12R03C21	12-21-3	Hs~Ref:NM_006241.2~uORF:IOH5954	198	46	152
B12R03C22	12-22-3	Hs~Ref:NM_006241.2~uORF:IOH5954	192	52	140
B12R04C01	12-1-4	Hs~MGC:BC011842.2~uORF:IOH14099	873	42	831
B12R04C02	12-2-4	Hs~MGC:BC011842.2~uORF:IOH14099	992	49	943
B12R04C03	12-3-4	Hs~MGC:BC021241.2~uORF:IOH14238	381	50	331
B12R04C04	12-4-4	Hs~MGC:BC021241.2~uORF:IOH14238	395	65	330
B12R04C05	12-5-4	Hs~MGC:BC000903.2~uORF:IOH2920	703	49	654
B12R04C06	12-6-4	Hs~MGC:BC000903.2~uORF:IOH2920	605	46	559
B12R04C07	12-7-4	Hs~MGC:BC014891.1~uORF:IOH10029	251	47	204
B12R04C08	12-8-4	Hs~MGC:BC014891.1~uORF:IOH10029	300	54	246
B12R04C09	12-9-4	Hs~Ref:NM_004772.1~uORF:IOH14022	416	59	357
B12R04C10	12-10-4	Hs~Ref:NM_004772.1~uORF:IOH14022	362	74	288
B12R04C11	12-11-4	Hs~MGC:BC021275.1~uORF:IOH13914	252	69	183
B12R04C12	12-12-4	Hs~MGC:BC021275.1~uORF:IOH13914	171	71	100
B12R04C13	12-13-4	Hs~MGC:BC021560.1~uORF:IOH14110	66	68	-2
B12R04C14	12-14-4	Hs~MGC:BC021560.1~uORF:IOH14110	426	47	379
B12R04C15	12-15-4	Hs~MGC:BC020600.1~uORF:IOH12780	262	52	210
B12R04C16	12-16-4	Hs~MGC:BC020600.1~uORF:IOH12780	377	52	325
B12R04C17	12-17-4	Hs~MGC:BC033708.1~uORF:IOH21753	6173	78	6095
B12R04C18	12-18-4	Hs~MGC:BC033708.1~uORF:IOH21753	5703	89	5614
B12R04C19	12-19-4	Hs~Ref:NM_001517.1~uORF:IOH5457	89	61	28
B12R04C20	12-20-4	Hs~Ref:NM_001517.1~uORF:IOH5457	118	62	56
B12R04C21	12-21-4	Hs~Ref:NM_002431.1~uORF:IOH3100	1433	86	1347
B12R04C22	12-22-4	Hs~Ref:NM_002431.1~uORF:IOH3100	172	55	117
B12R05C01	12-1-5	Hs~Ref:NM_001010844.1~uORF:IOH43230	1390	41	1349
B12R05C02	12-2-5	Hs~Ref:NM_001010844.1~uORF:IOH43230	1428	44	1384
B12R05C03	12-3-5	Hs~MGC:NM_006223.2~uORF:IOH43393	69	42	27
B12R05C04	12-4-5	Hs~MGC:NM_006223.2~uORF:IOH43393	115	67	48
B12R05C05	12-5-5	Hs~Ref:NM_147148.1~uORF:IOH43362	254	49	205
B12R05C06	12-6-5	Hs~Ref:NM_147148.1~uORF:IOH43362	305	63	242
B12R05C07	12-7-5	Hs~Ref:NM_182536.2~uORF:IOH43315	256	83	173
B12R05C08	12-8-5	Hs~Ref:NM_182536.2~uORF:IOH43315	180	109	71
B12R05C09	12-9-5	Hs~MGC:BC067446.1~uORF:IOH40156	597	99	498
B12R05C10	12-10-5	Hs~MGC:BC067446.1~uORF:IOH40156	334	178	156
B12R05C11	12-11-5	Hs~Ref:NM_139280.1~uORF:IOH40176	721	78	643
B12R05C12	12-12-5	Hs~Ref:NM_139280.1~uORF:IOH40176	680	71	609
B12R05C13	12-13-5	Hs~MGC:BC069329.1~uORF:IOH40250	563	252	311
B12R05C14	12-14-5	Hs~MGC:BC069329.1~uORF:IOH40250	433	72	361
B12R05C15	12-15-5	Hs~MGC:BC066316.1~uORF:IOH40103	731	64	667
B12R05C16	12-16-5	Hs~MGC:BC066316.1~uORF:IOH40103	773	72	701
B12R05C17	12-17-5	Hs~Ref:NM_145251.2~uORF:IOH10157	320	68	252
B12R05C18	12-18-5	Hs~Ref:NM_145251.2~uORF:IOH10157	283	78	205
B12R05C19	12-19-5	Hs~MGC:BC064984.1~uORF:IOH40665	1660	62	1598
B12R05C20	12-20-5	Hs~MGC:BC064984.1~uORF:IOH40665	1607	64	1543
B12R05C21	12-21-5	Hs~MGC:BC062423.1~uORF:IOH40739	452	302	150
B12R05C22	12-22-5	Hs~MGC:BC062423.1~uORF:IOH40739	128	63	65
B12R06C01	12-1-6	Hs~MGC:BC064514.1~uORF:IOH40669	470	44	426
B12R06C02	12-2-6	Hs~MGC:BC064514.1~uORF:IOH40669	542	189	353
B12R06C03	12-3-6	Hs~Ref:NM_003226.2~uORF:IOH58738	358	50	308
B12R06C04	12-4-6	Hs~Ref:NM_003226.2~uORF:IOH58738	323	52	271
B12R06C05	12-5-6	Hs~Ref:NM_021068.1~uORF:IOH54736	184	46	138
B12R06C06	12-6-6	Hs~Ref:NM_021068.1~uORF:IOH54736	191	49	142
B12R06C07	12-7-6	Hs~Ref:NM_001017417.1~uORF:IOH54734	3148	84	3064
B12R06C08	12-8-6	Hs~Ref:NM_001017417.1~uORF:IOH54734	2842	108	2734
B12R06C09	12-9-6	Hs~Ref:NM_199129.1~uORF:IOH59436	95	143	-48
B12R06C10	12-10-6	Hs~Ref:NM_199129.1~uORF:IOH59436	141	76	65
B12R06C11	12-11-6	Hs~Ref:NM_032636.2~uORF:IOH4088	3432	63	3369
B12R06C12	12-12-6	Hs~Ref:NM_032636.2~uORF:IOH4088	3627	64	3563
B12R06C13	12-13-6	Hs~MGC:BC007320.2~uORF:IOH5857	402	65	337
B12R06C14	12-14-6	Hs~MGC:BC007320.2~uORF:IOH5857	397	60	337
B12R06C15	12-15-6	Hs~MGC:BC019107.1~uORF:IOH13408	945	50	895
B12R06C16	12-16-6	Hs~MGC:BC019107.1~uORF:IOH13408	84	55	29
B12R06C17	12-17-6	Hs~Ref:NM_016052.1~uORF:IOH13661	1068	64	1004
B12R06C18	12-18-6	Hs~Ref:NM_016052.1~uORF:IOH13661	1366	670	696
B12R06C19	12-19-6	Hs~MGC:BC095406.1~uORF:IOH62661	127	55	72
B12R06C20	12-20-6	Hs~MGC:BC095406.1~uORF:IOH62661	80	56	24
B12R06C21	12-21-6	Hs~MGC:BC094719.1~uORF:IOH62673	2312	113	2199
B12R06C22	12-22-6	Hs~MGC:BC094719.1~uORF:IOH62673	1984	135	1849
B12R07C01	12-1-7	Hs~Ref:NM_138805.1~uORF:IOH10408	177	46	131
B12R07C02	12-2-7	Hs~Ref:NM_138805.1~uORF:IOH10408	234	46	188
B12R07C03	12-3-7	Hs~MGC:BC008286.1~uORF:IOH6243	184	46	138
B12R07C04	12-4-7	Hs~MGC:BC008286.1~uORF:IOH6243	173	45	128
B12R07C05	12-5-7	Hs~Ref:NM_054022.2~uORF:IOH41241	263	159	104
B12R07C06	12-6-7	Hs~Ref:NM_054022.2~uORF:IOH41241	349	116	233
B12R07C07	12-7-7	Hs~Ref:NM_194453.1~uORF:IOH42461	255	45	210
B12R07C08	12-8-7	Hs~Ref:NM_194453.1~uORF:IOH42461	100	51	49
B12R07C09	12-9-7	Hs~Ref:NM_016815.2~uORF:IOH41541	220	49	171
B12R07C10	12-10-7	Hs~Ref:NM_016815.2~uORF:IOH41541	234	51	183
B12R07C11	12-11-7	Hs~Ref:NM_006621.3~uORF:IOH41131	1216	115	1101
B12R07C12	12-12-7	Hs~Ref:NM_006621.3~uORF:IOH41131	1077	79	998
B12R07C13	12-13-7	Hs~MGC:BC022983.1~uORF:IOH10747	50	62	-12
B12R07C14	12-14-7	Hs~MGC:BC022983.1~uORF:IOH10747	169	55	114
B12R07C15	12-15-7	Hs~Ref:NM_006453.2~uORF:IOH10246	234	49	185
B12R07C16	12-16-7	Hs~Ref:NM_006453.2~uORF:IOH10246	130	54	76
B12R07C17	12-17-7	Hs~MGC:BC020981.1~uORF:IOH10388	38	58	-20
B12R07C18	12-18-7	Hs~MGC:BC020981.1~uORF:IOH10388	178	65	113
B12R07C19	12-19-7	Hs~Ref:NM_018270.3~uORF:IOH14702	568	50	518
B12R07C20	12-20-7	Hs~Ref:NM_018270.3~uORF:IOH14702	657	54	603
B12R07C21	12-21-7	Hs~MGC:BC078670.1~uORF:IOH63078	30241	67	30174
B12R07C22	12-22-7	Hs~MGC:BC078670.1~uORF:IOH63078	30404	62	30342
B12R08C01	12-1-8	Hs~MGC:BC070361.1~uORF:IOH63029	37363	49	37314
B12R08C02	12-2-8	Hs~MGC:BC070361.1~uORF:IOH63029	38765	56	38709
B12R08C03	12-3-8	Hs~MGC:BC066935.1~uORF:IOH61468	200	46	154
B12R08C04	12-4-8	Hs~MGC:BC066935.1~uORF:IOH61468	382	156	226
B12R08C05	12-5-8	Hs~MGC:BC006078.1~uORF:IOH62953	474	45	429
B12R08C06	12-6-8	Hs~MGC:BC006078.1~uORF:IOH62953	614	48	566
B12R08C07	12-7-8	Hs~Ref:NM_006948.1~uORF:IOH22345	490	44	446
B12R08C08	12-8-8	Hs~Ref:NM_006948.1~uORF:IOH22345	490	48	442
B12R08C09	12-9-8	Hs~Ref:NM_015510.2~uORF:IOH5674	63	56	7
B12R08C10	12-10-8	Hs~Ref:NM_015510.2~uORF:IOH5674	416	49	367
B12R08C11	12-11-8	Hs~MGC:BC022237.1~uORF:IOH21440	276	210	66
B12R08C12	12-12-8	Hs~MGC:BC022237.1~uORF:IOH21440	129	169	-40
B12R08C13	12-13-8	Hs~MGC:BC018928.1~uORF:IOH12116	42	46	-4
B12R08C14	12-14-8	Hs~MGC:BC018928.1~uORF:IOH12116	41	43	-2
B12R08C15	12-15-8	Hs~MGC:BC022471.1~uORF:IOH11199	61	49	12
B12R08C16	12-16-8	Hs~MGC:BC022471.1~uORF:IOH11199	993	527	466
B12R08C17	12-17-8	Hs~Ref:NM_080739.1~uORF:IOH11067	599	62	537
B12R08C18	12-18-8	Hs~Ref:NM_080739.1~uORF:IOH11067	43	80	-37
B12R08C19	12-19-8	Hs~Ref:NM_052950.2~uORF:IOH13317	455	54	401
B12R08C20	12-20-8	Hs~Ref:NM_052950.2~uORF:IOH13317	412	63	349
B12R08C21	12-21-8	Hs~MGC:BC011906.1~uORF:IOH12531	1234	108	1126
B12R08C22	12-22-8	Hs~MGC:BC011906.1~uORF:IOH12531	1291	802	489
B12R09C01	12-1-9	Hs~Ref:NM_022776.3~uORF:IOH40437	1679	52	1627
B12R09C02	12-2-9	Hs~Ref:NM_022776.3~uORF:IOH40437	2106	60	2046
B12R09C03	12-3-9	Hs~Ref:NM_032875.1~uORF:IOH40622	185	42	143
B12R09C04	12-4-9	Hs~Ref:NM_032875.1~uORF:IOH40622	276	41	235
B12R09C05	12-5-9	Hs~MGC:BC068071.1~uORF:IOH40780	63	42	21
B12R09C06	12-6-9	Hs~MGC:BC068071.1~uORF:IOH40780	80	44	36
B12R09C07	12-7-9	Hs~MGC:BC070189.1~uORF:IOH40809	87	46	41
B12R09C08	12-8-9	Hs~MGC:BC070189.1~uORF:IOH40809	224	40	184
B12R09C09	12-9-9	Hs~Ref:NM_024749.1~uORF:IOH27040	185	41	144
B12R09C10	12-10-9	Hs~Ref:NM_024749.1~uORF:IOH27040	197	93	104
B12R09C11	12-11-9	Hs~MGC:NM_178540.2~uORF:IOH26200	211	43	168
B12R09C12	12-12-9	Hs~MGC:NM_178540.2~uORF:IOH26200	211	43	168
B12R09C13	12-13-9	Hs~Ref:NM_016135.1~uORF:IOH26043	235	40	195
B12R09C14	12-14-9	Hs~Ref:NM_016135.1~uORF:IOH26043	115	41	74
B12R09C15	12-15-9	Hs~MGC:NM_182494.1~uORF:IOH26292	70	44	26
B12R09C16	12-16-9	Hs~MGC:NM_182494.1~uORF:IOH26292	51	44	7
B12R09C17	12-17-9	Hs~MGC:BC009506.1~uORF:IOH12068	1839	46	1793
B12R09C18	12-18-9	Hs~MGC:BC009506.1~uORF:IOH12068	1958	45	1913
B12R09C19	12-19-9	Hs~MGC:BC012109.1~uORF:IOH12380	3798	50	3748
B12R09C20	12-20-9	Hs~MGC:BC012109.1~uORF:IOH12380	3888	53	3835
B12R09C21	12-21-9	Hs~Ref:NM_022780.2~uORF:IOH13276	731	51	680
B12R09C22	12-22-9	Hs~Ref:NM_022780.2~uORF:IOH13276	712	45	667
B12R10C01	12-1-10	Hs~Ref:NM_020384.1~uORF:IOH12584	787	119	668
B12R10C02	12-2-10	Hs~Ref:NM_020384.1~uORF:IOH12584	642	43	599
B12R10C03	12-3-10	Hs~MGC:BC057243.1~uORF:IOH29436	389	40	349
B12R10C04	12-4-10	Hs~MGC:BC057243.1~uORF:IOH29436	334	41	293
B12R10C05	12-5-10	Hs~MGC:BC054034.1~uORF:IOH29051	1916	40	1876
B12R10C06	12-6-10	Hs~MGC:BC054034.1~uORF:IOH29051	1862	40	1822
B12R10C07	12-7-10	Hs~MGC:BC053560.1~uORF:IOH29024	888	41	847
B12R10C08	12-8-10	Hs~MGC:BC053560.1~uORF:IOH29024	889	39	850
B12R10C09	12-9-10	Hs~MGC:BC013928.1~uORF:IOH27869	421	40	381
B12R10C10	12-10-10	Hs~MGC:BC013928.1~uORF:IOH27869	547	56	491
B12R10C11	12-11-10	GST1	43	41	2
B12R10C12	12-12-10	GST1	41	39	2
B12R10C13	12-13-10	GST2	44	39	5
B12R10C14	12-14-10	GST2	45	41	4
B12R10C15	12-15-10	GST3	37	42	-5
B12R10C16	12-16-10	GST3	49	41	8
B12R10C17	12-17-10	GST4	79	40	39
B12R10C18	12-18-10	GST4	62	39	23
B12R10C19	12-19-10	Anti-HumanIgA1~N/A	6962	41	6921
B12R10C20	12-20-10	Anti-HumanIgA1~N/A	6481	41	6440
B12R10C21	12-21-10	Anti-HumanIgA2~N/A	12644	43	12601
B12R10C22	12-22-10	Anti-HumanIgA2~N/A	12790	42	12748
B12R11C01	12-1-11	AlexaAntiMouseAb~N/A	25146	45	25101
B12R11C02	12-2-11	AlexaAntiMouseAb~N/A	27435	40	27395
B12R11C03	12-3-11	MAPKAP~N/A	170	43	127
B12R11C04	12-4-11	MAPKAP~N/A	157	67	90
B12R11C05	12-5-11	Buffer	86	41	45
B12R11C06	12-6-11	Buffer	84	44	40
B12R11C07	12-7-11	BSA~N/A	7612	40	7572
B12R11C08	12-8-11	BSA~N/A	7685	40	7645
B12R11C09	12-9-11	Anti-HumanIgG1~N/A	1374	40	1334
B12R11C10	12-10-11	Anti-HumanIgG1~N/A	1330	42	1288
B12R11C11	12-11-11	Anti-HumanIgG2~N/A	2447	40	2407
B12R11C12	12-12-11	Anti-HumanIgG2~N/A	2634	40	2594
B12R11C13	12-13-11	Anti-HumanIgG3~N/A	4409	40	4369
B12R11C14	12-14-11	Anti-HumanIgG3~N/A	4553	41	4512
B12R11C15	12-15-11	Anti-HumanIgG4~N/A	9748	43	9705
B12R11C16	12-16-11	Anti-HumanIgG4~N/A	9025	42	8983
B12R11C17	12-17-11	AntiBiotinAb~N/A	10383	42	10341
B12R11C18	12-18-11	AntiBiotinAb~N/A	10228	41	10187
B12R11C19	12-19-11	Buffer	49	45	4
B12R11C20	12-20-11	Buffer	42	40	2
B12R11C21	12-21-11	Hs~MGC:BC042195.1~uORF:IOH28766	124	45	79
B12R11C22	12-22-11	Hs~MGC:BC042195.1~uORF:IOH28766	75	42	33
B12R12C01	12-1-12	Hs~MGC:BC057810.1~uORF:IOH29262	278	41	237
B12R12C02	12-2-12	Hs~MGC:BC057810.1~uORF:IOH29262	304	41	263
B12R12C03	12-3-12	Hs~MGC:BC052984.1~uORF:IOH28912	318	41	277
B12R12C04	12-4-12	Hs~MGC:BC052984.1~uORF:IOH28912	382	41	341
B12R12C05	12-5-12	Hs~MGC:BC052805.1~uORF:IOH29378	1961	42	1919
B12R12C06	12-6-12	Hs~MGC:BC052805.1~uORF:IOH29378	1931	42	1889
B12R12C07	12-7-12	Hs~Ref:NM_173519.1~uORF:IOH27342	516	42	474
B12R12C08	12-8-12	Hs~Ref:NM_173519.1~uORF:IOH27342	547	44	503
B12R12C09	12-9-12	Hs~MGC:BC047870.1~uORF:IOH26949	63	46	17
B12R12C10	12-10-12	Hs~MGC:BC047870.1~uORF:IOH26949	302	45	257
B12R12C11	12-11-12	Hs~Ref:NM_021038.3~uORF:IOH26398	842	42	800
B12R12C12	12-12-12	Hs~Ref:NM_021038.3~uORF:IOH26398	815	40	775
B12R12C13	12-13-12	Hs~Ref:NM_002558.2~uORF:IOH26134	545	40	505
B12R12C14	12-14-12	Hs~Ref:NM_002558.2~uORF:IOH26134	610	41	569
B12R12C15	12-15-12	Hs~MGC:BC098152.1~uORF:IOH63303	133	42	91
B12R12C16	12-16-12	Hs~MGC:BC098152.1~uORF:IOH63303	137	43	94
B12R12C17	12-17-12	Hs~MGC:BC103660.1~uORF:IOH63319	620	48	572
B12R12C18	12-18-12	Hs~MGC:BC103660.1~uORF:IOH63319	600	45	555
B12R12C19	12-19-12	Hs~Ref:NM_145051.1~uORF:IOH12052	219	79	140
B12R12C20	12-20-12	Hs~Ref:NM_145051.1~uORF:IOH12052	150	47	103
B12R12C21	12-21-12	Hs~MGC:BC007681.2~uORF:IOH6233	283	236	47
B12R12C22	12-22-12	Hs~MGC:BC007681.2~uORF:IOH6233	455	47	408
B12R13C01	12-1-13	Hs~MGC:BC032919.1~uORF:IOH23210	325	40	285
B12R13C02	12-2-13	Hs~MGC:BC032919.1~uORF:IOH23210	344	42	302
B12R13C03	12-3-13	Hs~MGC:BC033088.1~uORF:IOH23217	919	40	879
B12R13C04	12-4-13	Hs~MGC:BC033088.1~uORF:IOH23217	950	40	910
B12R13C05	12-5-13	Hs~Ref:NM_014270.3~uORF:IOH12317	345	41	304
B12R13C06	12-6-13	Hs~Ref:NM_014270.3~uORF:IOH12317	376	41	335
B12R13C07	12-7-13	Hs~Ref:NM_001001550.1~uORF:IOH13204	2735	41	2694
B12R13C08	12-8-13	Hs~Ref:NM_001001550.1~uORF:IOH13204	2748	40	2708
B12R13C09	12-9-13	Hs~Ref:NM_133443.1~uORF:IOH40699	1110	45	1065
B12R13C10	12-10-13	Hs~Ref:NM_133443.1~uORF:IOH40699	1045	46	999
B12R13C11	12-11-13	Hs~Ref:NM_018894.1~uORF:IOH37773	136	43	93
B12R13C12	12-12-13	Hs~Ref:NM_018894.1~uORF:IOH37773	128	41	87
B12R13C13	12-13-13	Hs~MGC:BC053533.1~uORF:IOH39790	58	45	13
B12R13C14	12-14-13	Hs~MGC:BC053533.1~uORF:IOH39790	441	43	398
B12R13C15	12-15-13	Hs~MGC:BC064518.1~uORF:IOH39887	329	46	283
B12R13C16	12-16-13	Hs~MGC:BC064518.1~uORF:IOH39887	44	51	-7
B12R13C17	12-17-13	Hs~MGC:BC022075.1~uORF:IOH10954	553	46	507
B12R13C18	12-18-13	Hs~MGC:BC022075.1~uORF:IOH10954	542	46	496
B12R13C19	12-19-13	Hs~Ref:NM_014380.1~uORF:IOH4519	3245	43	3202
B12R13C20	12-20-13	Hs~Ref:NM_014380.1~uORF:IOH4519	3263	45	3218
B12R13C21	12-21-13	Hs~Ref:NM_030920.1~uORF:IOH2956	285	150	135
B12R13C22	12-22-13	Hs~Ref:NM_030920.1~uORF:IOH2956	50	53	-3
B12R14C01	12-1-14	Hs~Ref:NM_001009957.1~uORF:IOH57345	298	42	256
B12R14C02	12-2-14	Hs~Ref:NM_001009957.1~uORF:IOH57345	304	45	259
B12R14C03	12-3-14	Hs~Ref:NM_001005473.1~uORF:IOH59368	428	41	387
B12R14C04	12-4-14	Hs~Ref:NM_001005473.1~uORF:IOH59368	401	41	360
B12R14C05	12-5-14	Hs~Ref:NM_001008270.1~uORF:IOH59742	243	47	196
B12R14C06	12-6-14	Hs~Ref:NM_001008270.1~uORF:IOH59742	244	42	202
B12R14C07	12-7-14	Hs~Ref:NM_012217.2~uORF:IOH59766	291	43	248
B12R14C08	12-8-14	Hs~Ref:NM_012217.2~uORF:IOH59766	253	41	212
B12R14C09	12-9-14	Hs~Ref:NM_206900.1~uORF:IOH53506	212	43	169
B12R14C10	12-10-14	Hs~Ref:NM_206900.1~uORF:IOH53506	271	45	226
B12R14C11	12-11-14	Hs~Ref:NM_006792.2~uORF:IOH58223	400	44	356
B12R14C12	12-12-14	Hs~Ref:NM_006792.2~uORF:IOH58223	439	45	394
B12R14C13	12-13-14	Hs~MGC:NM_000461.3~uORF:IOH29857	102	44	58
B12R14C14	12-14-14	Hs~MGC:NM_000461.3~uORF:IOH29857	70	62	8
B12R14C15	12-15-14	Hs~Ref:NM_181268.1~uORF:IOH58697	74	49	25
B12R14C16	12-16-14	Hs~Ref:NM_181268.1~uORF:IOH58697	359	56	303
B12R14C17	12-17-14	Hs~Ref:NM_004442.3~N/A	70	58	12
B12R14C18	12-18-14	Hs~Ref:NM_004442.3~N/A	267	48	219
B12R14C19	12-19-14	Hs~Ref:NM_000525.3~uORF:IOH60138	392	79	313
B12R14C20	12-20-14	Hs~Ref:NM_000525.3~uORF:IOH60138	57	46	11
B12R14C21	12-21-14	Hs~MGC:BC069089.1~uORF:IOH63640	646	48	598
B12R14C22	12-22-14	Hs~MGC:BC069089.1~uORF:IOH63640	612	45	567
B12R15C01	12-1-15	Hs~Ref:NM_020204.2~uORF:IOH41164	602	39	563
B12R15C02	12-2-15	Hs~Ref:NM_020204.2~uORF:IOH41164	627	41	586
B12R15C03	12-3-15	Hs~Ref:NM_030761.3~uORF:IOH29127	434	41	393
B12R15C04	12-4-15	Hs~Ref:NM_030761.3~uORF:IOH29127	409	41	368
B12R15C05	12-5-15	Hs~Ref:NM_001216.1~uORF:IOH14740	394	41	353
B12R15C06	12-6-15	Hs~Ref:NM_001216.1~uORF:IOH14740	408	40	368
B12R15C07	12-7-15	Hs~Ref:NM_017594.2~uORF:IOH5904	395	40	355
B12R15C08	12-8-15	Hs~Ref:NM_017594.2~uORF:IOH5904	411	41	370
B12R15C09	12-9-15	Hs~Ref:NM_024430.1~uORF:IOH27423	402	40	362
B12R15C10	12-10-15	Hs~Ref:NM_024430.1~uORF:IOH27423	276	43	233
B12R15C11	12-11-15	Hs~MGC:BC040527.1~uORF:IOH27478	649	49	600
B12R15C12	12-12-15	Hs~MGC:BC040527.1~uORF:IOH27478	54	48	6
B12R15C13	12-13-15	Hs~Ref:NM_031988.1~CAT:PV3318	148	41	107
B12R15C14	12-14-15	Hs~Ref:NM_031988.1~CAT:PV3318	144	42	102
B12R15C15	12-15-15	Hs~Ref:NM_004440.1~CAT:PV3689	43	47	-4
B12R15C16	12-16-15	Hs~Ref:NM_004440.1~CAT:PV3689	52	50	2
B12R15C17	12-17-15	Hs~Ref:NM_004409.2~CAT:PV3784	256	45	211
B12R15C18	12-18-15	Hs~Ref:NM_004409.2~CAT:PV3784	351	65	286
B12R15C19	12-19-15	Hs~IVGN:PM_3503~Ext:influenza_A~N/A	3675	44	3631
B12R15C20	12-20-15	Hs~IVGN:PM_3503~Ext:influenza_A~N/A	3630	44	3586
B12R15C21	12-21-15	Hs~Ref:NM_016123.1~CAT:PV3362	111	41	70
B12R15C22	12-22-15	Hs~Ref:NM_016123.1~CAT:PV3362	40	47	-7
B12R16C01	12-1-16	Hs~Ref:NM_000880.2~CAT_PHC0076	692	39	653
B12R16C02	12-2-16	Hs~Ref:NM_000880.2~CAT_PHC0076	698	40	658
B12R16C03	12-3-16	Hs~Ref:NM_002983.1~CAT_PHC1105	116	43	73
B12R16C04	12-4-16	Hs~Ref:NM_002983.1~CAT_PHC1105	114	42	72
B12R16C05	12-5-16	Hs~IVGN:NM_002007~CAT_PHG0154~N/A	330	40	290
B12R16C06	12-6-16	Hs~IVGN:NM_002007~CAT_PHG0154~N/A	328	40	288
B12R16C07	12-7-16	Hs~Ref:NM_005416.1~uORF:IOH59847	434	39	395
B12R16C08	12-8-16	Hs~Ref:NM_005416.1~uORF:IOH59847	413	39	374
B12R16C09	12-9-16	Hs~MGC:BC065912.1~uORF:IOH40442	1157	40	1117
B12R16C10	12-10-16	Hs~MGC:BC065912.1~uORF:IOH40442	1197	42	1155
B12R16C11	12-11-16	Hs~Ref:NM_182770.1~uORF:IOH53444	755	44	711
B12R16C12	12-12-16	Hs~Ref:NM_182770.1~uORF:IOH53444	682	45	637
B12R16C13	12-13-16	Hs~Ref:NM_002031.2~uORF:IOH56137	357	43	314
B12R16C14	12-14-16	Hs~Ref:NM_002031.2~uORF:IOH56137	346	40	306
B12R16C15	12-15-16	Hs~Ref:NM_020215.2~uORF:IOH28060	54	46	8
B12R16C16	12-16-16	Hs~Ref:NM_020215.2~uORF:IOH28060	282	43	239
B12R16C17	12-17-16	Hs~Ref:NM_020672.1~uORF:IOH5597	285	146	139
B12R16C18	12-18-16	Hs~Ref:NM_020672.1~uORF:IOH5597	207	77	130
B12R16C19	12-19-16	Hs~Ref:NM_005850.3~uORF:IOH5494	511	47	464
B12R16C20	12-20-16	Hs~Ref:NM_005850.3~uORF:IOH5494	308	57	251
B12R16C21	12-21-16	Hs~Ref:NM_002923.1~uORF:IOH7121	402	48	354
B12R16C22	12-22-16	Hs~Ref:NM_002923.1~uORF:IOH7121	415	43	372
B12R17C01	12-1-17	Hs~MGC:NM_170693.1~uORF:IOH14023	291	40	251
B12R17C02	12-2-17	Hs~MGC:NM_170693.1~uORF:IOH14023	280	40	240
B12R17C03	12-3-17	Hs~MGC:BC010931.1~uORF:IOH14302	250	43	207
B12R17C04	12-4-17	Hs~MGC:BC010931.1~uORF:IOH14302	236	67	169
B12R17C05	12-5-17	Hs~MGC:BC010947.1~uORF:IOH14455	326	46	280
B12R17C06	12-6-17	Hs~MGC:BC010947.1~uORF:IOH14455	305	41	264
B12R17C07	12-7-17	Hs~MGC:BC028725.2~uORF:IOH11761	265	40	225
B12R17C08	12-8-17	Hs~MGC:BC028725.2~uORF:IOH11761	276	41	235
B12R17C09	12-9-17	Hs~MGC:NM_175738.2~uORF:IOH27507	345	42	303
B12R17C10	12-10-17	Hs~MGC:NM_175738.2~uORF:IOH27507	322	43	279
B12R17C11	12-11-17	Hs~MGC:NM_173607.2~uORF:IOH21621	80	41	39
B12R17C12	12-12-17	Hs~MGC:NM_173607.2~uORF:IOH21621	73	43	30
B12R17C13	12-13-17	Hs~MGC:NM_173088.1~uORF:IOH5097	205	43	162
B12R17C14	12-14-17	Hs~MGC:NM_173088.1~uORF:IOH5097	368	52	316
B12R17C15	12-15-17	Hs~Ref:NM_032328.1~uORF:IOH7232	55	46	9
B12R17C16	12-16-17	Hs~Ref:NM_032328.1~uORF:IOH7232	47	48	-1
B12R17C17	12-17-17	Hs~MGC:BC020242.1~uORF:IOH57203	289	47	242
B12R17C18	12-18-17	Hs~MGC:BC020242.1~uORF:IOH57203	311	73	238
B12R17C19	12-19-17	Hs~MGC:BC000467.2~uORF:IOH56721	46	53	-7
B12R17C20	12-20-17	Hs~MGC:BC000467.2~uORF:IOH56721	120	52	68
B12R17C21	12-21-17	Hs~MGC:NM_178177.2~uORF:IOH22674	61	48	13
B12R17C22	12-22-17	Hs~MGC:NM_178177.2~uORF:IOH22674	41	52	-11
B12R18C01	12-1-18	Hs~MGC:BC100765.2~uORF:IOH63417	293	42	251
B12R18C02	12-2-18	Hs~MGC:BC100765.2~uORF:IOH63417	324	42	282
B12R18C03	12-3-18	Hs~MGC:BC094759.1~uORF:IOH62624	232	43	189
B12R18C04	12-4-18	Hs~MGC:BC094759.1~uORF:IOH62624	99	44	55
B12R18C05	12-5-18	Hs~MGC:BC091497.1~uORF:IOH62592	411	42	369
B12R18C06	12-6-18	Hs~MGC:BC091497.1~uORF:IOH62592	378	42	336
B12R18C07	12-7-18	Hs~MGC:BC073959.1~uORF:IOH62556	263	63	200
B12R18C08	12-8-18	Hs~MGC:BC073959.1~uORF:IOH62556	265	42	223
B12R18C09	12-9-18	Hs~MGC:BC066284.1~uORF:IOH61831	113	43	70
B12R18C10	12-10-18	Hs~MGC:BC066284.1~uORF:IOH61831	242	53	189
B12R18C11	12-11-18	Hs~Ref:NM_138972.2~uORF:IOH39612	574	42	532
B12R18C12	12-12-18	Hs~Ref:NM_138972.2~uORF:IOH39612	638	43	595
B12R18C13	12-13-18	Hs~MGC:BC032662.1~uORF:IOH21986	1178	46	1132
B12R18C14	12-14-18	Hs~MGC:BC032662.1~uORF:IOH21986	1320	47	1273
B12R18C15	12-15-18	Hs~Ref:NM_001961.2~uORF:IOH39624	670	47	623
B12R18C16	12-16-18	Hs~Ref:NM_001961.2~uORF:IOH39624	397	48	349
B12R18C17	12-17-18	Hs~Ref:NM_012096.1~uORF:IOH11629	510	46	464
B12R18C18	12-18-18	Hs~Ref:NM_012096.1~uORF:IOH11629	522	46	476
B12R18C19	12-19-18	Hs~Ref:NM_000861.2~uORF:IOH29722	412	68	344
B12R18C20	12-20-18	Hs~Ref:NM_000861.2~uORF:IOH29722	443	55	388
B12R18C21	12-21-18	Hs~MGC:BC007956.1~uORF:IOH29317	60	51	9
B12R18C22	12-22-18	Hs~MGC:BC007956.1~uORF:IOH29317	43	61	-18
B12R19C01	12-1-19	Hs~Ref:NM_012368.1~uORF:IOH28406	334	41	293
B12R19C02	12-2-19	Hs~Ref:NM_012368.1~uORF:IOH28406	367	42	325
B12R19C03	12-3-19	Hs~Ref:NM_006136.1~uORF:IOH7253	454	43	411
B12R19C04	12-4-19	Hs~Ref:NM_006136.1~uORF:IOH7253	444	42	402
B12R19C05	12-5-19	Hs~Ref:NM_020166.2~uORF:IOH3833	83	40	43
B12R19C06	12-6-19	Hs~Ref:NM_020166.2~uORF:IOH3833	135	57	78
B12R19C07	12-7-19	Hs~MGC:BC000478.2~uORF:IOH3690	237	46	191
B12R19C08	12-8-19	Hs~MGC:BC000478.2~uORF:IOH3690	260	47	213
B12R19C09	12-9-19	Hs~Ref:NM_006775.1~uORF:IOH10720	343	43	300
B12R19C10	12-10-19	Hs~Ref:NM_006775.1~uORF:IOH10720	372	42	330
B12R19C11	12-11-19	Hs~Ref:NM_005915.4~uORF:IOH21645	76	42	34
B12R19C12	12-12-19	Hs~Ref:NM_005915.4~uORF:IOH21645	108	56	52
B12R19C13	12-13-19	Hs~Ref:NM_004671.2~uORF:IOH52471	366	44	322
B12R19C14	12-14-19	Hs~Ref:NM_004671.2~uORF:IOH52471	56	47	9
B12R19C15	12-15-19	Hs~Ref:NM_001012965.1~uORF:IOH58966	123	48	75
B12R19C16	12-16-19	Hs~Ref:NM_001012965.1~uORF:IOH58966	426	46	380
B12R19C17	12-17-19	Hs~Ref:NM_022641.2~uORF:IOH58682	330	46	284
B12R19C18	12-18-19	Hs~Ref:NM_022641.2~uORF:IOH58682	336	44	292
B12R19C19	12-19-19	Hs~Ref:NM_006786.2~uORF:IOH58698	475	45	430
B12R19C20	12-20-19	Hs~Ref:NM_006786.2~uORF:IOH58698	452	43	409
B12R19C21	12-21-19	Hs~MGC:BC000809.1~uORF:IOH3070	856	47	809
B12R19C22	12-22-19	Hs~MGC:BC000809.1~uORF:IOH3070	862	48	814
B12R20C01	12-1-20	Hs~MGC:BC021303.1~uORF:IOH14570	260	42	218
B12R20C02	12-2-20	Hs~MGC:BC021303.1~uORF:IOH14570	267	45	222
B12R20C03	12-3-20	Hs~MGC:BC001017.1~uORF:IOH4237	144	43	101
B12R20C04	12-4-20	Hs~MGC:BC001017.1~uORF:IOH4237	287	43	244
B12R20C05	12-5-20	Hs~Ref:NM_000375.1~uORF:IOH4136	50	38	12
B12R20C06	12-6-20	Hs~Ref:NM_000375.1~uORF:IOH4136	40	41	-1
B12R20C07	12-7-20	Hs~Ref:NM_052969.1~uORF:IOH12514	618	49	569
B12R20C08	12-8-20	Hs~Ref:NM_052969.1~uORF:IOH12514	616	50	566
B12R20C09	12-9-20	Hs~MGC:BC007991.2~uORF:IOH6109	702	42	660
B12R20C10	12-10-20	Hs~MGC:BC007991.2~uORF:IOH6109	642	39	603
B12R20C11	12-11-20	Hs~Ref:NM_014049.3~uORF:IOH6788	669	39	630
B12R20C12	12-12-20	Hs~Ref:NM_014049.3~uORF:IOH6788	636	40	596
B12R20C13	12-13-20	Hs~MGC:BC013331.1~uORF:IOH13858	805	41	764
B12R20C14	12-14-20	Hs~MGC:BC013331.1~uORF:IOH13858	697	44	653
B12R20C15	12-15-20	Hs~Ref:NM_080879.2~uORF:IOH45721	1264	42	1222
B12R20C16	12-16-20	Hs~Ref:NM_080879.2~uORF:IOH45721	1233	42	1191
B12R20C17	12-17-20	Hs~MGC:BC034318.1~uORF:IOH27668	1106	41	1065
B12R20C18	12-18-20	Hs~MGC:BC034318.1~uORF:IOH27668	1160	41	1119
B12R20C19	12-19-20	Hs~Ref:NM_201648.1~uORF:IOH44576	47	47	0
B12R20C20	12-20-20	Hs~Ref:NM_201648.1~uORF:IOH44576	60	47	13
B12R20C21	12-21-20	Hs~Ref:NM_005459.2~uORF:IOH44401	191	59	132
B12R20C22	12-22-20	Hs~Ref:NM_005459.2~uORF:IOH44401	154	57	97
B12R21C01	12-1-21	Hs~Ref:NM_001005782.1~uORF:IOH50126	703	40	663
B12R21C02	12-2-21	Hs~Ref:NM_001005782.1~uORF:IOH50126	705	40	665
B12R21C03	12-3-21	Hs~Ref:NM_183049.2~uORF:IOH50073	590	40	550
B12R21C04	12-4-21	Hs~Ref:NM_183049.2~uORF:IOH50073	589	40	549
B12R21C05	12-5-21	Hs~Ref:ENST00000339946~uORF:IOH50128	894	40	854
B12R21C06	12-6-21	Hs~Ref:ENST00000339946~uORF:IOH50128	936	40	896
B12R21C07	12-7-21	Hs~Ref:NM_207285.1~uORF:IOH50066	12395	44	12351
B12R21C08	12-8-21	Hs~Ref:NM_207285.1~uORF:IOH50066	12573	45	12528
B12R21C09	12-9-21	Hs~Ref:NP_003028.1~CAT_10837-H08H-25	36	41	-5
B12R21C10	12-10-21	Hs~Ref:NP_003028.1~CAT_10837-H08H-25	38	38	0
B12R21C11	12-11-21	Internal_1007209	42	37	5
B12R21C12	12-12-21	Internal_1007209	43	37	6
B12R21C13	12-13-21	Hs~Ref:NP_055022.2~CAT_11027-H08H-25	42	38	4
B12R21C14	12-14-21	Hs~Ref:NP_055022.2~CAT_11027-H08H-25	43	38	5
B12R21C15	12-15-21	Internal_1007209	70	40	30
B12R21C16	12-16-21	Internal_1007209	46	44	2
B12R21C17	12-17-21	Hs~Ref:O43464-1~CAT_10619-H08E-25	46	41	5
B12R21C18	12-18-21	Hs~Ref:O43464-1~CAT_10619-H08E-25	40	38	2
B12R21C19	12-19-21	Internal_1007209	41	41	0
B12R21C20	12-20-21	Internal_1007209	40	42	-2
B12R21C21	12-21-21	Internal_1007209	40	40	0
B12R21C22	12-22-21	Internal_1007209	38	41	-3
B12R22C01	12-1-22	ERa~N/A	2594	38	2556
B12R22C02	12-2-22	ERa~N/A	2389	38	2351
B12R22C03	12-3-22	PKCeta~N/A	283	41	242
B12R22C04	12-4-22	PKCeta~N/A	272	41	231
B12R22C05	12-5-22	Calmodulin~N/A	87	46	41
B12R22C06	12-6-22	Calmodulin~N/A	53	39	14
B12R22C07	12-7-22	V5control5~N/A	291	41	250
B12R22C08	12-8-22	V5control5~N/A	348	46	302
B12R22C09	12-9-22	V5control4~N/A	316	48	268
B12R22C10	12-10-22	V5control4~N/A	414	55	359
B12R22C11	12-11-22	V5control3~N/A	97	48	49
B12R22C12	12-12-22	V5control3~N/A	54	39	15
B12R22C13	12-13-22	V5control2~N/A	60	40	20
B12R22C14	12-14-22	V5control2~N/A	48	38	10
B12R22C15	12-15-22	V5control1~N/A	47	39	8
B12R22C16	12-16-22	V5control1~N/A	50	41	9
B12R22C17	12-17-22	CMK2A~N/A	477	40	437
B12R22C18	12-18-22	CMK2A~N/A	497	39	458
B12R22C19	12-19-22	ERa~N/A	2060	40	2020
B12R22C20	12-20-22	ERa~N/A	1877	40	1837
B12R22C21	12-21-22	AlexaAntiMouseAb~N/A	8815	40	8775
B12R22C22	12-22-22	AlexaAntiMouseAb~N/A	8752	41	8711
B13R01C01	13-1-1	AlexaAntiMouseAb~N/A	31342	37	31305
B13R01C02	13-2-1	AlexaAntiMouseAb~N/A	32452	35	32417
B13R01C03	13-3-1	ERa~N/A	2173	34	2139
B13R01C04	13-4-1	ERa~N/A	2038	34	2004
B13R01C05	13-5-1	HumanIgG1~N/A	1441	35	1406
B13R01C06	13-6-1	HumanIgG1~N/A	1556	35	1521
B13R01C07	13-7-1	HumanIgG2~N/A	3548	35	3513
B13R01C08	13-8-1	HumanIgG2~N/A	3465	35	3430
B13R01C09	13-9-1	HumanIgG3~N/A	14582	36	14546
B13R01C10	13-10-1	HumanIgG3~N/A	14611	37	14574
B13R01C11	13-11-1	HumanIgG4~N/A	40442	38	40404
B13R01C12	13-12-1	HumanIgG4~N/A	41539	40	41499
B13R01C13	13-13-1	BiotinAb~N/A	367	43	324
B13R01C14	13-14-1	BiotinAb~N/A	350	40	310
B13R01C15	13-15-1	RanBP2deltaFG~N/A	264	35	229
B13R01C16	13-16-1	RanBP2deltaFG~N/A	262	37	225
B13R01C17	13-17-1	hMDM2~N/A	713	43	670
B13R01C18	13-18-1	hMDM2~N/A	748	40	708
B13R01C19	13-19-1	PKCeta~N/A	418	36	382
B13R01C20	13-20-1	PKCeta~N/A	410	37	373
B13R01C21	13-21-1	AlexaAntiMouseAb~N/A	34657	39	34618
B13R01C22	13-22-1	AlexaAntiMouseAb~N/A	41366	39	41327
B13R02C01	13-1-2	PKCeta~N/A	998	41	957
B13R02C02	13-2-2	PKCeta~N/A	1035	36	999
B13R02C03	13-3-2	Buffer	144	43	101
B13R02C04	13-4-2	Buffer	154	38	116
B13R02C05	13-5-2	HumanIgA~N/A	19755	37	19718
B13R02C06	13-6-2	HumanIgA~N/A	20438	38	20400
B13R02C07	13-7-2	Buffer	104	41	63
B13R02C08	13-8-2	Buffer	105	38	67
B13R02C09	13-9-2	BSA~N/A	11626	36	11590
B13R02C10	13-10-2	BSA~N/A	12097	36	12061
B13R02C11	13-11-2	Hs~MGC:NM_174909.1~uORF:IOH14735	433	35	398
B13R02C12	13-12-2	Hs~MGC:NM_174909.1~uORF:IOH14735	449	37	412
B13R02C13	13-13-2	Hs~MGC:BC011600.1~uORF:IOH13680	15366	50	15316
B13R02C14	13-14-2	Hs~MGC:BC011600.1~uORF:IOH13680	14607	43	14564
B13R02C15	13-15-2	Hs~MGC:NM_172240.1~uORF:IOH10829	536	36	500
B13R02C16	13-16-2	Hs~MGC:NM_172240.1~uORF:IOH10829	521	42	479
B13R02C17	13-17-2	Hs~Ref:NM_004221.2~uORF:IOH14487	265	88	177
B13R02C18	13-18-2	Hs~Ref:NM_004221.2~uORF:IOH14487	275	64	211
B13R02C19	13-19-2	Hs~Ref:XM_378305.2~uORF:IOH42388	320	37	283
B13R02C20	13-20-2	Hs~Ref:XM_378305.2~uORF:IOH42388	323	43	280
B13R02C21	13-21-2	Hs~Ref:NM_201521.1~uORF:IOH43964	776	66	710
B13R02C22	13-22-2	Hs~Ref:NM_201521.1~uORF:IOH43964	784	45	739
B13R03C01	13-1-3	Hs~Ref:NM_022730.1~uORF:IOH42071	702	51	651
B13R03C02	13-2-3	Hs~Ref:NM_022730.1~uORF:IOH42071	576	40	536
B13R03C03	13-3-3	Hs~Ref:NM_021649.3~uORF:IOH43638	245	42	203
B13R03C04	13-4-3	Hs~Ref:NM_021649.3~uORF:IOH43638	215	36	179
B13R03C05	13-5-3	Hs~MGC:BC046214.1~uORF:IOH26987	177	80	97
B13R03C06	13-6-3	Hs~MGC:BC046214.1~uORF:IOH26987	177	76	101
B13R03C07	13-7-3	Hs~Ref:NM_002612.1~uORF:IOH25726	1556	44	1512
B13R03C08	13-8-3	Hs~Ref:NM_002612.1~uORF:IOH25726	1625	42	1583
B13R03C09	13-9-3	Hs~MGC:BC013173.1~uORF:IOH11125	354	40	314
B13R03C10	13-10-3	Hs~MGC:BC013173.1~uORF:IOH11125	397	42	355
B13R03C11	13-11-3	Hs~Ref:NM_006356.1~uORF:IOH26157	339	38	301
B13R03C12	13-12-3	Hs~Ref:NM_006356.1~uORF:IOH26157	321	37	284
B13R03C13	13-13-3	Hs~MGC:BC002954.1~uORF:IOH4913	306	37	269
B13R03C14	13-14-3	Hs~MGC:BC002954.1~uORF:IOH4913	320	38	282
B13R03C15	13-15-3	Hs~MGC:BC008803.1~uORF:IOH6345	486	37	449
B13R03C16	13-16-3	Hs~MGC:BC008803.1~uORF:IOH6345	537	37	500
B13R03C17	13-17-3	Hs~MGC:BC002430.1~uORF:IOH4273	481	39	442
B13R03C18	13-18-3	Hs~MGC:BC002430.1~uORF:IOH4273	466	41	425
B13R03C19	13-19-3	Hs~Ref:NM_005842.2~uORF:IOH13536	765	40	725
B13R03C20	13-20-3	Hs~Ref:NM_005842.2~uORF:IOH13536	756	41	715
B13R03C21	13-21-3	Hs~Ref:NM_012420.1~uORF:IOH22625	398	76	322
B13R03C22	13-22-3	Hs~Ref:NM_012420.1~uORF:IOH22625	353	43	310
B13R04C01	13-1-4	Hs~Ref:NM_016564.1~uORF:IOH22629	1394	35	1359
B13R04C02	13-2-4	Hs~Ref:NM_016564.1~uORF:IOH22629	1334	35	1299
B13R04C03	13-3-4	Hs~MGC:NM_152389.1~uORF:IOH22642	425	37	388
B13R04C04	13-4-4	Hs~MGC:NM_152389.1~uORF:IOH22642	414	37	377
B13R04C05	13-5-4	Hs~Ref:NM_019099.1~uORF:IOH22645	299	36	263
B13R04C06	13-6-4	Hs~Ref:NM_019099.1~uORF:IOH22645	284	39	245
B13R04C07	13-7-4	Hs~Ref:NM_002120.2~uORF:IOH6668	259	42	217
B13R04C08	13-8-4	Hs~Ref:NM_002120.2~uORF:IOH6668	244	41	203
B13R04C09	13-9-4	Hs~MGC:BC007704.1~uORF:IOH6307	389	41	348
B13R04C10	13-10-4	Hs~MGC:BC007704.1~uORF:IOH6307	423	42	381
B13R04C11	13-11-4	Hs~Ref:NM_016306.2~uORF:IOH4824	390	39	351
B13R04C12	13-12-4	Hs~Ref:NM_016306.2~uORF:IOH4824	375	37	338
B13R04C13	13-13-4	Hs~MGC:BC007546.1~uORF:IOH6804	200	38	162
B13R04C14	13-14-4	Hs~MGC:BC007546.1~uORF:IOH6804	236	56	180
B13R04C15	13-15-4	Hs~MGC:BC060813.1~uORF:IOH39816	747	41	706
B13R04C16	13-16-4	Hs~MGC:BC060813.1~uORF:IOH39816	801	39	762
B13R04C17	13-17-4	Hs~MGC:BC014959.1~uORF:IOH13467	922	36	886
B13R04C18	13-18-4	Hs~MGC:BC014959.1~uORF:IOH13467	863	37	826
B13R04C19	13-19-4	Hs~Ref:NM_033453.2~uORF:IOH13043	159	43	116
B13R04C20	13-20-4	Hs~Ref:NM_033453.2~uORF:IOH13043	167	51	116
B13R04C21	13-21-4	Hs~Ref:NM_024708.2~uORF:IOH39832	294	76	218
B13R04C22	13-22-4	Hs~Ref:NM_024708.2~uORF:IOH39832	315	55	260
B13R05C01	13-1-5	Hs~MGC:BC009462.1~uORF:IOH12111	403	34	369
B13R05C02	13-2-5	Hs~MGC:BC009462.1~uORF:IOH12111	408	34	374
B13R05C03	13-3-5	Hs~MGC:BC017100.1~uORF:IOH12953	483	35	448
B13R05C04	13-4-5	Hs~MGC:BC017100.1~uORF:IOH12953	522	37	485
B13R05C05	13-5-5	Hs~MGC:BC017376.2~uORF:IOH12616	659	36	623
B13R05C06	13-6-5	Hs~MGC:BC017376.2~uORF:IOH12616	580	37	543
B13R05C07	13-7-5	Hs~Ref:NM_022104.1~uORF:IOH12306	460	42	418
B13R05C08	13-8-5	Hs~Ref:NM_022104.1~uORF:IOH12306	449	40	409
B13R05C09	13-9-5	Hs~MGC:BC045758.1~uORF:IOH26432	1137	37	1100
B13R05C10	13-10-5	Hs~MGC:BC045758.1~uORF:IOH26432	1172	36	1136
B13R05C11	13-11-5	Hs~MGC:BC050704.1~uORF:IOH27028	495	37	458
B13R05C12	13-12-5	Hs~MGC:BC050704.1~uORF:IOH27028	455	37	418
B13R05C13	13-13-5	Hs~MGC:BC040955.1~uORF:IOH26197	102	51	51
B13R05C14	13-14-5	Hs~MGC:BC040955.1~uORF:IOH26197	153	61	92
B13R05C15	13-15-5	Hs~MGC:BC047945.1~uORF:IOH26362	205	133	72
B13R05C16	13-16-5	Hs~MGC:BC047945.1~uORF:IOH26362	256	169	87
B13R05C17	13-17-5	Hs~Ref:NM_020070.1~uORF:IOH10617	684	36	648
B13R05C18	13-18-5	Hs~Ref:NM_020070.1~uORF:IOH10617	636	36	600
B13R05C19	13-19-5	Hs~MGC:BC024919.1~uORF:IOH11019	350	42	308
B13R05C20	13-20-5	Hs~MGC:BC024919.1~uORF:IOH11019	359	48	311
B13R05C21	13-21-5	Hs~Ref:NM_018956.2~uORF:IOH11209	2666	60	2606
B13R05C22	13-22-5	Hs~Ref:NM_018956.2~uORF:IOH11209	2753	41	2712
B13R06C01	13-1-6	Hs~Ref:NM_021101.3~uORF:IOH10602	310	36	274
B13R06C02	13-2-6	Hs~Ref:NM_021101.3~uORF:IOH10602	326	37	289
B13R06C03	13-3-6	Hs~Ref:NM_144769.1~uORF:IOH40875	392	36	356
B13R06C04	13-4-6	Hs~Ref:NM_144769.1~uORF:IOH40875	386	40	346
B13R06C05	13-5-6	Hs~Ref:NM_016355.3~uORF:IOH39973	497	39	458
B13R06C06	13-6-6	Hs~Ref:NM_016355.3~uORF:IOH39973	460	36	424
B13R06C07	13-7-6	Hs~MGC:BC070073.1~uORF:IOH40070	361	36	325
B13R06C08	13-8-6	Hs~MGC:BC070073.1~uORF:IOH40070	387	37	350
B13R06C09	13-9-6	Hs~MGC:BC065195.1~uORF:IOH39893	206	38	168
B13R06C10	13-10-6	Hs~MGC:BC065195.1~uORF:IOH39893	118	37	81
B13R06C11	13-11-6	Hs~Ref:NM_198252.1~uORF:IOH45790	1987	38	1949
B13R06C12	13-12-6	Hs~Ref:NM_198252.1~uORF:IOH45790	1944	39	1905
B13R06C13	13-13-6	Hs~Ref:NM_130766.1~uORF:IOH45827	220	42	178
B13R06C14	13-14-6	Hs~Ref:NM_130766.1~uORF:IOH45827	261	91	170
B13R06C15	13-15-6	Hs~Ref:NM_138349.2~uORF:IOH45741	378	39	339
B13R06C16	13-16-6	Hs~Ref:NM_138349.2~uORF:IOH45741	374	38	336
B13R06C17	13-17-6	Hs~Ref:NM_015942.3~uORF:IOH45791	373	39	334
B13R06C18	13-18-6	Hs~Ref:NM_015942.3~uORF:IOH45791	339	41	298
B13R06C19	13-19-6	Hs~Ref:NM_014236.1~uORF:IOH55614	146	39	107
B13R06C20	13-20-6	Hs~Ref:NM_014236.1~uORF:IOH55614	217	61	156
B13R06C21	13-21-6	Hs~MGC:BC031413.1~uORF:IOH22724	79	36	43
B13R06C22	13-22-6	Hs~MGC:BC031413.1~uORF:IOH22724	83	36	47
B13R07C01	13-1-7	Hs~MGC:BC009507.1~uORF:IOH13554	411	38	373
B13R07C02	13-2-7	Hs~MGC:BC009507.1~uORF:IOH13554	405	38	367
B13R07C03	13-3-7	Hs~MGC:BC011635.1~uORF:IOH14421	860	35	825
B13R07C04	13-4-7	Hs~MGC:BC011635.1~uORF:IOH14421	897	38	859
B13R07C05	13-5-7	Hs~Ref:NM_033256.1~uORF:IOH13214	633	39	594
B13R07C06	13-6-7	Hs~Ref:NM_033256.1~uORF:IOH13214	657	39	618
B13R07C07	13-7-7	Hs~Ref:NM_014241.2~uORF:IOH12805	329	46	283
B13R07C08	13-8-7	Hs~Ref:NM_014241.2~uORF:IOH12805	307	88	219
B13R07C09	13-9-7	Hs~Ref:NM_016103.1~uORF:IOH5421	251	44	207
B13R07C10	13-10-7	Hs~Ref:NM_016103.1~uORF:IOH5421	287	66	221
B13R07C11	13-11-7	Hs~Ref:NM_016361.2~uORF:IOH13822	221	49	172
B13R07C12	13-12-7	Hs~Ref:NM_016361.2~uORF:IOH13822	210	41	169
B13R07C13	13-13-7	Hs~Ref:NM_000160.1~uORF:IOH39475	305	40	265
B13R07C14	13-14-7	Hs~Ref:NM_000160.1~uORF:IOH39475	300	39	261
B13R07C15	13-15-7	Hs~Ref:NM_020744.2~uORF:IOH5213	315	42	273
B13R07C16	13-16-7	Hs~Ref:NM_020744.2~uORF:IOH5213	331	40	291
B13R07C17	13-17-7	Hs~Ref:NM_005037.3~uORF:IOH39661	473	39	434
B13R07C18	13-18-7	Hs~Ref:NM_005037.3~uORF:IOH39661	508	38	470
B13R07C19	13-19-7	Hs~MGC:NM_024493.1~uORF:IOH6566	741	40	701
B13R07C20	13-20-7	Hs~MGC:NM_024493.1~uORF:IOH6566	725	42	683
B13R07C21	13-21-7	Hs~Ref:NM_003159.1~N/A	523	39	484
B13R07C22	13-22-7	Hs~Ref:NM_003159.1~N/A	513	37	476
B13R08C01	13-1-8	Hs~Ref:NM_173191.2~uORF:IOH39568	106	86	20
B13R08C02	13-2-8	Hs~Ref:NM_173191.2~uORF:IOH39568	104	43	61
B13R08C03	13-3-8	Hs~Ref:NM_015149.2~uORF:IOH39464	577	43	534
B13R08C04	13-4-8	Hs~Ref:NM_015149.2~uORF:IOH39464	576	41	535
B13R08C05	13-5-8	Hs~Ref:NM_003702.2~uORF:IOH39665	406	38	368
B13R08C06	13-6-8	Hs~Ref:NM_003702.2~uORF:IOH39665	429	41	388
B13R08C07	13-7-8	Hs~MGC:BC009262.2~uORF:IOH22956	272	129	143
B13R08C08	13-8-8	Hs~MGC:BC009262.2~uORF:IOH22956	319	48	271
B13R08C09	13-9-8	Hs~MGC:BC010434.1~uORF:IOH22935	638	40	598
B13R08C10	13-10-8	Hs~MGC:BC010434.1~uORF:IOH22935	615	38	577
B13R08C11	13-11-8	Hs~MGC:BC004292.1~uORF:IOH22899	435	41	394
B13R08C12	13-12-8	Hs~MGC:BC004292.1~uORF:IOH22899	479	41	438
B13R08C13	13-13-8	Hs~MGC:BC010432.2~uORF:IOH22933	525	42	483
B13R08C14	13-14-8	Hs~MGC:BC010432.2~uORF:IOH22933	485	42	443
B13R08C15	13-15-8	Hs~Ref:NM_033415.2~uORF:IOH45656	595	41	554
B13R08C16	13-16-8	Hs~Ref:NM_033415.2~uORF:IOH45656	581	39	542
B13R08C17	13-17-8	Hs~Ref:NM_181493.1~uORF:IOH44551	660	37	623
B13R08C18	13-18-8	Hs~Ref:NM_181493.1~uORF:IOH44551	656	38	618
B13R08C19	13-19-8	Hs~Ref:NM_024623.1~uORF:IOH44690	457	38	419
B13R08C20	13-20-8	Hs~Ref:NM_024623.1~uORF:IOH44690	477	40	437
B13R08C21	13-21-8	Hs~Ref:NM_031285.1~uORF:IOH22841	537	42	495
B13R08C22	13-22-8	Hs~Ref:NM_031285.1~uORF:IOH22841	487	37	450
B13R09C01	13-1-9	Hs~Ref:NM_000137.1~uORF:IOH4075	289	36	253
B13R09C02	13-2-9	Hs~Ref:NM_000137.1~uORF:IOH4075	314	44	270
B13R09C03	13-3-9	Hs~MGC:BC042625.1~uORF:IOH27415	368	59	309
B13R09C04	13-4-9	Hs~MGC:BC042625.1~uORF:IOH27415	361	52	309
B13R09C05	13-5-9	Hs~Ref:NM_139279.3~uORF:IOH25779	281	42	239
B13R09C06	13-6-9	Hs~Ref:NM_139279.3~uORF:IOH25779	270	39	231
B13R09C07	13-7-9	Hs~Ref:NM_018025.2~uORF:IOH6539	411	37	374
B13R09C08	13-8-9	Hs~Ref:NM_018025.2~uORF:IOH6539	417	39	378
B13R09C09	13-9-9	Hs~MGC:BC038406.1~uORF:IOH27357	334	40	294
B13R09C10	13-10-9	Hs~MGC:BC038406.1~uORF:IOH27357	319	39	280
B13R09C11	13-11-9	Hs~MGC:BC044242.1~uORF:IOH28797	297	48	249
B13R09C12	13-12-9	Hs~MGC:BC044242.1~uORF:IOH28797	330	39	291
B13R09C13	13-13-9	Hs~MGC:BC041099.1~uORF:IOH25949	329	47	282
B13R09C14	13-14-9	Hs~MGC:BC041099.1~uORF:IOH25949	345	42	303
B13R09C15	13-15-9	Hs~MGC:BC047363.1~uORF:IOH26485	312	56	256
B13R09C16	13-16-9	Hs~MGC:BC047363.1~uORF:IOH26485	313	41	272
B13R09C17	13-17-9	Hs~MGC:BC008902.2~uORF:IOH46064	7408	37	7371
B13R09C18	13-18-9	Hs~MGC:BC008902.2~uORF:IOH46064	6727	36	6691
B13R09C19	13-19-9	Hs~MGC:BC015586.2~uORF:IOH46065	622	37	585
B13R09C20	13-20-9	Hs~MGC:BC015586.2~uORF:IOH46065	588	38	550
B13R09C21	13-21-9	Hs~MGC:BC000742.2~uORF:IOH46095	159	38	121
B13R09C22	13-22-9	Hs~MGC:BC000742.2~uORF:IOH46095	212	44	168
B13R10C01	13-1-10	Hs~MGC:BC003127.1~uORF:IOH46076	255	35	220
B13R10C02	13-2-10	Hs~MGC:BC003127.1~uORF:IOH46076	246	40	206
B13R10C03	13-3-10	Hs~MGC:BC062338.1~uORF:IOH40690	6085	46	6039
B13R10C04	13-4-10	Hs~MGC:BC062338.1~uORF:IOH40690	6035	41	5994
B13R10C05	13-5-10	Hs~MGC:BC062353.1~uORF:IOH40673	595	34	561
B13R10C06	13-6-10	Hs~MGC:BC062353.1~uORF:IOH40673	556	36	520
B13R10C07	13-7-10	Hs~Ref:NM_178817.3~uORF:IOH40717	293	39	254
B13R10C08	13-8-10	Hs~Ref:NM_178817.3~uORF:IOH40717	290	42	248
B13R10C09	13-9-10	Hs~Ref:NM_013444.2~uORF:IOH40769	113	84	29
B13R10C10	13-10-10	Hs~Ref:NM_013444.2~uORF:IOH40769	112	45	67
B13R10C11	13-11-10	GST1	54	36	18
B13R10C12	13-12-10	GST1	367	39	328
B13R10C13	13-13-10	GST2	66	36	30
B13R10C14	13-14-10	GST2	69	36	33
B13R10C15	13-15-10	GST3	99	37	62
B13R10C16	13-16-10	GST3	83	43	40
B13R10C17	13-17-10	GST4	272	79	193
B13R10C18	13-18-10	GST4	151	36	115
B13R10C19	13-19-10	Anti-HumanIgA1~N/A	8398	35	8363
B13R10C20	13-20-10	Anti-HumanIgA1~N/A	8724	37	8687
B13R10C21	13-21-10	Anti-HumanIgA2~N/A	15690	38	15652
B13R10C22	13-22-10	Anti-HumanIgA2~N/A	15780	37	15743
B13R11C01	13-1-11	AlexaAntiMouseAb~N/A	23562	34	23528
B13R11C02	13-2-11	AlexaAntiMouseAb~N/A	21647	35	21612
B13R11C03	13-3-11	MAPKAP~N/A	91	43	48
B13R11C04	13-4-11	MAPKAP~N/A	160	56	104
B13R11C05	13-5-11	Buffer	244	36	208
B13R11C06	13-6-11	Buffer	241	43	198
B13R11C07	13-7-11	BSA~N/A	9219	40	9179
B13R11C08	13-8-11	BSA~N/A	9069	41	9028
B13R11C09	13-9-11	Anti-HumanIgG1~N/A	1789	44	1745
B13R11C10	13-10-11	Anti-HumanIgG1~N/A	1751	42	1709
B13R11C11	13-11-11	Anti-HumanIgG2~N/A	3351	37	3314
B13R11C12	13-12-11	Anti-HumanIgG2~N/A	3060	37	3023
B13R11C13	13-13-11	Anti-HumanIgG3~N/A	5786	35	5751
B13R11C14	13-14-11	Anti-HumanIgG3~N/A	6109	35	6074
B13R11C15	13-15-11	Anti-HumanIgG4~N/A	11535	36	11499
B13R11C16	13-16-11	Anti-HumanIgG4~N/A	11099	37	11062
B13R11C17	13-17-11	AntiBiotinAb~N/A	12522	37	12485
B13R11C18	13-18-11	AntiBiotinAb~N/A	12489	36	12453
B13R11C19	13-19-11	Buffer	49	34	15
B13R11C20	13-20-11	Buffer	56	36	20
B13R11C21	13-21-11	Hs~Ref:NM_138401.2~uORF:IOH14104	371	39	332
B13R11C22	13-22-11	Hs~Ref:NM_138401.2~uORF:IOH14104	383	35	348
B13R12C01	13-1-12	Hs~Ref:NM_014909.2~uORF:IOH27006	711	34	677
B13R12C02	13-2-12	Hs~Ref:NM_014909.2~uORF:IOH27006	766	34	732
B13R12C03	13-3-12	Hs~Ref:NM_004111.4~uORF:IOH3530	2385	35	2350
B13R12C04	13-4-12	Hs~Ref:NM_004111.4~uORF:IOH3530	2395	36	2359
B13R12C05	13-5-12	Hs~Ref:NM_006640.2~uORF:IOH12164	3279	37	3242
B13R12C06	13-6-12	Hs~Ref:NM_006640.2~uORF:IOH12164	3261	37	3224
B13R12C07	13-7-12	Hs~MGC:BC030253.1~uORF:IOH21512	426	38	388
B13R12C08	13-8-12	Hs~MGC:BC030253.1~uORF:IOH21512	441	40	401
B13R12C09	13-9-12	Hs~Ref:NM_014326.2~uORF:IOH21336	359	44	315
B13R12C10	13-10-12	Hs~Ref:NM_014326.2~uORF:IOH21336	399	111	288
B13R12C11	13-11-12	Hs~MGC:BC011392.1~uORF:IOH21419	618	42	576
B13R12C12	13-12-12	Hs~MGC:BC011392.1~uORF:IOH21419	610	36	574
B13R12C13	13-13-12	Hs~MGC:BC030776.1~uORF:IOH22290	34	33	1
B13R12C14	13-14-12	Hs~MGC:BC030776.1~uORF:IOH22290	33	32	1
B13R12C15	13-15-12	Hs~MGC:BC028141.1~uORF:IOH21529	462	35	427
B13R12C16	13-16-12	Hs~MGC:BC028141.1~uORF:IOH21529	439	36	403
B13R12C17	13-17-12	Hs~Ref:NM_022133.2~uORF:IOH21896	241	39	202
B13R12C18	13-18-12	Hs~Ref:NM_022133.2~uORF:IOH21896	262	107	155
B13R12C19	13-19-12	Hs~Ref:NM_015214.1~uORF:IOH41859	357	42	315
B13R12C20	13-20-12	Hs~Ref:NM_015214.1~uORF:IOH41859	370	39	331
B13R12C21	13-21-12	Hs~Ref:NM_014923.2~uORF:IOH44828	438	43	395
B13R12C22	13-22-12	Hs~Ref:NM_014923.2~uORF:IOH44828	412	37	375
B13R13C01	13-1-13	Hs~Ref:NM_032926.1~uORF:IOH6818	72	52	20
B13R13C02	13-2-13	Hs~Ref:NM_032926.1~uORF:IOH6818	99	51	48
B13R13C03	13-3-13	Hs~Ref:NM_032883.1~uORF:IOH6975	207	37	170
B13R13C04	13-4-13	Hs~Ref:NM_032883.1~uORF:IOH6975	132	38	94
B13R13C05	13-5-13	Hs~Ref:NM_004454.1~uORF:IOH5884	557	38	519
B13R13C06	13-6-13	Hs~Ref:NM_004454.1~uORF:IOH5884	559	37	522
B13R13C07	13-7-13	Hs~MGC:BC000594.2~uORF:IOH4296	822	36	786
B13R13C08	13-8-13	Hs~MGC:BC000594.2~uORF:IOH4296	855	36	819
B13R13C09	13-9-13	Hs~Ref:NM_004650.1~uORF:IOH54866	55	36	19
B13R13C10	13-10-13	Hs~Ref:NM_004650.1~uORF:IOH54866	50	38	12
B13R13C11	13-11-13	Hs~Ref:NM_001030007.1~uORF:IOH61132	440	37	403
B13R13C12	13-12-13	Hs~Ref:NM_001030007.1~uORF:IOH61132	417	37	380
B13R13C13	13-13-13	Hs~Ref:NM_020768.1~uORF:IOH60002	767	35	732
B13R13C14	13-14-13	Hs~Ref:NM_020768.1~uORF:IOH60002	689	34	655
B13R13C15	13-15-13	Hs~Ref:NM_019056.2~uORF:IOH59983	251	40	211
B13R13C16	13-16-13	Hs~Ref:NM_019056.2~uORF:IOH59983	281	77	204
B13R13C17	13-17-13	Hs~MGC:BC065534.1~uORF:IOH39945	668	37	631
B13R13C18	13-18-13	Hs~MGC:BC065534.1~uORF:IOH39945	627	36	591
B13R13C19	13-19-13	Hs~MGC:BC001184.1~uORF:IOH4545	780	36	744
B13R13C20	13-20-13	Hs~MGC:BC001184.1~uORF:IOH4545	817	36	781
B13R13C21	13-21-13	Hs~MGC:BC008623.1~uORF:IOH3309	491	40	451
B13R13C22	13-22-13	Hs~MGC:BC008623.1~uORF:IOH3309	443	40	403
B13R14C01	13-1-14	Hs~Ref:NM_014759.2~uORF:IOH22215	392	34	358
B13R14C02	13-2-14	Hs~Ref:NM_014759.2~uORF:IOH22215	392	34	358
B13R14C03	13-3-14	Hs~MGC:BC045639.1~uORF:IOH28733	390	36	354
B13R14C04	13-4-14	Hs~MGC:BC045639.1~uORF:IOH28733	406	37	369
B13R14C05	13-5-14	Hs~MGC:BC059386.1~uORF:IOH29132	561	35	526
B13R14C06	13-6-14	Hs~MGC:BC059386.1~uORF:IOH29132	605	35	570
B13R14C07	13-7-14	Hs~Ref:NM_003636.1~uORF:IOH29625	65535	37	65498
B13R14C08	13-8-14	Hs~Ref:NM_003636.1~uORF:IOH29625	65535	38	65497
B13R14C09	13-9-14	Hs~MGC:BC054508.1~uORF:IOH28891	446	37	409
B13R14C10	13-10-14	Hs~MGC:BC054508.1~uORF:IOH28891	447	39	408
B13R14C11	13-11-14	Hs~Ref:NM_017881.1~uORF:IOH3973	351	48	303
B13R14C12	13-12-14	Hs~Ref:NM_017881.1~uORF:IOH3973	315	39	276
B13R14C13	13-13-14	Hs~Ref:NM_016185.1~uORF:IOH4078	410	36	374
B13R14C14	13-14-14	Hs~Ref:NM_016185.1~uORF:IOH4078	401	35	366
B13R14C15	13-15-14	Hs~Ref:NM_014184.1~uORF:IOH4181	455	36	419
B13R14C16	13-16-14	Hs~Ref:NM_014184.1~uORF:IOH4181	499	37	462
B13R14C17	13-17-14	Hs~Ref:NM_002764.2~uORF:IOH4906	300	37	263
B13R14C18	13-18-14	Hs~Ref:NM_002764.2~uORF:IOH4906	340	36	304
B13R14C19	13-19-14	Hs~MGC:BC093097.1~uORF:IOH63177	20587	35	20552
B13R14C20	13-20-14	Hs~MGC:BC093097.1~uORF:IOH63177	20091	36	20055
B13R14C21	13-21-14	Hs~MGC:BC051738.1~uORF:IOH62356	215	49	166
B13R14C22	13-22-14	Hs~MGC:BC051738.1~uORF:IOH62356	121	88	33
B13R15C01	13-1-15	Hs~MGC:BC067778.1~uORF:IOH61697	232	37	195
B13R15C02	13-2-15	Hs~MGC:BC067778.1~uORF:IOH61697	254	40	214
B13R15C03	13-3-15	Hs~MGC:BC032576.1~uORF:IOH61732	283	38	245
B13R15C04	13-4-15	Hs~MGC:BC032576.1~uORF:IOH61732	281	38	243
B13R15C05	13-5-15	Hs~MGC:BC060819.1~uORF:IOH29138	329	36	293
B13R15C06	13-6-15	Hs~MGC:BC060819.1~uORF:IOH29138	309	37	272
B13R15C07	13-7-15	Hs~MGC:BC040559.1~uORF:IOH62278	353	54	299
B13R15C08	13-8-15	Hs~MGC:BC040559.1~uORF:IOH62278	337	53	284
B13R15C09	13-9-15	Hs~MGC:BC062740.1~uORF:IOH62863	548	40	508
B13R15C10	13-10-15	Hs~MGC:BC062740.1~uORF:IOH62863	564	37	527
B13R15C11	13-11-15	Hs~MGC:BC022458.1~uORF:IOH61400	408	37	371
B13R15C12	13-12-15	Hs~MGC:BC022458.1~uORF:IOH61400	400	36	364
B13R15C13	13-13-15	Hs~IVGN:NM_000584~CAT_PHC0084~N/A	49	34	15
B13R15C14	13-14-15	Hs~IVGN:NM_000584~CAT_PHC0084~N/A	59	46	13
B13R15C15	13-15-15	Hs~Ref:NM_014397.2~CAT:PV3353	1144	35	1109
B13R15C16	13-16-15	Hs~Ref:NM_014397.2~CAT:PV3353	1135	34	1101
B13R15C17	13-17-15	Hs~Ref:NM_002744.2~CAT:P2268	1039	34	1005
B13R15C18	13-18-15	Hs~Ref:NM_002744.2~CAT:P2268	1002	35	967
B13R15C19	13-19-15	Hs~Ref:NM_015981.1~CAT:PV3142	348	35	313
B13R15C20	13-20-15	Hs~Ref:NM_015981.1~CAT:PV3142	359	35	324
B13R15C21	13-21-15	Hs~N/A:NM_005228.3~CAT:PV4128	234	41	193
B13R15C22	13-22-15	Hs~N/A:NM_005228.3~CAT:PV4128	192	41	151
B13R16C01	13-1-16	Hs~Ref:NM_000245.2~CAT:PV3143	142	49	93
B13R16C02	13-2-16	Hs~Ref:NM_000245.2~CAT:PV3143	77	40	37
B13R16C03	13-3-16	Hs~Ref:NM_002227.1~CAT:PV4774	188	81	107
B13R16C04	13-4-16	Hs~Ref:NM_002227.1~CAT:PV4774	168	102	66
B13R16C05	13-5-16	Hs~MGC:NM_000461.3~CAT:PV4764	105	35	70
B13R16C06	13-6-16	Hs~MGC:NM_000461.3~CAT:PV4764	123	84	39
B13R16C07	13-7-16	Hs~MGC:BC092477.1~uORF:IOH62628	1295	38	1257
B13R16C08	13-8-16	Hs~MGC:BC092477.1~uORF:IOH62628	1386	39	1347
B13R16C09	13-9-16	Hs~MGC:BC092404.1~uORF:IOH62574	3409	39	3370
B13R16C10	13-10-16	Hs~MGC:BC092404.1~uORF:IOH62574	3517	37	3480
B13R16C11	13-11-16	Hs~MGC:BC099626.2~uORF:IOH63203	345	38	307
B13R16C12	13-12-16	Hs~MGC:BC099626.2~uORF:IOH63203	323	37	286
B13R16C13	13-13-16	Hs~MGC:BC064965.1~uORF:IOH61592	383	36	347
B13R16C14	13-14-16	Hs~MGC:BC064965.1~uORF:IOH61592	403	37	366
B13R16C15	13-15-16	Hs~MGC:BC054049.2~uORF:IOH29102	436	36	400
B13R16C16	13-16-16	Hs~MGC:BC054049.2~uORF:IOH29102	467	36	431
B13R16C17	13-17-16	Hs~Ref:NM_181705.1~uORF:IOH26509	509	36	473
B13R16C18	13-18-16	Hs~Ref:NM_181705.1~uORF:IOH26509	508	36	472
B13R16C19	13-19-16	Hs~Ref:NM_002931.3~uORF:IOH27050	872	36	836
B13R16C20	13-20-16	Hs~Ref:NM_002931.3~uORF:IOH27050	793	37	756
B13R16C21	13-21-16	Hs~Ref:NM_173665.1~uORF:IOH27294	578	39	539
B13R16C22	13-22-16	Hs~Ref:NM_173665.1~uORF:IOH27294	549	37	512
B13R17C01	13-1-17	Hs~Ref:NM_015679.1~uORF:IOH4013	954	35	919
B13R17C02	13-2-17	Hs~Ref:NM_015679.1~uORF:IOH4013	934	39	895
B13R17C03	13-3-17	Hs~Ref:NM_014583.2~uORF:IOH4194	449	52	397
B13R17C04	13-4-17	Hs~Ref:NM_014583.2~uORF:IOH4194	493	44	449
B13R17C05	13-5-17	Hs~MGC:BC010741.1~uORF:IOH9986	742	34	708
B13R17C06	13-6-17	Hs~MGC:BC010741.1~uORF:IOH9986	711	35	676
B13R17C07	13-7-17	Hs~MGC:BC007252.1~uORF:IOH6830	613	35	578
B13R17C08	13-8-17	Hs~MGC:BC007252.1~uORF:IOH6830	561	38	523
B13R17C09	13-9-17	Hs~MGC:BC064937.1~uORF:IOH61600	368	39	329
B13R17C10	13-10-17	Hs~MGC:BC064937.1~uORF:IOH61600	401	37	364
B13R17C11	13-11-17	Hs~MGC:BC061924.1~uORF:IOH62453	279	36	243
B13R17C12	13-12-17	Hs~MGC:BC061924.1~uORF:IOH62453	238	57	181
B13R17C13	13-13-17	Hs~MGC:BC025766.1~uORF:IOH61723	387	39	348
B13R17C14	13-14-17	Hs~MGC:BC025766.1~uORF:IOH61723	298	40	258
B13R17C15	13-15-17	Hs~MGC:BC071651.1~uORF:IOH61799	200	39	161
B13R17C16	13-16-17	Hs~MGC:BC071651.1~uORF:IOH61799	335	51	284
B13R17C17	13-17-17	Hs~Ref:NM_016283.2~uORF:IOH5842	299	38	261
B13R17C18	13-18-17	Hs~Ref:NM_016283.2~uORF:IOH5842	343	43	300
B13R17C19	13-19-17	Hs~Ref:NM_033019.1~uORF:IOH6258	1419	39	1380
B13R17C20	13-20-17	Hs~Ref:NM_033019.1~uORF:IOH6258	1423	37	1386
B13R17C21	13-21-17	Hs~Ref:NM_002045.1~uORF:IOH6708	6506	38	6468
B13R17C22	13-22-17	Hs~Ref:NM_002045.1~uORF:IOH6708	6437	36	6401
B13R18C01	13-1-18	Hs~MGC:BC008374.1~uORF:IOH7134	312	34	278
B13R18C02	13-2-18	Hs~MGC:BC008374.1~uORF:IOH7134	357	36	321
B13R18C03	13-3-18	Hs~MGC:BC039306.1~uORF:IOH27482	465	38	427
B13R18C04	13-4-18	Hs~MGC:BC039306.1~uORF:IOH27482	466	36	430
B13R18C05	13-5-18	Hs~MGC:BC001651.1~uORF:IOH3740	490	37	453
B13R18C06	13-6-18	Hs~MGC:BC001651.1~uORF:IOH3740	395	36	359
B13R18C07	13-7-18	Hs~Ref:NM_003885.1~uORF:IOH11747	460	37	423
B13R18C08	13-8-18	Hs~Ref:NM_003885.1~uORF:IOH11747	492	43	449
B13R18C09	13-9-18	Hs~Ref:NM_214461.1~uORF:IOH26301	232	50	182
B13R18C10	13-10-18	Hs~Ref:NM_214461.1~uORF:IOH26301	273	133	140
B13R18C11	13-11-18	Hs~Ref:NM_004175.3~uORF:IOH56705	432	37	395
B13R18C12	13-12-18	Hs~Ref:NM_004175.3~uORF:IOH56705	423	37	386
B13R18C13	13-13-18	Hs~Ref:NM_025222.2~uORF:IOH57223	327	83	244
B13R18C14	13-14-18	Hs~Ref:NM_025222.2~uORF:IOH57223	254	39	215
B13R18C15	13-15-18	Hs~MGC:BC008913.2~uORF:IOH57002	294	62	232
B13R18C16	13-16-18	Hs~MGC:BC008913.2~uORF:IOH57002	393	83	310
B13R18C17	13-17-18	Hs~Ref:NM_015049.1~uORF:IOH55746	484	49	435
B13R18C18	13-18-18	Hs~Ref:NM_015049.1~uORF:IOH55746	546	48	498
B13R18C19	13-19-18	Hs~Ref:NM_016735.1~N/A	443	38	405
B13R18C20	13-20-18	Hs~Ref:NM_016735.1~N/A	462	39	423
B13R18C21	13-21-18	Hs~Ref:NM_006201.2~N/A	340	39	301
B13R18C22	13-22-18	Hs~Ref:NM_006201.2~N/A	370	39	331
B13R19C01	13-1-19	Hs~Ref:NM_005012.1~N/A	294	35	259
B13R19C02	13-2-19	Hs~Ref:NM_005012.1~N/A	366	44	322
B13R19C03	13-3-19	Hs~Ref:NM_005607.1~N/A	422	46	376
B13R19C04	13-4-19	Hs~Ref:NM_005607.1~N/A	392	45	347
B13R19C05	13-5-19	Hs~MGC:BC004932.1~uORF:IOH5521	283	46	237
B13R19C06	13-6-19	Hs~MGC:BC004932.1~uORF:IOH5521	265	38	227
B13R19C07	13-7-19	Hs~MGC:BC037854.1~uORF:IOH27633	310	54	256
B13R19C08	13-8-19	Hs~MGC:BC037854.1~uORF:IOH27633	288	171	117
B13R19C09	13-9-19	Hs~Ref:NM_004466.3~uORF:IOH26127	188	58	130
B13R19C10	13-10-19	Hs~Ref:NM_004466.3~uORF:IOH26127	196	51	145
B13R19C11	13-11-19	Hs~MGC:BC039582.1~uORF:IOH26251	207	42	165
B13R19C12	13-12-19	Hs~MGC:BC039582.1~uORF:IOH26251	215	38	177
B13R19C13	13-13-19	Hs~Ref:NM_022076.2~uORF:IOH42893	778	40	738
B13R19C14	13-14-19	Hs~Ref:NM_022076.2~uORF:IOH42893	790	38	752
B13R19C15	13-15-19	Hs~Ref:XM_374177.2~uORF:IOH43615	6938	40	6898
B13R19C16	13-16-19	Hs~Ref:XM_374177.2~uORF:IOH43615	6871	44	6827
B13R19C17	13-17-19	Hs~Ref:NM_001009880.1~uORF:IOH42078	11862	56	11806
B13R19C18	13-18-19	Hs~Ref:NM_001009880.1~uORF:IOH42078	11448	47	11401
B13R19C19	13-19-19	Hs~Ref:NM_019854.2~uORF:IOH11043	173	40	133
B13R19C20	13-20-19	Hs~Ref:NM_019854.2~uORF:IOH11043	255	45	210
B13R19C21	13-21-19	Hs~MGC:BC036029.1~uORF:IOH27232	418	37	381
B13R19C22	13-22-19	Hs~MGC:BC036029.1~uORF:IOH27232	445	36	409
B13R20C01	13-1-20	Hs~MGC:AB065662.1~uORF:IOH28287	433	35	398
B13R20C02	13-2-20	Hs~MGC:AB065662.1~uORF:IOH28287	502	41	461
B13R20C03	13-3-20	Hs~Ref:NM_139169.2~uORF:IOH22254	877	48	829
B13R20C04	13-4-20	Hs~Ref:NM_139169.2~uORF:IOH22254	898	42	856
B13R20C05	13-5-20	Hs~MGC:BC034954.2~uORF:IOH26830	777	37	740
B13R20C06	13-6-20	Hs~MGC:BC034954.2~uORF:IOH26830	753	37	716
B13R20C07	13-7-20	Hs~MGC:BC015813.1~uORF:IOH10085	392	38	354
B13R20C08	13-8-20	Hs~MGC:BC015813.1~uORF:IOH10085	392	49	343
B13R20C09	13-9-20	Hs~Ref:NM_023937.1~uORF:IOH4594	483	61	422
B13R20C10	13-10-20	Hs~Ref:NM_023937.1~uORF:IOH4594	475	48	427
B13R20C11	13-11-20	Hs~MGC:BC007609.1~uORF:IOH6912	35	35	0
B13R20C12	13-12-20	Hs~MGC:BC007609.1~uORF:IOH6912	35	36	-1
B13R20C13	13-13-20	Hs~MGC:BC014975.1~uORF:IOH14285	367	38	329
B13R20C14	13-14-20	Hs~MGC:BC014975.1~uORF:IOH14285	396	39	357
B13R20C15	13-15-20	Hs~MGC:NM_175883.2~uORF:IOH28444	154	40	114
B13R20C16	13-16-20	Hs~MGC:NM_175883.2~uORF:IOH28444	275	40	235
B13R20C17	13-17-20	Hs~Ref:NM_012360.1~uORF:IOH28397	235	67	168
B13R20C18	13-18-20	Hs~Ref:NM_012360.1~uORF:IOH28397	242	68	174
B13R20C19	13-19-20	Hs~MGC:BC052614.1~uORF:IOH29388	307	39	268
B13R20C20	13-20-20	Hs~MGC:BC052614.1~uORF:IOH29388	307	42	265
B13R20C21	13-21-20	Hs~ENS:ENST00000312345~uORF:IOH28302	280	50	230
B13R20C22	13-22-20	Hs~ENS:ENST00000312345~uORF:IOH28302	406	41	365
B13R21C01	13-1-21	Hs~Ref:NM_006626.3~uORF:IOH27148	152	44	108
B13R21C02	13-2-21	Hs~Ref:NM_006626.3~uORF:IOH27148	270	65	205
B13R21C03	13-3-21	Hs~MGC:BC023527.2~uORF:IOH29316	121	35	86
B13R21C04	13-4-21	Hs~MGC:BC023527.2~uORF:IOH29316	217	43	174
B13R21C05	13-5-21	Hs~MGC:BC047943.1~uORF:IOH28793	160	90	70
B13R21C06	13-6-21	Hs~MGC:BC047943.1~uORF:IOH28793	194	44	150
B13R21C07	13-7-21	Hs~MGC:BC023655.2~uORF:IOH27943	100	36	64
B13R21C08	13-8-21	Hs~MGC:BC023655.2~uORF:IOH27943	141	70	71
B13R21C09	13-9-21	Hs~Ref:NP_002174.1~CAT_10518-H03H-25	3894	49	3845
B13R21C10	13-10-21	Hs~Ref:NP_002174.1~CAT_10518-H03H-25	3818	43	3775
B13R21C11	13-11-21	Internal_1007209	60	36	24
B13R21C12	13-12-21	Internal_1007209	59	35	24
B13R21C13	13-13-21	Hs~Ref:NP_002847.1~CAT_10005-H08H-25	43	35	8
B13R21C14	13-14-21	Hs~Ref:NP_002847.1~CAT_10005-H08H-25	64	40	24
B13R21C15	13-15-21	Internal_1007209	52	38	14
B13R21C16	13-16-21	Internal_1007209	42	36	6
B13R21C17	13-17-21	Hs~Ref:NP_001108225.1~CAT_10149-H02H-25	3270	37	3233
B13R21C18	13-18-21	Hs~Ref:NP_001108225.1~CAT_10149-H02H-25	3443	38	3405
B13R21C19	13-19-21	Internal_1007209	1452	37	1415
B13R21C20	13-20-21	Internal_1007209	1432	37	1395
B13R21C21	13-21-21	Hs~Ref:NM001200~CAT_PHC7146	9475	39	9436
B13R21C22	13-22-21	Hs~Ref:NM001200~CAT_PHC7146	9043	38	9005
B13R22C01	13-1-22	ERa~N/A	2543	35	2508
B13R22C02	13-2-22	ERa~N/A	2609	34	2575
B13R22C03	13-3-22	PKCeta~N/A	336	34	302
B13R22C04	13-4-22	PKCeta~N/A	301	35	266
B13R22C05	13-5-22	Calmodulin~N/A	234	51	183
B13R22C06	13-6-22	Calmodulin~N/A	218	38	180
B13R22C07	13-7-22	V5control5~N/A	885	34	851
B13R22C08	13-8-22	V5control5~N/A	898	35	863
B13R22C09	13-9-22	V5control4~N/A	130	42	88
B13R22C10	13-10-22	V5control4~N/A	187	45	142
B13R22C11	13-11-22	V5control3~N/A	113	48	65
B13R22C12	13-12-22	V5control3~N/A	135	70	65
B13R22C13	13-13-22	V5control2~N/A	72	35	37
B13R22C14	13-14-22	V5control2~N/A	83	50	33
B13R22C15	13-15-22	V5control1~N/A	52	36	16
B13R22C16	13-16-22	V5control1~N/A	944	36	908
B13R22C17	13-17-22	CMK2A~N/A	645	36	609
B13R22C18	13-18-22	CMK2A~N/A	681	35	646
B13R22C19	13-19-22	ERa~N/A	2050	36	2014
B13R22C20	13-20-22	ERa~N/A	2030	36	1994
B13R22C21	13-21-22	AlexaAntiMouseAb~N/A	10293	37	10256
B13R22C22	13-22-22	AlexaAntiMouseAb~N/A	9433	37	9396
B14R01C01	14-1-1	AlexaAntiMouseAb~N/A	40945	37	40908
B14R01C02	14-2-1	AlexaAntiMouseAb~N/A	36852	36	36816
B14R01C03	14-3-1	ERa~N/A	1716	36	1680
B14R01C04	14-4-1	ERa~N/A	1770	37	1733
B14R01C05	14-5-1	HumanIgG1~N/A	779	38	741
B14R01C06	14-6-1	HumanIgG1~N/A	1078	46	1032
B14R01C07	14-7-1	HumanIgG2~N/A	2132	51	2081
B14R01C08	14-8-1	HumanIgG2~N/A	2575	46	2529
B14R01C09	14-9-1	HumanIgG3~N/A	14725	56	14669
B14R01C10	14-10-1	HumanIgG3~N/A	18274	60	18214
B14R01C11	14-11-1	HumanIgG4~N/A	39778	58	39720
B14R01C12	14-12-1	HumanIgG4~N/A	44971	52	44919
B14R01C13	14-13-1	BiotinAb~N/A	365	46	319
B14R01C14	14-14-1	BiotinAb~N/A	324	42	282
B14R01C15	14-15-1	RanBP2deltaFG~N/A	87	43	44
B14R01C16	14-16-1	RanBP2deltaFG~N/A	268	54	214
B14R01C17	14-17-1	hMDM2~N/A	774	41	733
B14R01C18	14-18-1	hMDM2~N/A	744	39	705
B14R01C19	14-19-1	PKCeta~N/A	533	37	496
B14R01C20	14-20-1	PKCeta~N/A	526	38	488
B14R01C21	14-21-1	AlexaAntiMouseAb~N/A	38582	40	38542
B14R01C22	14-22-1	AlexaAntiMouseAb~N/A	40132	40	40092
B14R02C01	14-1-2	PKCeta~N/A	1644	38	1606
B14R02C02	14-2-2	PKCeta~N/A	1999	38	1961
B14R02C03	14-3-2	Buffer	248	39	209
B14R02C04	14-4-2	Buffer	353	230	123
B14R02C05	14-5-2	HumanIgA~N/A	21947	42	21905
B14R02C06	14-6-2	HumanIgA~N/A	22440	48	22392
B14R02C07	14-7-2	Buffer	120	53	67
B14R02C08	14-8-2	Buffer	105	43	62
B14R02C09	14-9-2	BSA~N/A	13203	51	13152
B14R02C10	14-10-2	BSA~N/A	13679	64	13615
B14R02C11	14-11-2	Hs~Ref:NM_080548.1~uORF:IOH4085	1154	63	1091
B14R02C12	14-12-2	Hs~Ref:NM_080548.1~uORF:IOH4085	1135	53	1082
B14R02C13	14-13-2	Hs~Ref:NM_022756.2~uORF:IOH13235	804	55	749
B14R02C14	14-14-2	Hs~Ref:NM_022756.2~uORF:IOH13235	857	53	804
B14R02C15	14-15-2	Hs~MGC:BC008375.1~uORF:IOH7243	696	54	642
B14R02C16	14-16-2	Hs~MGC:BC008375.1~uORF:IOH7243	956	46	910
B14R02C17	14-17-2	Hs~MGC:BC028675.1~uORF:IOH23010	756	39	717
B14R02C18	14-18-2	Hs~MGC:BC028675.1~uORF:IOH23010	700	38	662
B14R02C19	14-19-2	Hs~MGC:BC000313.1~uORF:IOH3491	657	39	618
B14R02C20	14-20-2	Hs~MGC:BC000313.1~uORF:IOH3491	661	40	621
B14R02C21	14-21-2	Hs~MGC:BC019909.1~uORF:IOH12023	721	42	679
B14R02C22	14-22-2	Hs~MGC:BC019909.1~uORF:IOH12023	703	41	662
B14R03C01	14-1-3	Hs~Ref:NM_006788.2~uORF:IOH10874	1075	39	1036
B14R03C02	14-2-3	Hs~Ref:NM_006788.2~uORF:IOH10874	1102	39	1063
B14R03C03	14-3-3	Hs~MGC:BC014133.1~uORF:IOH12958	514	40	474
B14R03C04	14-4-3	Hs~MGC:BC014133.1~uORF:IOH12958	486	41	445
B14R03C05	14-5-3	Hs~Ref:NM_016152.2~uORF:IOH36705	143	41	102
B14R03C06	14-6-3	Hs~Ref:NM_016152.2~uORF:IOH36705	139	46	93
B14R03C07	14-7-3	Hs~Ref:NM_005975.2~uORF:IOH37738	622	76	546
B14R03C08	14-8-3	Hs~Ref:NM_005975.2~uORF:IOH37738	794	307	487
B14R03C09	14-9-3	Hs~Ref:NM_198467.1~uORF:IOH40427	380	61	319
B14R03C10	14-10-3	Hs~Ref:NM_198467.1~uORF:IOH40427	464	146	318
B14R03C11	14-11-3	Hs~Ref:NM_194289.1~uORF:IOH40643	356	134	222
B14R03C12	14-12-3	Hs~Ref:NM_194289.1~uORF:IOH40643	158	61	97
B14R03C13	14-13-3	Hs~Ref:NM_198287.1~uORF:IOH41021	243	80	163
B14R03C14	14-14-3	Hs~Ref:NM_198287.1~uORF:IOH41021	86	50	36
B14R03C15	14-15-3	Hs~Ref:NM_173080.1~uORF:IOH34934	578	47	531
B14R03C16	14-16-3	Hs~Ref:NM_173080.1~uORF:IOH34934	829	62	767
B14R03C17	14-17-3	Hs~Ref:NM_170713.1~uORF:IOH40971	236	47	189
B14R03C18	14-18-3	Hs~Ref:NM_170713.1~uORF:IOH40971	56	39	17
B14R03C19	14-19-3	Hs~Ref:NM_080827.1~uORF:IOH34944	164	44	120
B14R03C20	14-20-3	Hs~Ref:NM_080827.1~uORF:IOH34944	114	48	66
B14R03C21	14-21-3	Hs~MGC:BC032775.1~uORF:IOH21765	310	44	266
B14R03C22	14-22-3	Hs~MGC:BC032775.1~uORF:IOH21765	312	42	270
B14R04C01	14-1-4	Hs~MGC:BC002940.1~uORF:IOH5740	307	39	268
B14R04C02	14-2-4	Hs~MGC:BC002940.1~uORF:IOH5740	300	42	258
B14R04C03	14-3-4	Hs~MGC:BC031052.1~uORF:IOH22518	341	41	300
B14R04C04	14-4-4	Hs~MGC:BC031052.1~uORF:IOH22518	352	37	315
B14R04C05	14-5-4	Hs~MGC:BC012888.1~uORF:IOH11770	206	38	168
B14R04C06	14-6-4	Hs~MGC:BC012888.1~uORF:IOH11770	212	40	172
B14R04C07	14-7-4	Hs~Ref:NM_002927.3~uORF:IOH11040	536	51	485
B14R04C08	14-8-4	Hs~Ref:NM_002927.3~uORF:IOH11040	466	52	414
B14R04C09	14-9-4	Hs~Ref:NM_003874.1~uORF:IOH11227	362	54	308
B14R04C10	14-10-4	Hs~Ref:NM_003874.1~uORF:IOH11227	355	65	290
B14R04C11	14-11-4	Hs~Ref:NM_013401.2~uORF:IOH10925	490	141	349
B14R04C12	14-12-4	Hs~Ref:NM_013401.2~uORF:IOH10925	514	459	55
B14R04C13	14-13-4	Hs~Ref:NM_002362.2~uORF:IOH11259	201	57	144
B14R04C14	14-14-4	Hs~Ref:NM_002362.2~uORF:IOH11259	179	54	125
B14R04C15	14-15-4	Hs~Ref:NM_181837.1~uORF:IOH38202	253	43	210
B14R04C16	14-16-4	Hs~Ref:NM_181837.1~uORF:IOH38202	275	41	234
B14R04C17	14-17-4	Hs~MGC:BC060770.1~uORF:IOH29229	234	74	160
B14R04C18	14-18-4	Hs~MGC:BC060770.1~uORF:IOH29229	283	42	241
B14R04C19	14-19-4	Hs~Ref:NM_176824.1~uORF:IOH38205	300	41	259
B14R04C20	14-20-4	Hs~Ref:NM_176824.1~uORF:IOH38205	314	43	271
B14R04C21	14-21-4	Hs~Ref:NM_007368.2~uORF:IOH25931	869	43	826
B14R04C22	14-22-4	Hs~Ref:NM_007368.2~uORF:IOH25931	993	42	951
B14R05C01	14-1-5	Hs~MGC:BC017781.1~uORF:IOH12143	796	38	758
B14R05C02	14-2-5	Hs~MGC:BC017781.1~uORF:IOH12143	777	47	730
B14R05C03	14-3-5	Hs~Ref:NM_032861.2~uORF:IOH29307	332	56	276
B14R05C04	14-4-5	Hs~Ref:NM_032861.2~uORF:IOH29307	274	47	227
B14R05C05	14-5-5	Hs~Ref:NM_133332.1~uORF:IOH38113	447	39	408
B14R05C06	14-6-5	Hs~Ref:NM_133332.1~uORF:IOH38113	475	39	436
B14R05C07	14-7-5	Hs~MGC:BC036319.1~uORF:IOH27661	387	51	336
B14R05C08	14-8-5	Hs~MGC:BC036319.1~uORF:IOH27661	380	73	307
B14R05C09	14-9-5	Hs~Ref:NM_005884.2~N/A	1423	55	1368
B14R05C10	14-10-5	Hs~Ref:NM_005884.2~N/A	1405	65	1340
B14R05C11	14-11-5	Hs~Ref:NM_016735.1~N/A	688	565	123
B14R05C12	14-12-5	Hs~Ref:NM_016735.1~N/A	711	60	651
B14R05C13	14-13-5	Hs~Ref:NM_001893.3~N/A	710	49	661
B14R05C14	14-14-5	Hs~Ref:NM_001893.3~N/A	652	44	608
B14R05C15	14-15-5	Hs~Ref:NM_002752.3~N/A	410	56	354
B14R05C16	14-16-5	Hs~Ref:NM_002752.3~N/A	45	50	-5
B14R05C17	14-17-5	Hs~Ref:NM_003561.1~uORF:IOH40301	730	480	250
B14R05C18	14-18-5	Hs~Ref:NM_003561.1~uORF:IOH40301	545	43	502
B14R05C19	14-19-5	Hs~Ref:NM_207331.1~uORF:IOH40118	604	42	562
B14R05C20	14-20-5	Hs~Ref:NM_207331.1~uORF:IOH40118	618	43	575
B14R05C21	14-21-5	Hs~Ref:NM_000394.2~uORF:IOH40243	683	43	640
B14R05C22	14-22-5	Hs~Ref:NM_000394.2~uORF:IOH40243	792	43	749
B14R06C01	14-1-6	Hs~Ref:NM_002578.1~N/A	581	37	544
B14R06C02	14-2-6	Hs~Ref:NM_002578.1~N/A	559	46	513
B14R06C03	14-3-6	Hs~MGC:BC018060.1~uORF:IOH11303	1163	57	1106
B14R06C04	14-4-6	Hs~MGC:BC018060.1~uORF:IOH11303	1132	48	1084
B14R06C05	14-5-6	Hs~Ref:NM_001307.1~uORF:IOH4602	695	39	656
B14R06C06	14-6-6	Hs~Ref:NM_001307.1~uORF:IOH4602	702	38	664
B14R06C07	14-7-6	Hs~Ref:NM_002881.1~uORF:IOH11519	705	65	640
B14R06C08	14-8-6	Hs~Ref:NM_002881.1~uORF:IOH11519	844	87	757
B14R06C09	14-9-6	Hs~Ref:NM_016364.2~uORF:IOH12214	1536	59	1477
B14R06C10	14-10-6	Hs~Ref:NM_016364.2~uORF:IOH12214	1541	61	1480
B14R06C11	14-11-6	Hs~Ref:NM_001005360.1~uORF:IOH53617	488	58	430
B14R06C12	14-12-6	Hs~Ref:NM_001005360.1~uORF:IOH53617	454	52	402
B14R06C13	14-13-6	Hs~Ref:NM_173698.1~uORF:IOH59790	2335	50	2285
B14R06C14	14-14-6	Hs~Ref:NM_173698.1~uORF:IOH59790	2450	45	2405
B14R06C15	14-15-6	Hs~Ref:NM_001004332.1~uORF:IOH59656	328	81	247
B14R06C16	14-16-6	Hs~Ref:NM_001004332.1~uORF:IOH59656	179	48	131
B14R06C17	14-17-6	Hs~Ref:NM_001003712.1~uORF:IOH52892	891	42	849
B14R06C18	14-18-6	Hs~Ref:NM_001003712.1~uORF:IOH52892	834	42	792
B14R06C19	14-19-6	Hs~Ref:NM_148957.2~uORF:IOH26603	500	45	455
B14R06C20	14-20-6	Hs~Ref:NM_148957.2~uORF:IOH26603	457	43	414
B14R06C21	14-21-6	Hs~Ref:NM_138342.2~uORF:IOH25758	301	41	260
B14R06C22	14-22-6	Hs~Ref:NM_138342.2~uORF:IOH25758	72	49	23
B14R07C01	14-1-7	Hs~Ref:NM_018960.4~uORF:IOH21907	330	37	293
B14R07C02	14-2-7	Hs~Ref:NM_018960.4~uORF:IOH21907	347	46	301
B14R07C03	14-3-7	Hs~MGC:BC031556.1~uORF:IOH27349	503	47	456
B14R07C04	14-4-7	Hs~MGC:BC031556.1~uORF:IOH27349	366	43	323
B14R07C05	14-5-7	Hs~Ref:NM_002265.3~uORF:IOH4406	206	37	169
B14R07C06	14-6-7	Hs~Ref:NM_002265.3~uORF:IOH4406	190	39	151
B14R07C07	14-7-7	Hs~Ref:NM_000846.3~uORF:IOH5711	371	63	308
B14R07C08	14-8-7	Hs~Ref:NM_000846.3~uORF:IOH5711	320	82	238
B14R07C09	14-9-7	Hs~MGC:BC003152.1~uORF:IOH5139	312	68	244
B14R07C10	14-10-7	Hs~MGC:BC003152.1~uORF:IOH5139	211	67	144
B14R07C11	14-11-7	Hs~Ref:NM_134425.1~uORF:IOH11026	305	90	215
B14R07C12	14-12-7	Hs~Ref:NM_134425.1~uORF:IOH11026	309	69	240
B14R07C13	14-13-7	Hs~MGC:BC015202.1~uORF:IOH9835	537	53	484
B14R07C14	14-14-7	Hs~MGC:BC015202.1~uORF:IOH9835	496	55	441
B14R07C15	14-15-7	Hs~MGC:BC012981.2~uORF:IOH13857	386	45	341
B14R07C16	14-16-7	Hs~MGC:BC012981.2~uORF:IOH13857	320	42	278
B14R07C17	14-17-7	Hs~MGC:BC012782.2~uORF:IOH13955	490	42	448
B14R07C18	14-18-7	Hs~MGC:BC012782.2~uORF:IOH13955	409	42	367
B14R07C19	14-19-7	Hs~Ref:NM_006233.3~uORF:IOH13698	393	74	319
B14R07C20	14-20-7	Hs~Ref:NM_006233.3~uORF:IOH13698	113	78	35
B14R07C21	14-21-7	Hs~Ref:NM_004177.3~uORF:IOH5893	242	44	198
B14R07C22	14-22-7	Hs~Ref:NM_004177.3~uORF:IOH5893	156	42	114
B14R08C01	14-1-8	Hs~MGC:BC019266.1~uORF:IOH13740	217	37	180
B14R08C02	14-2-8	Hs~MGC:BC019266.1~uORF:IOH13740	206	106	100
B14R08C03	14-3-8	Hs~Ref:NM_005356.2~N/A	374	241	133
B14R08C04	14-4-8	Hs~Ref:NM_005356.2~N/A	284	60	224
B14R08C05	14-5-8	Hs~Ref:NM_005204.2~N/A	300	43	257
B14R08C06	14-6-8	Hs~Ref:NM_005204.2~N/A	285	42	243
B14R08C07	14-7-8	Hs~Ref:NM_004712.3~uORF:IOH4952	455	56	399
B14R08C08	14-8-8	Hs~Ref:NM_004712.3~uORF:IOH4952	581	87	494
B14R08C09	14-9-8	Hs~MGC:BC002955.1~uORF:IOH4931	3720	64	3656
B14R08C10	14-10-8	Hs~MGC:BC002955.1~uORF:IOH4931	3897	71	3826
B14R08C11	14-11-8	Hs~Ref:NM_002749.2~uORF:IOH13115	830	127	703
B14R08C12	14-12-8	Hs~Ref:NM_002749.2~uORF:IOH13115	854	85	769
B14R08C13	14-13-8	Hs~MGC:BC033178.1~uORF:IOH23236	65535	50	65485
B14R08C14	14-14-8	Hs~MGC:BC033178.1~uORF:IOH23236	65535	44	65491
B14R08C15	14-15-8	Hs~Ref:NM_139317.1~uORF:IOH44697	854	43	811
B14R08C16	14-16-8	Hs~Ref:NM_139317.1~uORF:IOH44697	803	43	760
B14R08C17	14-17-8	Hs~Ref:NM_018841.3~uORF:IOH57343	568	42	526
B14R08C18	14-18-8	Hs~Ref:NM_018841.3~uORF:IOH57343	566	41	525
B14R08C19	14-19-8	Hs~Ref:NM_005805.2~uORF:IOH40112	755	42	713
B14R08C20	14-20-8	Hs~Ref:NM_005805.2~uORF:IOH40112	799	42	757
B14R08C21	14-21-8	Hs~Ref:NM_001008917.1~uORF:IOH50160	577	42	535
B14R08C22	14-22-8	Hs~Ref:NM_001008917.1~uORF:IOH50160	279	43	236
B14R09C01	14-1-9	Hs~Ref:NM_153453.1~uORF:IOH59895	221	43	178
B14R09C02	14-2-9	Hs~Ref:NM_153453.1~uORF:IOH59895	267	56	211
B14R09C03	14-3-9	Hs~Ref:NM_004069.3~uORF:IOH58971	175	41	134
B14R09C04	14-4-9	Hs~Ref:NM_004069.3~uORF:IOH58971	255	51	204
B14R09C05	14-5-9	Hs~Ref:NM_003135.1~uORF:IOH59899	463	44	419
B14R09C06	14-6-9	Hs~Ref:NM_003135.1~uORF:IOH59899	461	40	421
B14R09C07	14-7-9	Hs~Ref:NM_018973.3~uORF:IOH58681	177	39	138
B14R09C08	14-8-9	Hs~Ref:NM_018973.3~uORF:IOH58681	228	62	166
B14R09C09	14-9-9	Hs~Ref:NM_000114.2~uORF:IOH57032	215	88	127
B14R09C10	14-10-9	Hs~Ref:NM_000114.2~uORF:IOH57032	255	96	159
B14R09C11	14-11-9	Hs~MGC:BC007709.1~uORF:IOH57301	556	129	427
B14R09C12	14-12-9	Hs~MGC:BC007709.1~uORF:IOH57301	388	54	334
B14R09C13	14-13-9	Hs~Ref:NM_006411.2~uORF:IOH56715	148	42	106
B14R09C14	14-14-9	Hs~Ref:NM_006411.2~uORF:IOH56715	141	40	101
B14R09C15	14-15-9	Hs~Ref:NM_005197.2~uORF:IOH56874	883	41	842
B14R09C16	14-16-9	Hs~Ref:NM_005197.2~uORF:IOH56874	891	41	850
B14R09C17	14-17-9	Hs~MGC:BC002606.1~uORF:IOH4132	435	42	393
B14R09C18	14-18-9	Hs~MGC:BC002606.1~uORF:IOH4132	511	44	467
B14R09C19	14-19-9	Hs~Ref:NM_138775.1~uORF:IOH10820	326	139	187
B14R09C20	14-20-9	Hs~Ref:NM_138775.1~uORF:IOH10820	247	82	165
B14R09C21	14-21-9	Hs~Ref:NM_002119.1~uORF:IOH10959	452	76	376
B14R09C22	14-22-9	Hs~Ref:NM_002119.1~uORF:IOH10959	47	56	-9
B14R10C01	14-1-10	Hs~Ref:NM_004286.2~uORF:IOH14552	4063	37	4026
B14R10C02	14-2-10	Hs~Ref:NM_004286.2~uORF:IOH14552	3982	38	3944
B14R10C03	14-3-10	Hs~Ref:NM_199415.1~uORF:IOH26936	8086	37	8049
B14R10C04	14-4-10	Hs~Ref:NM_199415.1~uORF:IOH26936	8250	40	8210
B14R10C05	14-5-10	Hs~Ref:NM_020664.3~uORF:IOH9825	2375	40	2335
B14R10C06	14-6-10	Hs~Ref:NM_020664.3~uORF:IOH9825	2373	40	2333
B14R10C07	14-7-10	Hs~MGC:BC005378.1~uORF:IOH7320	445	38	407
B14R10C08	14-8-10	Hs~MGC:BC005378.1~uORF:IOH7320	478	59	419
B14R10C09	14-9-10	Hs~Ref:NM_004281.2~uORF:IOH6609	7804	80	7724
B14R10C10	14-10-10	Hs~Ref:NM_004281.2~uORF:IOH6609	7874	66	7808
B14R10C11	14-11-10	GST1	60	58	2
B14R10C12	14-12-10	GST1	52	48	4
B14R10C13	14-13-10	GST2	45	40	5
B14R10C14	14-14-10	GST2	45	40	5
B14R10C15	14-15-10	GST3	54	39	15
B14R10C16	14-16-10	GST3	57	39	18
B14R10C17	14-17-10	GST4	97	51	46
B14R10C18	14-18-10	GST4	62	40	22
B14R10C19	14-19-10	Anti-HumanIgA1~N/A	9338	40	9298
B14R10C20	14-20-10	Anti-HumanIgA1~N/A	9534	41	9493
B14R10C21	14-21-10	Anti-HumanIgA2~N/A	18288	41	18247
B14R10C22	14-22-10	Anti-HumanIgA2~N/A	17414	41	17373
B14R11C01	14-1-11	AlexaAntiMouseAb~N/A	24178	35	24143
B14R11C02	14-2-11	AlexaAntiMouseAb~N/A	24680	36	24644
B14R11C03	14-3-11	MAPKAP~N/A	82	36	46
B14R11C04	14-4-11	MAPKAP~N/A	125	41	84
B14R11C05	14-5-11	Buffer	141	50	91
B14R11C06	14-6-11	Buffer	184	43	141
B14R11C07	14-7-11	BSA~N/A	11201	40	11161
B14R11C08	14-8-11	BSA~N/A	10695	50	10645
B14R11C09	14-9-11	Anti-HumanIgG1~N/A	2024	57	1967
B14R11C10	14-10-11	Anti-HumanIgG1~N/A	2337	52	2285
B14R11C11	14-11-11	Anti-HumanIgG2~N/A	4257	59	4198
B14R11C12	14-12-11	Anti-HumanIgG2~N/A	3973	51	3922
B14R11C13	14-13-11	Anti-HumanIgG3~N/A	6802	44	6758
B14R11C14	14-14-11	Anti-HumanIgG3~N/A	6407	41	6366
B14R11C15	14-15-11	Anti-HumanIgG4~N/A	11682	42	11640
B14R11C16	14-16-11	Anti-HumanIgG4~N/A	12028	40	11988
B14R11C17	14-17-11	AntiBiotinAb~N/A	14315	39	14276
B14R11C18	14-18-11	AntiBiotinAb~N/A	14577	38	14539
B14R11C19	14-19-11	Buffer	54	37	17
B14R11C20	14-20-11	Buffer	64	47	17
B14R11C21	14-21-11	Hs~Ref:NM_030938.2~uORF:IOH22902	36	40	-4
B14R11C22	14-22-11	Hs~Ref:NM_030938.2~uORF:IOH22902	38	38	0
B14R12C01	14-1-12	Hs~MGC:NM_178151.1~uORF:IOH22620	447	35	412
B14R12C02	14-2-12	Hs~MGC:NM_178151.1~uORF:IOH22620	495	36	459
B14R12C03	14-3-12	Hs~MGC:BC012291.1~uORF:IOH10483	533	37	496
B14R12C04	14-4-12	Hs~MGC:BC012291.1~uORF:IOH10483	480	38	442
B14R12C05	14-5-12	Hs~Ref:NM_002862.2~uORF:IOH9832	639	42	597
B14R12C06	14-6-12	Hs~Ref:NM_002862.2~uORF:IOH9832	655	43	612
B14R12C07	14-7-12	Hs~Ref:NM_145021.1~uORF:IOH10856	1197	42	1155
B14R12C08	14-8-12	Hs~Ref:NM_145021.1~uORF:IOH10856	1300	50	1250
B14R12C09	14-9-12	Hs~Ref:NM_005710.1~uORF:IOH13398	661	56	605
B14R12C10	14-10-12	Hs~Ref:NM_005710.1~uORF:IOH13398	574	68	506
B14R12C11	14-11-12	Hs~MGC:BC015634.1~uORF:IOH14765	417	199	218
B14R12C12	14-12-12	Hs~MGC:BC015634.1~uORF:IOH14765	243	72	171
B14R12C13	14-13-12	Hs~Ref:NM_033105.1~uORF:IOH11096	660	64	596
B14R12C14	14-14-12	Hs~Ref:NM_033105.1~uORF:IOH11096	546	46	500
B14R12C15	14-15-12	Hs~Ref:NM_017735.3~uORF:IOH40508	247	45	202
B14R12C16	14-16-12	Hs~Ref:NM_017735.3~uORF:IOH40508	205	41	164
B14R12C17	14-17-12	Hs~MGC:BC066645.1~uORF:IOH39925	473	40	433
B14R12C18	14-18-12	Hs~MGC:BC066645.1~uORF:IOH39925	474	40	434
B14R12C19	14-19-12	Hs~Ref:NM_000805.2~uORF:IOH40360	217	41	176
B14R12C20	14-20-12	Hs~Ref:NM_000805.2~uORF:IOH40360	250	185	65
B14R12C21	14-21-12	Hs~MGC:BC064428.1~uORF:IOH39937	176	45	131
B14R12C22	14-22-12	Hs~MGC:BC064428.1~uORF:IOH39937	193	133	60
B14R13C01	14-1-13	Hs~MGC:BC009207.2~uORF:IOH14435	372	37	335
B14R13C02	14-2-13	Hs~MGC:BC009207.2~uORF:IOH14435	368	40	328
B14R13C03	14-3-13	Hs~MGC:BC034275.1~uORF:IOH21410	550	43	507
B14R13C04	14-4-13	Hs~MGC:BC034275.1~uORF:IOH21410	550	43	507
B14R13C05	14-5-13	Hs~MGC:NM_173192.1~uORF:IOH21409	199	76	123
B14R13C06	14-6-13	Hs~MGC:NM_173192.1~uORF:IOH21409	117	49	68
B14R13C07	14-7-13	Hs~MGC:BC015219.1~uORF:IOH21424	311	54	257
B14R13C08	14-8-13	Hs~MGC:BC015219.1~uORF:IOH21424	4685	52	4633
B14R13C09	14-9-13	Hs~MGC:BC000448.1~uORF:IOH3504	390	54	336
B14R13C10	14-10-13	Hs~MGC:BC000448.1~uORF:IOH3504	411	93	318
B14R13C11	14-11-13	Hs~MGC:BC000552.1~uORF:IOH4161	409	218	191
B14R13C12	14-12-13	Hs~MGC:BC000552.1~uORF:IOH4161	276	60	216
B14R13C13	14-13-13	Hs~MGC:BC000250.1~uORF:IOH4515	307	153	154
B14R13C14	14-14-13	Hs~MGC:BC000250.1~uORF:IOH4515	289	52	237
B14R13C15	14-15-13	Hs~MGC:BC009011.1~uORF:IOH3300	275	148	127
B14R13C16	14-16-13	Hs~MGC:BC009011.1~uORF:IOH3300	298	48	250
B14R13C17	14-17-13	Hs~MGC:BC057811.1~uORF:IOH29291	117	40	77
B14R13C18	14-18-13	Hs~MGC:BC057811.1~uORF:IOH29291	123	44	79
B14R13C19	14-19-13	Hs~MGC:BC016967.1~uORF:IOH28624	253	42	211
B14R13C20	14-20-13	Hs~MGC:BC016967.1~uORF:IOH28624	233	53	180
B14R13C21	14-21-13	Hs~MGC:BC055427.1~uORF:IOH28811	269	47	222
B14R13C22	14-22-13	Hs~MGC:BC055427.1~uORF:IOH28811	301	45	256
B14R14C01	14-1-14	Hs~MGC:BC053670.1~uORF:IOH29013	245	40	205
B14R14C02	14-2-14	Hs~MGC:BC053670.1~uORF:IOH29013	227	43	184
B14R14C03	14-3-14	Hs~MGC:BC006124.1~uORF:IOH6586	704	42	662
B14R14C04	14-4-14	Hs~MGC:BC006124.1~uORF:IOH6586	713	41	672
B14R14C05	14-5-14	Hs~Ref:XM_378175.2~uORF:IOH26505	518	39	479
B14R14C06	14-6-14	Hs~Ref:XM_378175.2~uORF:IOH26505	469	39	430
B14R14C07	14-7-14	Hs~Ref:NM_004697.3~uORF:IOH12861	1177	45	1132
B14R14C08	14-8-14	Hs~Ref:NM_004697.3~uORF:IOH12861	1980	47	1933
B14R14C09	14-9-14	Hs~MGC:BC023973.1~uORF:IOH27304	1057	48	1009
B14R14C10	14-10-14	Hs~MGC:BC023973.1~uORF:IOH27304	839	56	783
B14R14C11	14-11-14	Hs~Ref:NM_004753.1~uORF:IOH5360	579	49	530
B14R14C12	14-12-14	Hs~Ref:NM_004753.1~uORF:IOH5360	577	184	393
B14R14C13	14-13-14	Hs~MGC:BC033711.1~uORF:IOH21762	602	54	548
B14R14C14	14-14-14	Hs~MGC:BC033711.1~uORF:IOH21762	547	49	498
B14R14C15	14-15-14	Hs~Ref:NM_005111.4~uORF:IOH22501	196	51	145
B14R14C16	14-16-14	Hs~Ref:NM_005111.4~uORF:IOH22501	198	42	156
B14R14C17	14-17-14	Hs~MGC:BC006323.1~uORF:IOH6466	339	40	299
B14R14C18	14-18-14	Hs~MGC:BC006323.1~uORF:IOH6466	404	42	362
B14R14C19	14-19-14	Hs~Ref:NM_004955.1~uORF:IOH3983	293	54	239
B14R14C20	14-20-14	Hs~Ref:NM_004955.1~uORF:IOH3983	279	71	208
B14R14C21	14-21-14	Hs~MGC:NM_173802.2~uORF:IOH26328	55	55	0
B14R14C22	14-22-14	Hs~MGC:NM_173802.2~uORF:IOH26328	551	63	488
B14R15C01	14-1-15	Hs~Ref:NM_012261.1~uORF:IOH27036	310	37	273
B14R15C02	14-2-15	Hs~Ref:NM_012261.1~uORF:IOH27036	338	45	293
B14R15C03	14-3-15	Hs~MGC:BC039814.1~uORF:IOH26283	689	38	651
B14R15C04	14-4-15	Hs~MGC:BC039814.1~uORF:IOH26283	679	37	642
B14R15C05	14-5-15	Hs~Ref:NM_182527.1~uORF:IOH26942	430	38	392
B14R15C06	14-6-15	Hs~Ref:NM_182527.1~uORF:IOH26942	404	38	366
B14R15C07	14-7-15	Hs~Ref:NM_000904.1~uORF:IOH6580	275	37	238
B14R15C08	14-8-15	Hs~Ref:NM_000904.1~uORF:IOH6580	280	47	233
B14R15C09	14-9-15	Hs~Ref:NM_006212.1~uORF:IOH34755	1602	43	1559
B14R15C10	14-10-15	Hs~Ref:NM_006212.1~uORF:IOH34755	1653	48	1605
B14R15C11	14-11-15	Hs~Ref:NM_000231.1~uORF:IOH1957	579	49	530
B14R15C12	14-12-15	Hs~Ref:NM_000231.1~uORF:IOH1957	555	47	508
B14R15C13	14-13-15	Hs~IVGN:NM_020996~CAT_PHG0174~N/A	281	46	235
B14R15C14	14-14-15	Hs~IVGN:NM_020996~CAT_PHG0174~N/A	230	51	179
B14R15C15	14-15-15	Hs~Ref:NM_002613.3~CAT:P3001	176	64	112
B14R15C16	14-16-15	Hs~Ref:NM_002613.3~CAT:P3001	115	54	61
B14R15C17	14-17-15	Hs~Ref:NM_002447.1~CAT:PV4314	637	41	596
B14R15C18	14-18-15	Hs~Ref:NM_002447.1~CAT:PV4314	656	38	618
B14R15C19	14-19-15	Hs~Ref:NM_002756.2~CAT:PV3662	370	39	331
B14R15C20	14-20-15	Hs~Ref:NM_002756.2~CAT:PV3662	296	41	255
B14R15C21	14-21-15	Hs~Ref:NM_139209.1~CAT:PV3823	246	49	197
B14R15C22	14-22-15	Hs~Ref:NM_139209.1~CAT:PV3823	82	62	20
B14R16C01	14-1-16	Hs~Ref:NM_001004105.1~CAT:PV3661	516	36	480
B14R16C02	14-2-16	Hs~Ref:NM_001004105.1~CAT:PV3661	520	36	484
B14R16C03	14-3-16	Hs~Ref:NM_003691.1~CAT:PV4311	62	35	27
B14R16C04	14-4-16	Hs~Ref:NM_003691.1~CAT:PV4311	69	36	33
B14R16C05	14-5-16	Hs~Ref:NM_006258.1~CAT:PV4340	208	40	168
B14R16C06	14-6-16	Hs~Ref:NM_006258.1~CAT:PV4340	173	38	135
B14R16C07	14-7-16	Hs~Ref:NM_001006641.1~uORF:IOH52122	241	38	203
B14R16C08	14-8-16	Hs~Ref:NM_001006641.1~uORF:IOH52122	210	39	171
B14R16C09	14-9-16	Hs~Ref:NM_182719.1~uORF:IOH58671	215	37	178
B14R16C10	14-10-16	Hs~Ref:NM_182719.1~uORF:IOH58671	241	47	194
B14R16C11	14-11-16	Hs~Ref:NM_022770.2~uORF:IOH56910	141	73	68
B14R16C12	14-12-16	Hs~Ref:NM_022770.2~uORF:IOH56910	146	49	97
B14R16C13	14-13-16	Hs~MGC:BC022543.1~uORF:IOH55985	329	54	275
B14R16C14	14-14-16	Hs~MGC:BC022543.1~uORF:IOH55985	245	49	196
B14R16C15	14-15-16	Hs~MGC:BC008877.2~uORF:IOH57031	926	48	878
B14R16C16	14-16-16	Hs~MGC:BC008877.2~uORF:IOH57031	953	45	908
B14R16C17	14-17-16	Hs~Ref:NM_032905.3~uORF:IOH56977	759	40	719
B14R16C18	14-18-16	Hs~Ref:NM_032905.3~uORF:IOH56977	742	40	702
B14R16C19	14-19-16	Hs~Ref:NM_181640.1~uORF:IOH58583	296	45	251
B14R16C20	14-20-16	Hs~Ref:NM_181640.1~uORF:IOH58583	57	55	2
B14R16C21	14-21-16	Hs~Ref:NM_001009613.1~uORF:IOH58584	1255	49	1206
B14R16C22	14-22-16	Hs~Ref:NM_001009613.1~uORF:IOH58584	1306	44	1262
B14R17C01	14-1-17	Hs~MGC:BC093749.1~uORF:IOH61988	335	37	298
B14R17C02	14-2-17	Hs~MGC:BC093749.1~uORF:IOH61988	318	38	280
B14R17C03	14-3-17	Hs~Ref:NM_012249.2~uORF:IOH59719	206	55	151
B14R17C04	14-4-17	Hs~Ref:NM_012249.2~uORF:IOH59719	118	40	78
B14R17C05	14-5-17	Hs~MGC:BC074764.2~uORF:IOH61918	138	66	72
B14R17C06	14-6-17	Hs~MGC:BC074764.2~uORF:IOH61918	94	46	48
B14R17C07	14-7-17	Hs~Ref:NM_001001877.1~uORF:IOH59704	199	40	159
B14R17C08	14-8-17	Hs~Ref:NM_001001877.1~uORF:IOH59704	180	38	142
B14R17C09	14-9-17	Hs~Ref:NM_145013.1~uORF:IOH10783	363	40	323
B14R17C10	14-10-17	Hs~Ref:NM_145013.1~uORF:IOH10783	574	51	523
B14R17C11	14-11-17	Hs~MGC:BC029395.1~uORF:IOH23151	530	212	318
B14R17C12	14-12-17	Hs~MGC:BC029395.1~uORF:IOH23151	344	232	112
B14R17C13	14-13-17	Hs~Ref:NM_002095.1~uORF:IOH22963	1539	50	1489
B14R17C14	14-14-17	Hs~Ref:NM_002095.1~uORF:IOH22963	1442	46	1396
B14R17C15	14-15-17	Hs~MGC:BC031549.1~uORF:IOH21007	737	41	696
B14R17C16	14-16-17	Hs~MGC:BC031549.1~uORF:IOH21007	744	39	705
B14R17C17	14-17-17	Hs~Ref:NM_153283.1~uORF:IOH45449	323	39	284
B14R17C18	14-18-17	Hs~Ref:NM_153283.1~uORF:IOH45449	276	46	230
B14R17C19	14-19-17	Hs~Ref:NM_021967.1~uORF:IOH45915	1243	62	1181
B14R17C20	14-20-17	Hs~Ref:NM_021967.1~uORF:IOH45915	1246	58	1188
B14R17C21	14-21-17	Hs~Ref:NM_173042.1~uORF:IOH45456	342	53	289
B14R17C22	14-22-17	Hs~Ref:NM_173042.1~uORF:IOH45456	416	52	364
B14R18C01	14-1-18	Hs~Ref:NM_153759.2~uORF:IOH45457	426	36	390
B14R18C02	14-2-18	Hs~Ref:NM_153759.2~uORF:IOH45457	464	37	427
B14R18C03	14-3-18	Hs~MGC:BC023603.2~uORF:IOH29334	322	41	281
B14R18C04	14-4-18	Hs~MGC:BC023603.2~uORF:IOH29334	324	176	148
B14R18C05	14-5-18	Hs~MGC:BC009650.1~uORF:IOH11334	569	41	528
B14R18C06	14-6-18	Hs~MGC:BC009650.1~uORF:IOH11334	507	42	465
B14R18C07	14-7-18	Hs~Ref:NM_004181.2~uORF:IOH5072	150	43	107
B14R18C08	14-8-18	Hs~Ref:NM_004181.2~uORF:IOH5072	96	44	52
B14R18C09	14-9-18	Hs~Ref:NM_017971.1~uORF:IOH13615	428	42	386
B14R18C10	14-10-18	Hs~Ref:NM_017971.1~uORF:IOH13615	537	57	480
B14R18C11	14-11-18	Hs~MGC:NM_178122.2~uORF:IOH26674	375	76	299
B14R18C12	14-12-18	Hs~MGC:NM_178122.2~uORF:IOH26674	435	58	377
B14R18C13	14-13-18	Hs~MGC:NM_000953.2~uORF:IOH26261	336	134	202
B14R18C14	14-14-18	Hs~MGC:NM_000953.2~uORF:IOH26261	245	48	197
B14R18C15	14-15-18	Hs~Ref:NM_000401.2~uORF:IOH14553	353	46	307
B14R18C16	14-16-18	Hs~Ref:NM_000401.2~uORF:IOH14553	301	43	258
B14R18C17	14-17-18	Hs~Ref:NM_025159.1~uORF:IOH13469	265	48	217
B14R18C18	14-18-18	Hs~Ref:NM_025159.1~uORF:IOH13469	184	44	140
B14R18C19	14-19-18	Hs~Ref:NM_153822.1~uORF:IOH41107	913	60	853
B14R18C20	14-20-18	Hs~Ref:NM_153822.1~uORF:IOH41107	879	56	823
B14R18C21	14-21-18	Hs~Ref:XM_378309.2~uORF:IOH41344	372	46	326
B14R18C22	14-22-18	Hs~Ref:XM_378309.2~uORF:IOH41344	380	60	320
B14R19C01	14-1-19	Hs~Ref:NM_000864.3~uORF:IOH6478	346	35	311
B14R19C02	14-2-19	Hs~Ref:NM_000864.3~uORF:IOH6478	358	36	322
B14R19C03	14-3-19	Hs~MGC:BC042174.1~uORF:IOH28018	798	38	760
B14R19C04	14-4-19	Hs~MGC:BC042174.1~uORF:IOH28018	764	39	725
B14R19C05	14-5-19	Hs~MGC:BC025726.1~uORF:IOH10934	123	40	83
B14R19C06	14-6-19	Hs~MGC:BC025726.1~uORF:IOH10934	161	95	66
B14R19C07	14-7-19	Hs~Ref:NM_014245.1~uORF:IOH7569	222	47	175
B14R19C08	14-8-19	Hs~Ref:NM_014245.1~uORF:IOH7569	254	46	208
B14R19C09	14-9-19	Hs~Ref:NM_017855.2~uORF:IOH23051	330	43	287
B14R19C10	14-10-19	Hs~Ref:NM_017855.2~uORF:IOH23051	397	73	324
B14R19C11	14-11-19	Hs~MGC:BC000468.1~uORF:IOH3618	468	55	413
B14R19C12	14-12-19	Hs~MGC:BC000468.1~uORF:IOH3618	505	50	455
B14R19C13	14-13-19	Hs~Ref:NM_016618.1~uORF:IOH10031	477	248	229
B14R19C14	14-14-19	Hs~Ref:NM_016618.1~uORF:IOH10031	292	52	240
B14R19C15	14-15-19	Hs~MGC:BC032462.1~uORF:IOH21685	586	54	532
B14R19C16	14-16-19	Hs~MGC:BC032462.1~uORF:IOH21685	434	152	282
B14R19C17	14-17-19	Hs~Ref:NM_001010874.2~uORF:IOH44524	404	45	359
B14R19C18	14-18-19	Hs~Ref:NM_001010874.2~uORF:IOH44524	337	44	293
B14R19C19	14-19-19	Hs~Ref:NM_004013.1~uORF:IOH36376	599	46	553
B14R19C20	14-20-19	Hs~Ref:NM_004013.1~uORF:IOH36376	545	46	499
B14R19C21	14-21-19	Hs~MGC:BC004878.1~uORF:IOH5623	265	97	168
B14R19C22	14-22-19	Hs~MGC:BC004878.1~uORF:IOH5623	228	91	137
B14R20C01	14-1-20	Hs~Ref:NM_019884.2~uORF:IOH11473	400	36	364
B14R20C02	14-2-20	Hs~Ref:NM_019884.2~uORF:IOH11473	433	37	396
B14R20C03	14-3-20	Hs~Ref:NM_015596.1~uORF:IOH40279	91	47	44
B14R20C04	14-4-20	Hs~Ref:NM_015596.1~uORF:IOH40279	58	40	18
B14R20C05	14-5-20	Hs~Ref:NM_052958.1~uORF:IOH42627	396	45	351
B14R20C06	14-6-20	Hs~Ref:NM_052958.1~uORF:IOH42627	464	67	397
B14R20C07	14-7-20	Hs~MGC:BC026100.2~uORF:IOH11308	170	53	117
B14R20C08	14-8-20	Hs~MGC:BC026100.2~uORF:IOH11308	89	55	34
B14R20C09	14-9-20	Hs~Ref:NM_001161.3~uORF:IOH5534	260	40	220
B14R20C10	14-10-20	Hs~Ref:NM_001161.3~uORF:IOH5534	239	42	197
B14R20C11	14-11-20	Hs~MGC:BC001868.1~uORF:IOH4965	192	59	133
B14R20C12	14-12-20	Hs~MGC:BC001868.1~uORF:IOH4965	99	51	48
B14R20C13	14-13-20	Hs~MGC:BC028113.1~uORF:IOH21569	70	49	21
B14R20C14	14-14-20	Hs~MGC:BC028113.1~uORF:IOH21569	80	52	28
B14R20C15	14-15-20	Hs~Ref:NM_178849.1~uORF:IOH35808	594	53	541
B14R20C16	14-16-20	Hs~Ref:NM_178849.1~uORF:IOH35808	566	47	519
B14R20C17	14-17-20	Hs~MGC:BC041799.1~uORF:IOH25876	890	43	847
B14R20C18	14-18-20	Hs~MGC:BC041799.1~uORF:IOH25876	945	41	904
B14R20C19	14-19-20	Hs~Ref:NM_000811.1~uORF:IOH34681	206	56	150
B14R20C20	14-20-20	Hs~Ref:NM_000811.1~uORF:IOH34681	42	47	-5
B14R20C21	14-21-20	Hs~Ref:NM_207044.1~uORF:IOH44520	149	48	101
B14R20C22	14-22-20	Hs~Ref:NM_207044.1~uORF:IOH44520	252	60	192
B14R21C01	14-1-21	Hs~Ref:NM_031262.1~uORF:IOH12922	458	36	422
B14R21C02	14-2-21	Hs~Ref:NM_031262.1~uORF:IOH12922	481	37	444
B14R21C03	14-3-21	Hs~MGC:BC030803.1~uORF:IOH23068	235	40	195
B14R21C04	14-4-21	Hs~MGC:BC030803.1~uORF:IOH23068	163	38	125
B14R21C05	14-5-21	Hs~Ref:NM_017545.2~uORF:IOH42486	555	44	511
B14R21C06	14-6-21	Hs~Ref:NM_017545.2~uORF:IOH42486	437	306	131
B14R21C07	14-7-21	Hs~MGC:BC032128.2~uORF:IOH23105	256	63	193
B14R21C08	14-8-21	Hs~MGC:BC032128.2~uORF:IOH23105	244	42	202
B14R21C09	14-9-21	Hs~Ref:NP_116121.2~CAT_11747-H08B-25	64	39	25
B14R21C10	14-10-21	Hs~Ref:NP_116121.2~CAT_11747-H08B-25	103	40	63
B14R21C11	14-11-21	Internal_1007209	254	51	203
B14R21C12	14-12-21	Internal_1007209	68	51	17
B14R21C13	14-13-21	Hs~Ref:Q13449~CAT_12136-H08H-25	47	46	1
B14R21C14	14-14-21	Hs~Ref:Q13449~CAT_12136-H08H-25	46	46	0
B14R21C15	14-15-21	Internal_1007209	154	53	101
B14R21C16	14-16-21	Internal_1007209	83	44	39
B14R21C17	14-17-21	Hs~Ref:NP_000558.2~CAT_11250-H08H-25	74	41	33
B14R21C18	14-18-21	Hs~Ref:NP_000558.2~CAT_11250-H08H-25	44	39	5
B14R21C19	14-19-21	Internal_1007209	57	39	18
B14R21C20	14-20-21	Internal_1007209	40	39	1
B14R21C21	14-21-21	Internal_1007209	42	40	2
B14R21C22	14-22-21	Internal_1007209	41	41	0
B14R22C01	14-1-22	ERa~N/A	2689	35	2654
B14R22C02	14-2-22	ERa~N/A	2493	35	2458
B14R22C03	14-3-22	PKCeta~N/A	278	36	242
B14R22C04	14-4-22	PKCeta~N/A	322	37	285
B14R22C05	14-5-22	Calmodulin~N/A	70	37	33
B14R22C06	14-6-22	Calmodulin~N/A	67	38	29
B14R22C07	14-7-22	V5control5~N/A	370	39	331
B14R22C08	14-8-22	V5control5~N/A	361	39	322
B14R22C09	14-9-22	V5control4~N/A	69	58	11
B14R22C10	14-10-22	V5control4~N/A	250	42	208
B14R22C11	14-11-22	V5control3~N/A	125	67	58
B14R22C12	14-12-22	V5control3~N/A	165	67	98
B14R22C13	14-13-22	V5control2~N/A	60	46	14
B14R22C14	14-14-22	V5control2~N/A	82	58	24
B14R22C15	14-15-22	V5control1~N/A	60	44	16
B14R22C16	14-16-22	V5control1~N/A	124	52	72
B14R22C17	14-17-22	CMK2A~N/A	422	40	382
B14R22C18	14-18-22	CMK2A~N/A	436	39	397
B14R22C19	14-19-22	ERa~N/A	1588	38	1550
B14R22C20	14-20-22	ERa~N/A	1775	39	1736
B14R22C21	14-21-22	AlexaAntiMouseAb~N/A	11677	39	11638
B14R22C22	14-22-22	AlexaAntiMouseAb~N/A	11100	39	11061
B15R01C01	15-1-1	AlexaAntiMouseAb~N/A	39947	40	39907
B15R01C02	15-2-1	AlexaAntiMouseAb~N/A	38116	39	38077
B15R01C03	15-3-1	ERa~N/A	1647	40	1607
B15R01C04	15-4-1	ERa~N/A	1656	40	1616
B15R01C05	15-5-1	HumanIgG1~N/A	1170	41	1129
B15R01C06	15-6-1	HumanIgG1~N/A	1304	40	1264
B15R01C07	15-7-1	HumanIgG2~N/A	2717	40	2677
B15R01C08	15-8-1	HumanIgG2~N/A	3181	41	3140
B15R01C09	15-9-1	HumanIgG3~N/A	12611	41	12570
B15R01C10	15-10-1	HumanIgG3~N/A	15878	42	15836
B15R01C11	15-11-1	HumanIgG4~N/A	41265	43	41222
B15R01C12	15-12-1	HumanIgG4~N/A	46631	43	46588
B15R01C13	15-13-1	BiotinAb~N/A	456	42	414
B15R01C14	15-14-1	BiotinAb~N/A	472	41	431
B15R01C15	15-15-1	RanBP2deltaFG~N/A	486	40	446
B15R01C16	15-16-1	RanBP2deltaFG~N/A	453	41	412
B15R01C17	15-17-1	hMDM2~N/A	910	41	869
B15R01C18	15-18-1	hMDM2~N/A	912	41	871
B15R01C19	15-19-1	PKCeta~N/A	657	40	617
B15R01C20	15-20-1	PKCeta~N/A	639	39	600
B15R01C21	15-21-1	AlexaAntiMouseAb~N/A	38734	40	38694
B15R01C22	15-22-1	AlexaAntiMouseAb~N/A	41583	41	41542
B15R02C01	15-1-2	PKCeta~N/A	1333	42	1291
B15R02C02	15-2-2	PKCeta~N/A	1531	40	1491
B15R02C03	15-3-2	Buffer	165	63	102
B15R02C04	15-4-2	Buffer	150	41	109
B15R02C05	15-5-2	HumanIgA~N/A	21376	42	21334
B15R02C06	15-6-2	HumanIgA~N/A	20822	42	20780
B15R02C07	15-7-2	Buffer	176	73	103
B15R02C08	15-8-2	Buffer	165	83	82
B15R02C09	15-9-2	BSA~N/A	12261	44	12217
B15R02C10	15-10-2	BSA~N/A	11720	45	11675
B15R02C11	15-11-2	Hs~Ref:NM_002391.1~uORF:IOH13794	385	43	342
B15R02C12	15-12-2	Hs~Ref:NM_002391.1~uORF:IOH13794	402	43	359
B15R02C13	15-13-2	Hs~MGC:BC022034.1~uORF:IOH10988	294	41	253
B15R02C14	15-14-2	Hs~MGC:BC022034.1~uORF:IOH10988	277	40	237
B15R02C15	15-15-2	Hs~Ref:NM_138551.1~uORF:IOH13700	452	42	410
B15R02C16	15-16-2	Hs~Ref:NM_138551.1~uORF:IOH13700	440	43	397
B15R02C17	15-17-2	Hs~MGC:BC017382.1~uORF:IOH14830	361	42	319
B15R02C18	15-18-2	Hs~MGC:BC017382.1~uORF:IOH14830	420	43	377
B15R02C19	15-19-2	Hs~Ref:NM_018186.2~uORF:IOH43824	212	43	169
B15R02C20	15-20-2	Hs~Ref:NM_018186.2~uORF:IOH43824	299	56	243
B15R02C21	15-21-2	Hs~Ref:XM_378983.2~uORF:IOH43632	306	53	253
B15R02C22	15-22-2	Hs~Ref:XM_378983.2~uORF:IOH43632	216	45	171
B15R03C01	15-1-3	Hs~Ref:NM_201564.1~uORF:IOH42223	1166	42	1124
B15R03C02	15-2-3	Hs~Ref:NM_201564.1~uORF:IOH42223	1072	41	1031
B15R03C03	15-3-3	Hs~Ref:NM_198205.1~uORF:IOH40943	972	43	929
B15R03C04	15-4-3	Hs~Ref:NM_198205.1~uORF:IOH40943	910	44	866
B15R03C05	15-5-3	Hs~MGC:BC046912.1~uORF:IOH26890	221	64	157
B15R03C06	15-6-3	Hs~MGC:BC046912.1~uORF:IOH26890	186	48	138
B15R03C07	15-7-3	Hs~MGC:BC016995.1~uORF:IOH25796	147	42	105
B15R03C08	15-8-3	Hs~MGC:BC016995.1~uORF:IOH25796	137	42	95
B15R03C09	15-9-3	Hs~MGC:BC039742.1~uORF:IOH26173	280	55	225
B15R03C10	15-10-3	Hs~MGC:BC039742.1~uORF:IOH26173	248	60	188
B15R03C11	15-11-3	Hs~MGC:BC046199.1~uORF:IOH26969	175	46	129
B15R03C12	15-12-3	Hs~MGC:BC046199.1~uORF:IOH26969	144	52	92
B15R03C13	15-13-3	Hs~MGC:BC015754.1~uORF:IOH13637	361	44	317
B15R03C14	15-14-3	Hs~MGC:BC015754.1~uORF:IOH13637	227	43	184
B15R03C15	15-15-3	Hs~MGC:BC002758.1~uORF:IOH5367	654	44	610
B15R03C16	15-16-3	Hs~MGC:BC002758.1~uORF:IOH5367	645	43	602
B15R03C17	15-17-3	Hs~MGC:BC022361.1~uORF:IOH14170	660	43	617
B15R03C18	15-18-3	Hs~MGC:BC022361.1~uORF:IOH14170	1339	62	1277
B15R03C19	15-19-3	Hs~Ref:NM_021992.1~uORF:IOH4359	1090	56	1034
B15R03C20	15-20-3	Hs~Ref:NM_021992.1~uORF:IOH4359	329	48	281
B15R03C21	15-21-3	Hs~MGC:BC031551.1~uORF:IOH22627	334	84	250
B15R03C22	15-22-3	Hs~MGC:BC031551.1~uORF:IOH22627	322	61	261
B15R04C01	15-1-4	Hs~Ref:NM_000049.1~uORF:IOH22633	292	44	248
B15R04C02	15-2-4	Hs~Ref:NM_000049.1~uORF:IOH22633	257	43	214
B15R04C03	15-3-4	Hs~MGC:BC029176.1~uORF:IOH22643	178	122	56
B15R04C04	15-4-4	Hs~MGC:BC029176.1~uORF:IOH22643	148	41	107
B15R04C05	15-5-4	Hs~Ref:NM_018452.1~uORF:IOH22646	495	41	454
B15R04C06	15-6-4	Hs~Ref:NM_018452.1~uORF:IOH22646	492	42	450
B15R04C07	15-7-4	Hs~MGC:BC007028.1~uORF:IOH7155	155	41	114
B15R04C08	15-8-4	Hs~MGC:BC007028.1~uORF:IOH7155	146	42	104
B15R04C09	15-9-4	Hs~Ref:NM_014268.1~uORF:IOH5850	920	54	866
B15R04C10	15-10-4	Hs~Ref:NM_014268.1~uORF:IOH5850	950	57	893
B15R04C11	15-11-4	Hs~Ref:NM_006512.1~uORF:IOH7161	87	54	33
B15R04C12	15-12-4	Hs~Ref:NM_006512.1~uORF:IOH7161	164	123	41
B15R04C13	15-13-4	Hs~MGC:BC003551.1~uORF:IOH4964	501	44	457
B15R04C14	15-14-4	Hs~MGC:BC003551.1~uORF:IOH4964	455	157	298
B15R04C15	15-15-4	Hs~MGC:BC063469.1~uORF:IOH39876	388	42	346
B15R04C16	15-16-4	Hs~MGC:BC063469.1~uORF:IOH39876	390	41	349
B15R04C17	15-17-4	Hs~MGC:BC050405.1~uORF:IOH26718	267	46	221
B15R04C18	15-18-4	Hs~MGC:BC050405.1~uORF:IOH26718	215	123	92
B15R04C19	15-19-4	Hs~Ref:NM_005041.3~uORF:IOH39791	641	82	559
B15R04C20	15-20-4	Hs~Ref:NM_005041.3~uORF:IOH39791	234	44	190
B15R04C21	15-21-4	Hs~Ref:NM_032439.1~uORF:IOH40856	387	45	342
B15R04C22	15-22-4	Hs~Ref:NM_032439.1~uORF:IOH40856	369	53	316
B15R05C01	15-1-5	Hs~MGC:BC017098.1~uORF:IOH13421	805	41	764
B15R05C02	15-2-5	Hs~MGC:BC017098.1~uORF:IOH13421	828	41	787
B15R05C03	15-3-5	Hs~MGC:BC009423.1~uORF:IOH12920	294	43	251
B15R05C04	15-4-5	Hs~MGC:BC009423.1~uORF:IOH12920	449	42	407
B15R05C05	15-5-5	Hs~MGC:NM_148904.2~uORF:IOH12103	359	42	317
B15R05C06	15-6-5	Hs~MGC:NM_148904.2~uORF:IOH12103	360	43	317
B15R05C07	15-7-5	Hs~MGC:BC009485.1~uORF:IOH12968	699	41	658
B15R05C08	15-8-5	Hs~MGC:BC009485.1~uORF:IOH12968	682	41	641
B15R05C09	15-9-5	Hs~MGC:BC046151.1~uORF:IOH26994	2094	42	2052
B15R05C10	15-10-5	Hs~MGC:BC046151.1~uORF:IOH26994	2020	43	1977
B15R05C11	15-11-5	Hs~MGC:NM_182918.2~uORF:IOH26275	293	44	249
B15R05C12	15-12-5	Hs~MGC:NM_182918.2~uORF:IOH26275	190	44	146
B15R05C13	15-13-5	Hs~MGC:NM_052913.2~uORF:IOH26380	233	47	186
B15R05C14	15-14-5	Hs~MGC:NM_052913.2~uORF:IOH26380	183	53	130
B15R05C15	15-15-5	Hs~Ref:NM_001203.1~uORF:IOH26729	231	62	169
B15R05C16	15-16-5	Hs~Ref:NM_001203.1~uORF:IOH26729	218	69	149
B15R05C17	15-17-5	Hs~Ref:NM_138421.1~uORF:IOH10769	299	45	254
B15R05C18	15-18-5	Hs~Ref:NM_138421.1~uORF:IOH10769	193	72	121
B15R05C19	15-19-5	Hs~MGC:BC012033.1~uORF:IOH10766	118	63	55
B15R05C20	15-20-5	Hs~MGC:BC012033.1~uORF:IOH10766	217	49	168
B15R05C21	15-21-5	Hs~Ref:NM_024009.1~uORF:IOH11015	183	49	134
B15R05C22	15-22-5	Hs~Ref:NM_024009.1~uORF:IOH11015	182	49	133
B15R06C01	15-1-6	Hs~Ref:NM_138798.1~uORF:IOH10640	323	46	277
B15R06C02	15-2-6	Hs~Ref:NM_138798.1~uORF:IOH10640	372	65	307
B15R06C03	15-3-6	Hs~Ref:NM_144613.3~uORF:IOH39922	139	42	97
B15R06C04	15-4-6	Hs~Ref:NM_144613.3~uORF:IOH39922	188	44	144
B15R06C05	15-5-6	Hs~MGC:BC067257.1~uORF:IOH39993	362	44	318
B15R06C06	15-6-6	Hs~MGC:BC067257.1~uORF:IOH39993	258	41	217
B15R06C07	15-7-6	Hs~Ref:NM_183243.1~uORF:IOH40877	247	40	207
B15R06C08	15-8-6	Hs~Ref:NM_183243.1~uORF:IOH40877	280	41	239
B15R06C09	15-9-6	Hs~Ref:NM_015907.2~uORF:IOH39976	702	42	660
B15R06C10	15-10-6	Hs~Ref:NM_015907.2~uORF:IOH39976	651	42	609
B15R06C11	15-11-6	Hs~Ref:NM_032548.2~uORF:IOH45815	288	43	245
B15R06C12	15-12-6	Hs~Ref:NM_032548.2~uORF:IOH45815	187	44	143
B15R06C13	15-13-6	Hs~Ref:NM_178002.1~uORF:IOH45891	97	45	52
B15R06C14	15-14-6	Hs~Ref:NM_178002.1~uORF:IOH45891	146	46	100
B15R06C15	15-15-6	Hs~Ref:NM_183383.1~uORF:IOH45765	178	51	127
B15R06C16	15-16-6	Hs~Ref:NM_183383.1~uORF:IOH45765	58	62	-4
B15R06C17	15-17-6	Hs~Ref:NM_013301.1~uORF:IOH45819	281	52	229
B15R06C18	15-18-6	Hs~Ref:NM_013301.1~uORF:IOH45819	288	47	241
B15R06C19	15-19-6	Hs~Ref:NM_020232.3~uORF:IOH57190	218	73	145
B15R06C20	15-20-6	Hs~Ref:NM_020232.3~uORF:IOH57190	365	63	302
B15R06C21	15-21-6	Hs~MGC:BC006383.2~uORF:IOH56929	91	45	46
B15R06C22	15-22-6	Hs~MGC:BC006383.2~uORF:IOH56929	72	43	29
B15R07C01	15-1-7	Hs~MGC:BC013039.1~uORF:IOH13569	464	47	417
B15R07C02	15-2-7	Hs~MGC:BC013039.1~uORF:IOH13569	461	53	408
B15R07C03	15-3-7	Hs~MGC:BC011636.2~uORF:IOH14389	946	45	901
B15R07C04	15-4-7	Hs~MGC:BC011636.2~uORF:IOH14389	859	43	816
B15R07C05	15-5-7	Hs~Ref:NM_007240.1~uORF:IOH6325	188	44	144
B15R07C06	15-6-7	Hs~Ref:NM_007240.1~uORF:IOH6325	168	46	122
B15R07C07	15-7-7	Hs~MGC:BC009196.1~uORF:IOH12943	180	43	137
B15R07C08	15-8-7	Hs~MGC:BC009196.1~uORF:IOH12943	200	43	157
B15R07C09	15-9-7	Hs~MGC:NM_177554.1~uORF:IOH13715	219	48	171
B15R07C10	15-10-7	Hs~MGC:NM_177554.1~uORF:IOH13715	150	43	107
B15R07C11	15-11-7	Hs~Ref:NM_002710.1~uORF:IOH14587	285	101	184
B15R07C12	15-12-7	Hs~Ref:NM_002710.1~uORF:IOH14587	227	81	146
B15R07C13	15-13-7	Hs~Ref:NM_014296.2~uORF:IOH39472	601	45	556
B15R07C14	15-14-7	Hs~Ref:NM_014296.2~uORF:IOH39472	668	67	601
B15R07C15	15-15-7	Hs~Ref:NM_021203.2~uORF:IOH39667	268	52	216
B15R07C16	15-16-7	Hs~Ref:NM_021203.2~uORF:IOH39667	299	90	209
B15R07C17	15-17-7	Hs~MGC:BC034984.1~uORF:IOH26875	262	44	218
B15R07C18	15-18-7	Hs~MGC:BC034984.1~uORF:IOH26875	109	47	62
B15R07C19	15-19-7	Hs~Ref:NM_004853.1~uORF:IOH9940	1208	220	988
B15R07C20	15-20-7	Hs~Ref:NM_004853.1~uORF:IOH9940	1032	52	980
B15R07C21	15-21-7	Hs~Ref:NM_003915.2~uORF:IOH4538	1813	45	1768
B15R07C22	15-22-7	Hs~Ref:NM_003915.2~uORF:IOH4538	1576	43	1533
B15R08C01	15-1-8	Hs~Ref:NM_000151.1~uORF:IOH39425	228	41	187
B15R08C02	15-2-8	Hs~Ref:NM_000151.1~uORF:IOH39425	208	40	168
B15R08C03	15-3-8	Hs~Ref:NM_173194.2~uORF:IOH39571	76	64	12
B15R08C04	15-4-8	Hs~Ref:NM_173194.2~uORF:IOH39571	127	49	78
B15R08C05	15-5-8	Hs~Ref:NM_005279.2~uORF:IOH39674	196	42	154
B15R08C06	15-6-8	Hs~Ref:NM_005279.2~uORF:IOH39674	165	41	124
B15R08C07	15-7-8	Hs~MGC:NM_152777.2~uORF:IOH22473	344	42	302
B15R08C08	15-8-8	Hs~MGC:NM_152777.2~uORF:IOH22473	333	42	291
B15R08C09	15-9-8	Hs~MGC:BC014170.1~uORF:IOH22995	561	43	518
B15R08C10	15-10-8	Hs~MGC:BC014170.1~uORF:IOH22995	530	42	488
B15R08C11	15-11-8	Hs~MGC:BC030814.1~uORF:IOH23035	34293	44	34249
B15R08C12	15-12-8	Hs~MGC:BC030814.1~uORF:IOH23035	34565	44	34521
B15R08C13	15-13-8	Hs~MGC:BC014117.1~uORF:IOH22991	402	52	350
B15R08C14	15-14-8	Hs~MGC:BC014117.1~uORF:IOH22991	341	82	259
B15R08C15	15-15-8	Hs~Ref:NM_181527.1~uORF:IOH43652	692	45	647
B15R08C16	15-16-8	Hs~Ref:NM_181527.1~uORF:IOH43652	684	45	639
B15R08C17	15-17-8	Hs~Ref:NM_080923.1~uORF:IOH44598	531	46	485
B15R08C18	15-18-8	Hs~Ref:NM_080923.1~uORF:IOH44598	519	45	474
B15R08C19	15-19-8	Hs~Ref:NM_017850.1~uORF:IOH45670	464	52	412
B15R08C20	15-20-8	Hs~Ref:NM_017850.1~uORF:IOH45670	496	47	449
B15R08C21	15-21-8	Hs~Ref:NM_012110.1~uORF:IOH22161	682	44	638
B15R08C22	15-22-8	Hs~Ref:NM_012110.1~uORF:IOH22161	682	41	641
B15R09C01	15-1-9	Hs~MGC:BC035058.1~uORF:IOH27691	283	40	243
B15R09C02	15-2-9	Hs~MGC:BC035058.1~uORF:IOH27691	166	42	124
B15R09C03	15-3-9	Hs~Ref:NM_203326.1~uORF:IOH3915	479	44	435
B15R09C04	15-4-9	Hs~Ref:NM_203326.1~uORF:IOH3915	570	67	503
B15R09C05	15-5-9	Hs~MGC:BC035601.1~uORF:IOH27560	344	42	302
B15R09C06	15-6-9	Hs~MGC:BC035601.1~uORF:IOH27560	283	40	243
B15R09C07	15-7-9	Hs~Ref:NM_004994.1~uORF:IOH6670	174	39	135
B15R09C08	15-8-9	Hs~Ref:NM_004994.1~uORF:IOH6670	186	39	147
B15R09C09	15-9-9	Hs~MGC:BC052591.1~uORF:IOH29389	38	38	0
B15R09C10	15-10-9	Hs~MGC:BC052591.1~uORF:IOH29389	46	39	7
B15R09C11	15-11-9	Hs~MGC:BC046634.2~uORF:IOH25856	190	41	149
B15R09C12	15-12-9	Hs~MGC:BC046634.2~uORF:IOH25856	48	40	8
B15R09C13	15-13-9	Hs~MGC:BC039895.1~uORF:IOH26171	1046	41	1005
B15R09C14	15-14-9	Hs~MGC:BC039895.1~uORF:IOH26171	1119	40	1079
B15R09C15	15-15-9	Hs~MGC:BC042151.1~uORF:IOH27998	240	51	189
B15R09C16	15-16-9	Hs~MGC:BC042151.1~uORF:IOH27998	252	55	197
B15R09C17	15-17-9	Hs~MGC:BC022820.1~uORF:IOH46094	71	42	29
B15R09C18	15-18-9	Hs~MGC:BC022820.1~uORF:IOH46094	4146	41	4105
B15R09C19	15-19-9	Hs~Ref:NM_001025202.1~uORF:IOH46069	56	41	15
B15R09C20	15-20-9	Hs~Ref:NM_001025202.1~uORF:IOH46069	51	39	12
B15R09C21	15-21-9	Hs~MGC:BC023567.2~uORF:IOH46137	306	54	252
B15R09C22	15-22-9	Hs~MGC:BC023567.2~uORF:IOH46137	345	51	294
B15R10C01	15-1-10	Hs~Ref:NM_024668.2~uORF:IOH46162	53	38	15
B15R10C02	15-2-10	Hs~Ref:NM_024668.2~uORF:IOH46162	375	45	330
B15R10C03	15-3-10	Hs~Ref:NM_183241.1~uORF:IOH40652	200	42	158
B15R10C04	15-4-10	Hs~Ref:NM_183241.1~uORF:IOH40652	136	39	97
B15R10C05	15-5-10	Hs~MGC:BC062297.1~uORF:IOH40691	271	40	231
B15R10C06	15-6-10	Hs~MGC:BC062297.1~uORF:IOH40691	220	39	181
B15R10C07	15-7-10	Hs~MGC:BC063126.1~uORF:IOH40737	143	39	104
B15R10C08	15-8-10	Hs~MGC:BC063126.1~uORF:IOH40737	199	42	157
B15R10C09	15-9-10	Hs~Ref:NM_212492.1~uORF:IOH40694	373	38	335
B15R10C10	15-10-10	Hs~Ref:NM_212492.1~uORF:IOH40694	414	39	375
B15R10C11	15-11-10	GST1	41	39	2
B15R10C12	15-12-10	GST1	38	40	-2
B15R10C13	15-13-10	GST2	853	41	812
B15R10C14	15-14-10	GST2	43	39	4
B15R10C15	15-15-10	GST3	43	40	3
B15R10C16	15-16-10	GST3	44	40	4
B15R10C17	15-17-10	GST4	48	39	9
B15R10C18	15-18-10	GST4	45	40	5
B15R10C19	15-19-10	Anti-HumanIgA1~N/A	7452	39	7413
B15R10C20	15-20-10	Anti-HumanIgA1~N/A	7116	39	7077
B15R10C21	15-21-10	Anti-HumanIgA2~N/A	11714	40	11674
B15R10C22	15-22-10	Anti-HumanIgA2~N/A	12310	39	12271
B15R11C01	15-1-11	AlexaAntiMouseAb~N/A	34585	40	34545
B15R11C02	15-2-11	AlexaAntiMouseAb~N/A	33125	41	33084
B15R11C03	15-3-11	MAPKAP~N/A	63	41	22
B15R11C04	15-4-11	MAPKAP~N/A	44	38	6
B15R11C05	15-5-11	Buffer	147	61	86
B15R11C06	15-6-11	Buffer	95	39	56
B15R11C07	15-7-11	BSA~N/A	6696	45	6651
B15R11C08	15-8-11	BSA~N/A	6442	44	6398
B15R11C09	15-9-11	Anti-HumanIgG1~N/A	1246	42	1204
B15R11C10	15-10-11	Anti-HumanIgG1~N/A	1214	42	1172
B15R11C11	15-11-11	Anti-HumanIgG2~N/A	2502	40	2462
B15R11C12	15-12-11	Anti-HumanIgG2~N/A	2620	40	2580
B15R11C13	15-13-11	Anti-HumanIgG3~N/A	5011	40	4971
B15R11C14	15-14-11	Anti-HumanIgG3~N/A	5238	41	5197
B15R11C15	15-15-11	Anti-HumanIgG4~N/A	9751	40	9711
B15R11C16	15-16-11	Anti-HumanIgG4~N/A	10150	40	10110
B15R11C17	15-17-11	AntiBiotinAb~N/A	11086	41	11045
B15R11C18	15-18-11	AntiBiotinAb~N/A	9788	40	9748
B15R11C19	15-19-11	Buffer	49	38	11
B15R11C20	15-20-11	Buffer	46	37	9
B15R11C21	15-21-11	Hs~Ref:NM_032319.1~uORF:IOH6578	1460	39	1421
B15R11C22	15-22-11	Hs~Ref:NM_032319.1~uORF:IOH6578	1082	39	1043
B15R12C01	15-1-12	Hs~MGC:BC033230.1~uORF:IOH23262	6502	40	6462
B15R12C02	15-2-12	Hs~MGC:BC033230.1~uORF:IOH23262	7147	45	7102
B15R12C03	15-3-12	Hs~MGC:BC042090.1~uORF:IOH28785	548	44	504
B15R12C04	15-4-12	Hs~MGC:BC042090.1~uORF:IOH28785	519	43	476
B15R12C05	15-5-12	Hs~MGC:BC007925.1~uORF:IOH6787	271	39	232
B15R12C06	15-6-12	Hs~MGC:BC007925.1~uORF:IOH6787	299	41	258
B15R12C07	15-7-12	Hs~Ref:NM_016508.2~uORF:IOH21339	3894	46	3848
B15R12C08	15-8-12	Hs~Ref:NM_016508.2~uORF:IOH21339	3841	48	3793
B15R12C09	15-9-12	Hs~MGC:BC034718.1~uORF:IOH21418	889	47	842
B15R12C10	15-10-12	Hs~MGC:BC034718.1~uORF:IOH21418	902	49	853
B15R12C11	15-11-12	Hs~MGC:BC019954.1~uORF:IOH21472	599	54	545
B15R12C12	15-12-12	Hs~MGC:BC019954.1~uORF:IOH21472	610	78	532
B15R12C13	15-13-12	Hs~MGC:BC034483.1~uORF:IOH22297	357	47	310
B15R12C14	15-14-12	Hs~MGC:BC034483.1~uORF:IOH22297	372	187	185
B15R12C15	15-15-12	Hs~MGC:BC013778.1~uORF:IOH10676	582	42	540
B15R12C16	15-16-12	Hs~MGC:BC013778.1~uORF:IOH10676	551	41	510
B15R12C17	15-17-12	Hs~Ref:NM_016655.3~uORF:IOH44326	296	43	253
B15R12C18	15-18-12	Hs~Ref:NM_016655.3~uORF:IOH44326	268	43	225
B15R12C19	15-19-12	Hs~Ref:NM_177951.1~uORF:IOH44340	241	42	199
B15R12C20	15-20-12	Hs~Ref:NM_177951.1~uORF:IOH44340	259	41	218
B15R12C21	15-21-12	Hs~Ref:NM_001359.1~uORF:IOH44360	430	41	389
B15R12C22	15-22-12	Hs~Ref:NM_001359.1~uORF:IOH44360	423	40	383
B15R13C01	15-1-13	Hs~Ref:NM_002093.2~uORF:IOH4507	139	41	98
B15R13C02	15-2-13	Hs~Ref:NM_002093.2~uORF:IOH4507	87	48	39
B15R13C03	15-3-13	Hs~Ref:NM_006620.2~uORF:IOH4029	1307	46	1261
B15R13C04	15-4-13	Hs~Ref:NM_006620.2~uORF:IOH4029	1282	45	1237
B15R13C05	15-5-13	Hs~Ref:NM_134323.1~uORF:IOH6090	845	43	802
B15R13C06	15-6-13	Hs~Ref:NM_134323.1~uORF:IOH6090	857	42	815
B15R13C07	15-7-13	Hs~MGC:BC007637.1~uORF:IOH6973	637	38	599
B15R13C08	15-8-13	Hs~MGC:BC007637.1~uORF:IOH6973	528	41	487
B15R13C09	15-9-13	Hs~Ref:NM_012080.3~uORF:IOH54783	236	51	185
B15R13C10	15-10-13	Hs~Ref:NM_012080.3~uORF:IOH54783	227	54	173
B15R13C11	15-11-13	Hs~MGC:BC028059.1~uORF:IOH59056	911	68	843
B15R13C12	15-12-13	Hs~MGC:BC028059.1~uORF:IOH59056	18348	406	17942
B15R13C13	15-13-13	Hs~Ref:NM_018907.2~uORF:IOH61185	418	87	331
B15R13C14	15-14-13	Hs~Ref:NM_018907.2~uORF:IOH61185	434	209	225
B15R13C15	15-15-13	Hs~Ref:NM_014431.1~uORF:IOH60022	387	43	344
B15R13C16	15-16-13	Hs~Ref:NM_014431.1~uORF:IOH60022	361	41	320
B15R13C17	15-17-13	Hs~Ref:NM_138468.3~uORF:IOH40023	647	42	605
B15R13C18	15-18-13	Hs~Ref:NM_138468.3~uORF:IOH40023	770	42	728
B15R13C19	15-19-13	Hs~MGC:BC009348.2~uORF:IOH12064	1092	42	1050
B15R13C20	15-20-13	Hs~MGC:BC009348.2~uORF:IOH12064	1027	48	979
B15R13C21	15-21-13	Hs~MGC:BC000974.2~uORF:IOH3026	630	54	576
B15R13C22	15-22-13	Hs~MGC:BC000974.2~uORF:IOH3026	624	44	580
B15R14C01	15-1-14	Hs~Ref:NM_004461.1~uORF:IOH5778	509	41	468
B15R14C02	15-2-14	Hs~Ref:NM_004461.1~uORF:IOH5778	455	41	414
B15R14C03	15-3-14	Hs~MGC:BC035494.2~uORF:IOH29313	552	41	511
B15R14C04	15-4-14	Hs~MGC:BC035494.2~uORF:IOH29313	483	41	442
B15R14C05	15-5-14	Hs~MGC:BC056415.1~uORF:IOH29068	837	42	795
B15R14C06	15-6-14	Hs~MGC:BC056415.1~uORF:IOH29068	817	42	775
B15R14C07	15-7-14	Hs~MGC:BC054030.1~uORF:IOH29089	224	41	183
B15R14C08	15-8-14	Hs~MGC:BC054030.1~uORF:IOH29089	215	42	173
B15R14C09	15-9-14	Hs~MGC:BC023546.2~uORF:IOH29323	598	49	549
B15R14C10	15-10-14	Hs~MGC:BC023546.2~uORF:IOH29323	597	49	548
B15R14C11	15-11-14	Hs~MGC:BC001419.1~uORF:IOH4071	6541	46	6495
B15R14C12	15-12-14	Hs~MGC:BC001419.1~uORF:IOH4071	7987	43	7944
B15R14C13	15-13-14	Hs~Ref:NM_006432.2~uORF:IOH4108	184	42	142
B15R14C14	15-14-14	Hs~Ref:NM_006432.2~uORF:IOH4108	292	44	248
B15R14C15	15-15-14	Hs~Ref:NM_015994.2~uORF:IOH4090	313	48	265
B15R14C16	15-16-14	Hs~Ref:NM_015994.2~uORF:IOH4090	300	50	250
B15R14C17	15-17-14	Hs~Ref:NM_032959.3~uORF:IOH58642	188	53	135
B15R14C18	15-18-14	Hs~Ref:NM_032959.3~uORF:IOH58642	155	45	110
B15R14C19	15-19-14	Hs~MGC:BC051670.1~uORF:IOH61620	260	43	217
B15R14C20	15-20-14	Hs~MGC:BC051670.1~uORF:IOH61620	218	104	114
B15R14C21	15-21-14	Hs~MGC:BC032844.1~uORF:IOH61607	515	58	457
B15R14C22	15-22-14	Hs~MGC:BC032844.1~uORF:IOH61607	486	44	442
B15R15C01	15-1-15	Hs~Ref:NM_001040624.1~uORF:IOH61538	280	47	233
B15R15C02	15-2-15	Hs~Ref:NM_001040624.1~uORF:IOH61538	194	42	152
B15R15C03	15-3-15	Hs~MGC:BC009327.2~uORF:IOH12082	376	44	332
B15R15C04	15-4-15	Hs~MGC:BC009327.2~uORF:IOH12082	310	43	267
B15R15C05	15-5-15	Hs~MGC:BC013163.1~uORF:IOH28616	138	40	98
B15R15C06	15-6-15	Hs~MGC:BC013163.1~uORF:IOH28616	134	41	93
B15R15C07	15-7-15	Hs~MGC:BC036184.1~uORF:IOH62166	402	42	360
B15R15C08	15-8-15	Hs~MGC:BC036184.1~uORF:IOH62166	388	42	346
B15R15C09	15-9-15	Hs~MGC:BC063137.1~uORF:IOH62857	269	46	223
B15R15C10	15-10-15	Hs~MGC:BC063137.1~uORF:IOH62857	306	53	253
B15R15C11	15-11-15	Hs~MGC:BC073793.1~uORF:IOH63082	15940	44	15896
B15R15C12	15-12-15	Hs~MGC:BC073793.1~uORF:IOH63082	14792	45	14747
B15R15C13	15-13-15	Hs~Ref:NM_016276.3~CAT:PV3858	94	46	48
B15R15C14	15-14-15	Hs~Ref:NM_016276.3~CAT:PV3858	83	46	37
B15R15C15	15-15-15	Hs~Ref:NM_005044.1~CAT:PV3813	165	72	93
B15R15C16	15-16-15	Hs~Ref:NM_005044.1~CAT:PV3813	102	41	61
B15R15C17	15-17-15	Hs~Ref:NM_006213.1~CAT:PV3853	202	50	152
B15R15C18	15-18-15	Hs~Ref:NM_006213.1~CAT:PV3853	169	44	125
B15R15C19	15-19-15	Hs~Ref:NM_002750.2~CAT:PV3319	57	40	17
B15R15C20	15-20-15	Hs~Ref:NM_002750.2~CAT:PV3319	54	40	14
B15R15C21	15-21-15	Hs~Ref:NM_016653.1~CAT:PV3882	95	41	54
B15R15C22	15-22-15	Hs~Ref:NM_016653.1~CAT:PV3882	86	40	46
B15R16C01	15-1-16	Hs~Ref:NM_002446.2~CAT:PV3877	203	39	164
B15R16C02	15-2-16	Hs~Ref:NM_002446.2~CAT:PV3877	163	40	123
B15R16C03	15-3-16	Hs~Ref:NM_003331.1~CAT:PV4790	72	40	32
B15R16C04	15-4-16	Hs~Ref:NM_003331.1~CAT:PV4790	63	40	23
B15R16C05	15-5-16	Hs~Ref:NM_032294.2~CAT:PV4670	60	42	18
B15R16C06	15-6-16	Hs~Ref:NM_032294.2~CAT:PV4670	65	39	26
B15R16C07	15-7-16	Hs~MGC:BC090864.1~uORF:IOH62569	867	41	826
B15R16C08	15-8-16	Hs~MGC:BC090864.1~uORF:IOH62569	881	41	840
B15R16C09	15-9-16	Hs~MGC:BC103966.1~uORF:IOH63474	268	43	225
B15R16C10	15-10-16	Hs~MGC:BC103966.1~uORF:IOH63474	285	44	241
B15R16C11	15-11-16	Hs~MGC:BC067523.1~uORF:IOH62530	314	48	266
B15R16C12	15-12-16	Hs~MGC:BC067523.1~uORF:IOH62530	254	45	209
B15R16C13	15-13-16	Hs~MGC:BC099907.1~uORF:IOH62625	65535	48	65487
B15R16C14	15-14-16	Hs~MGC:BC099907.1~uORF:IOH62625	65535	47	65488
B15R16C15	15-15-16	Hs~MGC:BC057812.1~uORF:IOH29129	401	44	357
B15R16C16	15-16-16	Hs~MGC:BC057812.1~uORF:IOH29129	175	51	124
B15R16C17	15-17-16	Hs~MGC:BC036301.1~uORF:IOH26789	673	67	606
B15R16C18	15-18-16	Hs~MGC:BC036301.1~uORF:IOH26789	609	59	550
B15R16C19	15-19-16	Hs~Ref:NM_178571.2~uORF:IOH26524	527	48	479
B15R16C20	15-20-16	Hs~Ref:NM_178571.2~uORF:IOH26524	482	45	437
B15R16C21	15-21-16	Hs~Ref:NM_014015.3~uORF:IOH27586	316	90	226
B15R16C22	15-22-16	Hs~Ref:NM_014015.3~uORF:IOH27586	154	42	112
B15R17C01	15-1-17	Hs~MGC:BC020739.1~uORF:IOH14471	520	39	481
B15R17C02	15-2-17	Hs~MGC:BC020739.1~uORF:IOH14471	605	43	562
B15R17C03	15-3-17	Hs~Ref:NM_022372.2~uORF:IOH11516	544	59	485
B15R17C04	15-4-17	Hs~Ref:NM_022372.2~uORF:IOH11516	619	143	476
B15R17C05	15-5-17	Hs~MGC:BC017763.1~uORF:IOH14236	554	42	512
B15R17C06	15-6-17	Hs~MGC:BC017763.1~uORF:IOH14236	474	40	434
B15R17C07	15-7-17	Hs~Ref:NM_025221.4~uORF:IOH21934	253	40	213
B15R17C08	15-8-17	Hs~Ref:NM_025221.4~uORF:IOH21934	242	41	201
B15R17C09	15-9-17	Hs~MGC:BC048965.1~uORF:IOH62430	190	43	147
B15R17C10	15-10-17	Hs~MGC:BC048965.1~uORF:IOH62430	206	41	165
B15R17C11	15-11-17	Hs~Ref:NM_001029861.1~uORF:IOH62386	239	47	192
B15R17C12	15-12-17	Hs~Ref:NM_001029861.1~uORF:IOH62386	225	68	157
B15R17C13	15-13-17	Hs~MGC:BC066287.1~uORF:IOH61832	136	41	95
B15R17C14	15-14-17	Hs~MGC:BC066287.1~uORF:IOH61832	118	41	77
B15R17C15	15-15-17	Hs~MGC:BC071702.1~uORF:IOH61790	122	42	80
B15R17C16	15-16-17	Hs~MGC:BC071702.1~uORF:IOH61790	401	89	312
B15R17C17	15-17-17	Hs~MGC:BC005857.1~uORF:IOH5858	189	44	145
B15R17C18	15-18-17	Hs~MGC:BC005857.1~uORF:IOH5858	220	44	176
B15R17C19	15-19-17	Hs~MGC:BC006231.1~uORF:IOH6284	250	45	205
B15R17C20	15-20-17	Hs~MGC:BC006231.1~uORF:IOH6284	139	41	98
B15R17C21	15-21-17	Hs~MGC:BC007872.1~uORF:IOH6779	662	42	620
B15R17C22	15-22-17	Hs~MGC:BC007872.1~uORF:IOH6779	664	41	623
B15R18C01	15-1-18	Hs~Ref:NM_001827.1~uORF:IOH5978	229	41	188
B15R18C02	15-2-18	Hs~Ref:NM_001827.1~uORF:IOH5978	214	48	166
B15R18C03	15-3-18	Hs~MGC:BC032852.2~uORF:IOH27153	12955	52	12903
B15R18C04	15-4-18	Hs~MGC:BC032852.2~uORF:IOH27153	12921	50	12871
B15R18C05	15-5-18	Hs~Ref:NM_003188.2~uORF:IOH21077	287	43	244
B15R18C06	15-6-18	Hs~Ref:NM_003188.2~uORF:IOH21077	244	41	203
B15R18C07	15-7-18	Hs~MGC:BC035048.2~uORF:IOH27687	243	40	203
B15R18C08	15-8-18	Hs~MGC:BC035048.2~uORF:IOH27687	261	40	221
B15R18C09	15-9-18	Hs~Ref:NM_152864.2~uORF:IOH25895	149	41	108
B15R18C10	15-10-18	Hs~Ref:NM_152864.2~uORF:IOH25895	229	45	184
B15R18C11	15-11-18	Hs~Ref:NM_018230.2~uORF:IOH55812	362	43	319
B15R18C12	15-12-18	Hs~Ref:NM_018230.2~uORF:IOH55812	288	48	240
B15R18C13	15-13-18	Hs~Ref:NM_203290.1~uORF:IOH57020	280	44	236
B15R18C14	15-14-18	Hs~Ref:NM_203290.1~uORF:IOH57020	417	83	334
B15R18C15	15-15-18	Hs~Ref:NM_000302.2~uORF:IOH55655	135	42	93
B15R18C16	15-16-18	Hs~Ref:NM_000302.2~uORF:IOH55655	126	43	83
B15R18C17	15-17-18	Hs~MGC:BC008958.2~uORF:IOH56892	457	45	412
B15R18C18	15-18-18	Hs~MGC:BC008958.2~uORF:IOH56892	433	42	391
B15R18C19	15-19-18	Hs~Ref:NM_015978.1~N/A	375	40	335
B15R18C20	15-20-18	Hs~Ref:NM_015978.1~N/A	336	40	296
B15R18C21	15-21-18	Hs~Ref:NM_001895.1~N/A	364	40	324
B15R18C22	15-22-18	Hs~Ref:NM_001895.1~N/A	318	43	275
B15R19C01	15-1-19	Hs~Ref:NM_138993.1~N/A	295	41	254
B15R19C02	15-2-19	Hs~Ref:NM_138993.1~N/A	285	43	242
B15R19C03	15-3-19	Hs~Ref:NM_002740.1~N/A	290	41	249
B15R19C04	15-4-19	Hs~Ref:NM_002740.1~N/A	296	41	255
B15R19C05	15-5-19	Hs~Ref:NM_001178.3~uORF:IOH28764	303	43	260
B15R19C06	15-6-19	Hs~Ref:NM_001178.3~uORF:IOH28764	327	47	280
B15R19C07	15-7-19	Hs~Ref:NM_007199.1~uORF:IOH29139	125	42	83
B15R19C08	15-8-19	Hs~Ref:NM_007199.1~uORF:IOH29139	139	42	97
B15R19C09	15-9-19	Hs~MGC:BC011989.1~uORF:IOH11771	108	41	67
B15R19C10	15-10-19	Hs~MGC:BC011989.1~uORF:IOH11771	131	42	89
B15R19C11	15-11-19	Hs~Ref:NM_005437.1~uORF:IOH11864	983	42	941
B15R19C12	15-12-19	Hs~Ref:NM_005437.1~uORF:IOH11864	1138	44	1094
B15R19C13	15-13-19	Hs~Ref:NM_019000.2~uORF:IOH43613	295	52	243
B15R19C14	15-14-19	Hs~Ref:NM_019000.2~uORF:IOH43613	54	60	-6
B15R19C15	15-15-19	Hs~Ref:NM_001459.2~uORF:IOH40930	331	71	260
B15R19C16	15-16-19	Hs~Ref:NM_001459.2~uORF:IOH40930	158	43	115
B15R19C17	15-17-19	Hs~Ref:NM_203471.1~uORF:IOH44569	565	44	521
B15R19C18	15-18-19	Hs~Ref:NM_203471.1~uORF:IOH44569	548	45	503
B15R19C19	15-19-19	Hs~MGC:BC033005.1~uORF:IOH22281	338	41	297
B15R19C20	15-20-19	Hs~MGC:BC033005.1~uORF:IOH22281	363	41	322
B15R19C21	15-21-19	Hs~MGC:BC040499.1~uORF:IOH27240	582	43	539
B15R19C22	15-22-19	Hs~MGC:BC040499.1~uORF:IOH27240	49	44	5
B15R20C01	15-1-20	Hs~MGC:BC032309.1~uORF:IOH27536	418	42	376
B15R20C02	15-2-20	Hs~MGC:BC032309.1~uORF:IOH27536	460	42	418
B15R20C03	15-3-20	Hs~MGC:BC038807.1~uORF:IOH25914	419	42	377
B15R20C04	15-4-20	Hs~MGC:BC038807.1~uORF:IOH25914	432	43	389
B15R20C05	15-5-20	Hs~MGC:BC034726.1~uORF:IOH25776	328	42	286
B15R20C06	15-6-20	Hs~MGC:BC034726.1~uORF:IOH25776	374	41	333
B15R20C07	15-7-20	Hs~Ref:NM_015414.2~uORF:IOH4985	990	41	949
B15R20C08	15-8-20	Hs~Ref:NM_015414.2~uORF:IOH4985	820	41	779
B15R20C09	15-9-20	Hs~Ref:NM_014183.1~uORF:IOH4293	40	41	-1
B15R20C10	15-10-20	Hs~Ref:NM_014183.1~uORF:IOH4293	41	40	1
B15R20C11	15-11-20	Hs~MGC:BC016901.1~uORF:IOH11722	42	41	1
B15R20C12	15-12-20	Hs~MGC:BC016901.1~uORF:IOH11722	41	43	-2
B15R20C13	15-13-20	Hs~MGC:BC018111.1~uORF:IOH11272	526	49	477
B15R20C14	15-14-20	Hs~MGC:BC018111.1~uORF:IOH11272	515	51	464
B15R20C15	15-15-20	Hs~ENS:ENST00000309403~uORF:IOH28306	188	44	144
B15R20C16	15-16-20	Hs~ENS:ENST00000309403~uORF:IOH28306	194	47	147
B15R20C17	15-17-20	Hs~MGC:BC053859.1~uORF:IOH29027	462	62	400
B15R20C18	15-18-20	Hs~MGC:BC053859.1~uORF:IOH29027	474	64	410
B15R20C19	15-19-20	Hs~ENS:ENST00000305377~uORF:IOH28224	179	46	133
B15R20C20	15-20-20	Hs~ENS:ENST00000305377~uORF:IOH28224	89	42	47
B15R20C21	15-21-20	Hs~Ref:NM_004339.2~uORF:IOH10419	96	44	52
B15R20C22	15-22-20	Hs~Ref:NM_004339.2~uORF:IOH10419	276	46	230
B15R21C01	15-1-21	Hs~MGC:BC037285.2~uORF:IOH27156	113	41	72
B15R21C02	15-2-21	Hs~MGC:BC037285.2~uORF:IOH27156	126	63	63
B15R21C03	15-3-21	Hs~MGC:BC054880.1~uORF:IOH29453	228	44	184
B15R21C04	15-4-21	Hs~MGC:BC054880.1~uORF:IOH29453	99	43	56
B15R21C05	15-5-21	Hs~MGC:BC061519.1~uORF:IOH29299	124	55	69
B15R21C06	15-6-21	Hs~MGC:BC061519.1~uORF:IOH29299	132	42	90
B15R21C07	15-7-21	Hs~MGC:BC011770.1~uORF:IOH12546	577	106	471
B15R21C08	15-8-21	Hs~MGC:BC011770.1~uORF:IOH12546	140	42	98
B15R21C09	15-9-21	Hs~Ref:NP_079513.1~CAT_10593-H07H-25	44	41	3
B15R21C10	15-10-21	Hs~Ref:NP_079513.1~CAT_10593-H07H-25	46	41	5
B15R21C11	15-11-21	Internal_1007209	50	41	9
B15R21C12	15-12-21	Internal_1007209	50	41	9
B15R21C13	15-13-21	Hs~Ref:NP_002244.1~CAT_10012-H08H-25	66	42	24
B15R21C14	15-14-21	Hs~Ref:NP_002244.1~CAT_10012-H08H-25	41	45	-4
B15R21C15	15-15-21	Internal_1007209	52	43	9
B15R21C16	15-16-21	Internal_1007209	56	49	7
B15R21C17	15-17-21	Hs~Ref:NP_000408.1~CAT_10165-H02H-25	14175	70	14105
B15R21C18	15-18-21	Hs~Ref:NP_000408.1~CAT_10165-H02H-25	14077	61	14016
B15R21C19	15-19-21	Internal_1007209	47	43	4
B15R21C20	15-20-21	Internal_1007209	65	44	21
B15R21C21	15-21-21	Internal_1007209	60	44	16
B15R21C22	15-22-21	Internal_1007209	68	40	28
B15R22C01	15-1-22	ERa~N/A	2059	39	2020
B15R22C02	15-2-22	ERa~N/A	2120	39	2081
B15R22C03	15-3-22	PKCeta~N/A	168	40	128
B15R22C04	15-4-22	PKCeta~N/A	269	45	224
B15R22C05	15-5-22	Calmodulin~N/A	52	40	12
B15R22C06	15-6-22	Calmodulin~N/A	51	41	10
B15R22C07	15-7-22	V5control5~N/A	15786	41	15745
B15R22C08	15-8-22	V5control5~N/A	14455	42	14413
B15R22C09	15-9-22	V5control4~N/A	99	42	57
B15R22C10	15-10-22	V5control4~N/A	80	41	39
B15R22C11	15-11-22	V5control3~N/A	76	40	36
B15R22C12	15-12-22	V5control3~N/A	65	41	24
B15R22C13	15-13-22	V5control2~N/A	62	41	21
B15R22C14	15-14-22	V5control2~N/A	55	42	13
B15R22C15	15-15-22	V5control1~N/A	52	44	8
B15R22C16	15-16-22	V5control1~N/A	56	51	5
B15R22C17	15-17-22	CMK2A~N/A	590	46	544
B15R22C18	15-18-22	CMK2A~N/A	620	43	577
B15R22C19	15-19-22	ERa~N/A	1896	43	1853
B15R22C20	15-20-22	ERa~N/A	2254	45	2209
B15R22C21	15-21-22	AlexaAntiMouseAb~N/A	11119	45	11074
B15R22C22	15-22-22	AlexaAntiMouseAb~N/A	12273	41	12232
B16R01C01	16-1-1	AlexaAntiMouseAb~N/A	34557	41	34516
B16R01C02	16-2-1	AlexaAntiMouseAb~N/A	36316	42	36274
B16R01C03	16-3-1	ERa~N/A	1666	41	1625
B16R01C04	16-4-1	ERa~N/A	1693	41	1652
B16R01C05	16-5-1	HumanIgG1~N/A	937	40	897
B16R01C06	16-6-1	HumanIgG1~N/A	942	40	902
B16R01C07	16-7-1	HumanIgG2~N/A	3191	40	3151
B16R01C08	16-8-1	HumanIgG2~N/A	3117	40	3077
B16R01C09	16-9-1	HumanIgG3~N/A	13377	41	13336
B16R01C10	16-10-1	HumanIgG3~N/A	13174	44	13130
B16R01C11	16-11-1	HumanIgG4~N/A	37018	45	36973
B16R01C12	16-12-1	HumanIgG4~N/A	38782	45	38737
B16R01C13	16-13-1	BiotinAb~N/A	287	62	225
B16R01C14	16-14-1	BiotinAb~N/A	92	49	43
B16R01C15	16-15-1	RanBP2deltaFG~N/A	299	43	256
B16R01C16	16-16-1	RanBP2deltaFG~N/A	297	44	253
B16R01C17	16-17-1	hMDM2~N/A	977	46	931
B16R01C18	16-18-1	hMDM2~N/A	989	49	940
B16R01C19	16-19-1	PKCeta~N/A	350	42	308
B16R01C20	16-20-1	PKCeta~N/A	366	42	324
B16R01C21	16-21-1	AlexaAntiMouseAb~N/A	29740	44	29696
B16R01C22	16-22-1	AlexaAntiMouseAb~N/A	27530	44	27486
B16R02C01	16-1-2	PKCeta~N/A	1037	41	996
B16R02C02	16-2-2	PKCeta~N/A	1046	42	1004
B16R02C03	16-3-2	Buffer	341	44	297
B16R02C04	16-4-2	Buffer	314	46	268
B16R02C05	16-5-2	HumanIgA~N/A	19601	44	19557
B16R02C06	16-6-2	HumanIgA~N/A	20145	43	20102
B16R02C07	16-7-2	Buffer	163	58	105
B16R02C08	16-8-2	Buffer	91	40	51
B16R02C09	16-9-2	BSA~N/A	11473	42	11431
B16R02C10	16-10-2	BSA~N/A	11194	42	11152
B16R02C11	16-11-2	Hs~Ref:NM_013293.1~uORF:IOH9999	1306	44	1262
B16R02C12	16-12-2	Hs~Ref:NM_013293.1~uORF:IOH9999	1316	45	1271
B16R02C13	16-13-2	Hs~Ref:NM_015690.2~uORF:IOH11118	815	44	771
B16R02C14	16-14-2	Hs~Ref:NM_015690.2~uORF:IOH11118	637	46	591
B16R02C15	16-15-2	Hs~Ref:NM_006413.2~uORF:IOH7208	742	48	694
B16R02C16	16-16-2	Hs~Ref:NM_006413.2~uORF:IOH7208	754	48	706
B16R02C17	16-17-2	Hs~MGC:BC002509.1~uORF:IOH3968	479	49	430
B16R02C18	16-18-2	Hs~MGC:BC002509.1~uORF:IOH3968	482	48	434
B16R02C19	16-19-2	Hs~MGC:BC017660.1~uORF:IOH13777	820	48	772
B16R02C20	16-20-2	Hs~MGC:BC017660.1~uORF:IOH13777	833	46	787
B16R02C21	16-21-2	Hs~MGC:BC009350.1~uORF:IOH14087	903	47	856
B16R02C22	16-22-2	Hs~MGC:BC009350.1~uORF:IOH14087	658	47	611
B16R03C01	16-1-3	Hs~MGC:NM_173509.2~uORF:IOH14185	1333	40	1293
B16R03C02	16-2-3	Hs~MGC:NM_173509.2~uORF:IOH14185	1335	41	1294
B16R03C03	16-3-3	Hs~MGC:BC012576.1~uORF:IOH12217	1576	44	1532
B16R03C04	16-4-3	Hs~MGC:BC012576.1~uORF:IOH12217	1549	46	1503
B16R03C05	16-5-3	Hs~Ref:NM_145651.1~uORF:IOH40401	125	46	79
B16R03C06	16-6-3	Hs~Ref:NM_145651.1~uORF:IOH40401	125	45	80
B16R03C07	16-7-3	Hs~Ref:NM_030669.1~uORF:IOH36740	333	44	289
B16R03C08	16-8-3	Hs~Ref:NM_030669.1~uORF:IOH36740	323	44	279
B16R03C09	16-9-3	Hs~MGC:BC070089.1~uORF:IOH40551	306	48	258
B16R03C10	16-10-3	Hs~MGC:BC070089.1~uORF:IOH40551	284	43	241
B16R03C11	16-11-3	Hs~Ref:NM_001095.2~uORF:IOH36580	254	42	212
B16R03C12	16-12-3	Hs~Ref:NM_001095.2~uORF:IOH36580	326	45	281
B16R03C13	16-13-3	Hs~Ref:NM_000364.2~uORF:IOH44471	343	46	297
B16R03C14	16-14-3	Hs~Ref:NM_000364.2~uORF:IOH44471	209	44	165
B16R03C15	16-15-3	Hs~Ref:NM_002604.1~uORF:IOH35734	153	46	107
B16R03C16	16-16-3	Hs~Ref:NM_002604.1~uORF:IOH35734	271	115	156
B16R03C17	16-17-3	Hs~Ref:NM_182525.1~uORF:IOH44477	275	47	228
B16R03C18	16-18-3	Hs~Ref:NM_182525.1~uORF:IOH44477	127	43	84
B16R03C19	16-19-3	Hs~Ref:NM_018293.1~uORF:IOH35442	239	62	177
B16R03C20	16-20-3	Hs~Ref:NM_018293.1~uORF:IOH35442	200	51	149
B16R03C21	16-21-3	Hs~Ref:NM_012265.1~uORF:IOH5339	350	52	298
B16R03C22	16-22-3	Hs~Ref:NM_012265.1~uORF:IOH5339	56	60	-4
B16R04C01	16-1-4	Hs~Ref:NM_006686.2~uORF:IOH21791	394	46	348
B16R04C02	16-2-4	Hs~Ref:NM_006686.2~uORF:IOH21791	275	41	234
B16R04C03	16-3-4	Hs~Ref:NM_000690.1~uORF:IOH4924	387	43	344
B16R04C04	16-4-4	Hs~Ref:NM_000690.1~uORF:IOH4924	388	43	345
B16R04C05	16-5-4	Hs~MGC:BC015878.1~uORF:IOH23080	361	50	311
B16R04C06	16-6-4	Hs~MGC:BC015878.1~uORF:IOH23080	428	48	380
B16R04C07	16-7-4	Hs~MGC:BC015413.1~uORF:IOH10971	444	45	399
B16R04C08	16-8-4	Hs~MGC:BC015413.1~uORF:IOH10971	415	45	370
B16R04C09	16-9-4	Hs~Ref:NM_025026.1~uORF:IOH10990	698	43	655
B16R04C10	16-10-4	Hs~Ref:NM_025026.1~uORF:IOH10990	715	42	673
B16R04C11	16-11-4	Hs~MGC:BC015409.1~uORF:IOH10948	362	42	320
B16R04C12	16-12-4	Hs~MGC:BC015409.1~uORF:IOH10948	320	44	276
B16R04C13	16-13-4	Hs~Ref:NM_016176.2~uORF:IOH10229	342	45	297
B16R04C14	16-14-4	Hs~Ref:NM_016176.2~uORF:IOH10229	393	45	348
B16R04C15	16-15-4	Hs~MGC:BC035959.1~uORF:IOH27984	281	65	216
B16R04C16	16-16-4	Hs~MGC:BC035959.1~uORF:IOH27984	213	115	98
B16R04C17	16-17-4	Hs~Ref:NM_014920.2~uORF:IOH38087	987	54	933
B16R04C18	16-18-4	Hs~Ref:NM_014920.2~uORF:IOH38087	1037	47	990
B16R04C19	16-19-4	Hs~Ref:NM_017437.1~uORF:IOH38302	375	55	320
B16R04C20	16-20-4	Hs~Ref:NM_017437.1~uORF:IOH38302	503	190	313
B16R04C21	16-21-4	Hs~MGC:BC059360.1~uORF:IOH29131	305	69	236
B16R04C22	16-22-4	Hs~MGC:BC059360.1~uORF:IOH29131	192	59	133
B16R05C01	16-1-5	Hs~Ref:NM_080816.1~uORF:IOH12104	633	68	565
B16R05C02	16-2-5	Hs~Ref:NM_080816.1~uORF:IOH12104	389	60	329
B16R05C03	16-3-5	Hs~MGC:BC057803.1~uORF:IOH29253	431	187	244
B16R05C04	16-4-5	Hs~MGC:BC057803.1~uORF:IOH29253	533	63	470
B16R05C05	16-5-5	Hs~Ref:NM_199188.1~uORF:IOH38224	10724	59	10665
B16R05C06	16-6-5	Hs~Ref:NM_199188.1~uORF:IOH38224	10712	57	10655
B16R05C07	16-7-5	Hs~Ref:NM_020426.1~uORF:IOH29483	317	58	259
B16R05C08	16-8-5	Hs~Ref:NM_020426.1~uORF:IOH29483	296	64	232
B16R05C09	16-9-5	Hs~Ref:NM_006282.1~N/A	490	54	436
B16R05C10	16-10-5	Hs~Ref:NM_006282.1~N/A	402	52	350
B16R05C11	16-11-5	Hs~Ref:NM_001626.2~N/A	414	61	353
B16R05C12	16-12-5	Hs~Ref:NM_001626.2~N/A	458	63	395
B16R05C13	16-13-5	Hs~Ref:NM_001826.1~N/A	1156	91	1065
B16R05C14	16-14-5	Hs~Ref:NM_001826.1~N/A	746	80	666
B16R05C15	16-15-5	Hs~Ref:NM_001721.2~N/A	469	194	275
B16R05C16	16-16-5	Hs~Ref:NM_001721.2~N/A	443	427	16
B16R05C17	16-17-5	Hs~MGC:BC068448.1~uORF:IOH40093	445	238	207
B16R05C18	16-18-5	Hs~MGC:BC068448.1~uORF:IOH40093	530	389	141
B16R05C19	16-19-5	Hs~Ref:NM_003521.2~uORF:IOH40169	566	243	323
B16R05C20	16-20-5	Hs~Ref:NM_003521.2~uORF:IOH40169	753	107	646
B16R05C21	16-21-5	Hs~Ref:NM_017433.1~N/A	537	317	220
B16R05C22	16-22-5	Hs~Ref:NM_017433.1~N/A	465	54	411
B16R06C01	16-1-6	Hs~Ref:NM_020328.1~N/A	576	325	251
B16R06C02	16-2-6	Hs~Ref:NM_020328.1~N/A	649	416	233
B16R06C03	16-3-6	Hs~MGC:BC010519.1~uORF:IOH10222	1152	70	1082
B16R06C04	16-4-6	Hs~MGC:BC010519.1~uORF:IOH10222	1030	62	968
B16R06C05	16-5-6	Hs~MGC:BC020844.1~uORF:IOH12056	633	67	566
B16R06C06	16-6-6	Hs~MGC:BC020844.1~uORF:IOH12056	615	67	548
B16R06C07	16-7-6	Hs~MGC:BC017968.1~uORF:IOH14358	1073	66	1007
B16R06C08	16-8-6	Hs~MGC:BC017968.1~uORF:IOH14358	1017	74	943
B16R06C09	16-9-6	Hs~Ref:NM_138280.1~uORF:IOH22167	1049	67	982
B16R06C10	16-10-6	Hs~Ref:NM_138280.1~uORF:IOH22167	974	66	908
B16R06C11	16-11-6	Hs~MGC:BC035578.1~uORF:IOH27608	875	596	279
B16R06C12	16-12-6	Hs~MGC:BC035578.1~uORF:IOH27608	739	82	657
B16R06C13	16-13-6	Hs~Ref:NM_006907.2~uORF:IOH59071	572	81	491
B16R06C14	16-14-6	Hs~Ref:NM_006907.2~uORF:IOH59071	584	86	498
B16R06C15	16-15-6	Hs~Ref:NM_003287.2~uORF:IOH59709	2382	58	2324
B16R06C16	16-16-6	Hs~Ref:NM_003287.2~uORF:IOH59709	2902	69	2833
B16R06C17	16-17-6	Hs~MGC:BC010167.2~uORF:IOH13169	1061	236	825
B16R06C18	16-18-6	Hs~MGC:BC010167.2~uORF:IOH13169	1817	245	1572
B16R06C19	16-19-6	Hs~Ref:NM_174938.3~uORF:IOH27753	341	60	281
B16R06C20	16-20-6	Hs~Ref:NM_174938.3~uORF:IOH27753	305	62	243
B16R06C21	16-21-6	Hs~MGC:BC048251.1~uORF:IOH26606	386	81	305
B16R06C22	16-22-6	Hs~MGC:BC048251.1~uORF:IOH26606	225	114	111
B16R07C01	16-1-7	Hs~Ref:NM_033542.2~uORF:IOH26587	355	48	307
B16R07C02	16-2-7	Hs~Ref:NM_033542.2~uORF:IOH26587	352	53	299
B16R07C03	16-3-7	Hs~Ref:NM_173574.1~uORF:IOH27216	444	60	384
B16R07C04	16-4-7	Hs~Ref:NM_173574.1~uORF:IOH27216	404	56	348
B16R07C05	16-5-7	Hs~MGC:BC014353.1~uORF:IOH23005	226	67	159
B16R07C06	16-6-7	Hs~MGC:BC014353.1~uORF:IOH23005	240	75	165
B16R07C07	16-7-7	Hs~MGC:BC001755.1~uORF:IOH4451	1826	69	1757
B16R07C08	16-8-7	Hs~MGC:BC001755.1~uORF:IOH4451	1938	67	1871
B16R07C09	16-9-7	Hs~MGC:BC001103.1~uORF:IOH4657	727	392	335
B16R07C10	16-10-7	Hs~MGC:BC001103.1~uORF:IOH4657	601	71	530
B16R07C11	16-11-7	Hs~MGC:NM_152321.1~uORF:IOH22595	659	88	571
B16R07C12	16-12-7	Hs~MGC:NM_152321.1~uORF:IOH22595	826	644	182
B16R07C13	16-13-7	Hs~MGC:BC009198.1~uORF:IOH14404	350	68	282
B16R07C14	16-14-7	Hs~MGC:BC009198.1~uORF:IOH14404	314	67	247
B16R07C15	16-15-7	Hs~MGC:BC009825.2~uORF:IOH14857	341	56	285
B16R07C16	16-16-7	Hs~MGC:BC009825.2~uORF:IOH14857	226	87	139
B16R07C17	16-17-7	Hs~MGC:BC009297.1~uORF:IOH14160	550	66	484
B16R07C18	16-18-7	Hs~MGC:BC009297.1~uORF:IOH14160	488	76	412
B16R07C19	16-19-7	Hs~MGC:BC021234.2~uORF:IOH13820	684	366	318
B16R07C20	16-20-7	Hs~MGC:BC021234.2~uORF:IOH13820	689	71	618
B16R07C21	16-21-7	Hs~Ref:NM_006913.2~uORF:IOH3743	275	70	205
B16R07C22	16-22-7	Hs~Ref:NM_006913.2~uORF:IOH3743	244	69	175
B16R08C01	16-1-8	Hs~MGC:BC021134.1~uORF:IOH23115	763	46	717
B16R08C02	16-2-8	Hs~MGC:BC021134.1~uORF:IOH23115	476	54	422
B16R08C03	16-3-8	Hs~Ref:NM_001261.2~N/A	575	54	521
B16R08C04	16-4-8	Hs~Ref:NM_001261.2~N/A	469	64	405
B16R08C05	16-5-8	Hs~Ref:NM_003582.1~N/A	369	86	283
B16R08C06	16-6-8	Hs~Ref:NM_003582.1~N/A	886	176	710
B16R08C07	16-7-8	Hs~Ref:NM_003177.3~uORF:IOH4914	933	61	872
B16R08C08	16-8-8	Hs~Ref:NM_003177.3~uORF:IOH4914	816	60	756
B16R08C09	16-9-8	Hs~Ref:NM_000593.5~uORF:IOH14037	412	76	336
B16R08C10	16-10-8	Hs~Ref:NM_000593.5~uORF:IOH14037	395	300	95
B16R08C11	16-11-8	Hs~Ref:NM_004656.2~uORF:IOH4938	1008	66	942
B16R08C12	16-12-8	Hs~Ref:NM_004656.2~uORF:IOH4938	1020	73	947
B16R08C13	16-13-8	Hs~Ref:NM_003504.3~uORF:IOH6286	551	252	299
B16R08C14	16-14-8	Hs~Ref:NM_003504.3~uORF:IOH6286	590	68	522
B16R08C15	16-15-8	Hs~Ref:NM_032649.5~uORF:IOH42043	995	384	611
B16R08C16	16-16-8	Hs~Ref:NM_032649.5~uORF:IOH42043	811	56	755
B16R08C17	16-17-8	Hs~Ref:NM_153500.1~uORF:IOH37934	829	59	770
B16R08C18	16-18-8	Hs~Ref:NM_153500.1~uORF:IOH37934	806	54	752
B16R08C19	16-19-8	Hs~Ref:NM_002411.1~uORF:IOH50178	140	89	51
B16R08C20	16-20-8	Hs~Ref:NM_002411.1~uORF:IOH50178	449	95	354
B16R08C21	16-21-8	Hs~Ref:NM_032485.4~uORF:IOH36748	1032	49	983
B16R08C22	16-22-8	Hs~Ref:NM_032485.4~uORF:IOH36748	908	50	858
B16R09C01	16-1-9	Hs~Ref:NM_003524.2~uORF:IOH58715	495	44	451
B16R09C02	16-2-9	Hs~Ref:NM_003524.2~uORF:IOH58715	567	47	520
B16R09C03	16-3-9	Hs~Ref:NM_133494.1~uORF:IOH45126	3130	55	3075
B16R09C04	16-4-9	Hs~Ref:NM_133494.1~uORF:IOH45126	2868	58	2810
B16R09C05	16-5-9	Hs~Ref:NM_001006667.1~uORF:IOH58767	1325	59	1266
B16R09C06	16-6-9	Hs~Ref:NM_001006667.1~uORF:IOH58767	1333	57	1276
B16R09C07	16-7-9	Hs~Ref:NM_004830.2~uORF:IOH53662	213	163	50
B16R09C08	16-8-9	Hs~Ref:NM_004830.2~uORF:IOH53662	197	73	124
B16R09C09	16-9-9	Hs~Ref:NM_018131.3~uORF:IOH56860	714	53	661
B16R09C10	16-10-9	Hs~Ref:NM_018131.3~uORF:IOH56860	769	61	708
B16R09C11	16-11-9	Hs~Ref:NM_018448.2~uORF:IOH55833	234	52	182
B16R09C12	16-12-9	Hs~Ref:NM_018448.2~uORF:IOH55833	202	53	149
B16R09C13	16-13-9	Hs~Ref:NM_014547.3~uORF:IOH55947	551	57	494
B16R09C14	16-14-9	Hs~Ref:NM_014547.3~uORF:IOH55947	605	68	537
B16R09C15	16-15-9	Hs~Ref:NM_201998.1~uORF:IOH56887	33382	56	33326
B16R09C16	16-16-9	Hs~Ref:NM_201998.1~uORF:IOH56887	33590	51	33539
B16R09C17	16-17-9	Hs~Ref:NM_145206.1~uORF:IOH11028	394	210	184
B16R09C18	16-18-9	Hs~Ref:NM_145206.1~uORF:IOH11028	297	60	237
B16R09C19	16-19-9	Hs~MGC:BC015239.1~uORF:IOH10789	368	73	295
B16R09C20	16-20-9	Hs~MGC:BC015239.1~uORF:IOH10789	118	98	20
B16R09C21	16-21-9	Hs~Ref:NM_052935.1~uORF:IOH10842	344	61	283
B16R09C22	16-22-9	Hs~Ref:NM_052935.1~uORF:IOH10842	187	51	136
B16R10C01	16-1-10	Hs~MGC:BC025392.1~uORF:IOH10724	258	50	208
B16R10C02	16-2-10	Hs~MGC:BC025392.1~uORF:IOH10724	147	45	102
B16R10C03	16-3-10	Hs~Ref:NM_005770.3~uORF:IOH3348	663	46	617
B16R10C04	16-4-10	Hs~Ref:NM_005770.3~uORF:IOH3348	638	47	591
B16R10C05	16-5-10	Hs~MGC:BC005297.1~uORF:IOH7259	747	46	701
B16R10C06	16-6-10	Hs~MGC:BC005297.1~uORF:IOH7259	726	47	679
B16R10C07	16-7-10	Hs~Ref:NM_001328.1~uORF:IOH12818	342	281	61
B16R10C08	16-8-10	Hs~Ref:NM_001328.1~uORF:IOH12818	303	65	238
B16R10C09	16-9-10	Hs~MGC:BC001052.2~uORF:IOH3752	869	51	818
B16R10C10	16-10-10	Hs~MGC:BC001052.2~uORF:IOH3752	846	47	799
B16R10C11	16-11-10	GST1	41	43	-2
B16R10C12	16-12-10	GST1	45	43	2
B16R10C13	16-13-10	GST2	47	43	4
B16R10C14	16-14-10	GST2	47	46	1
B16R10C15	16-15-10	GST3	43	48	-5
B16R10C16	16-16-10	GST3	47	45	2
B16R10C17	16-17-10	GST4	56	48	8
B16R10C18	16-18-10	GST4	44	59	-15
B16R10C19	16-19-10	Anti-HumanIgA1~N/A	7402	48	7354
B16R10C20	16-20-10	Anti-HumanIgA1~N/A	6903	49	6854
B16R10C21	16-21-10	Anti-HumanIgA2~N/A	12891	55	12836
B16R10C22	16-22-10	Anti-HumanIgA2~N/A	12652	55	12597
B16R11C01	16-1-11	AlexaAntiMouseAb~N/A	23865	42	23823
B16R11C02	16-2-11	AlexaAntiMouseAb~N/A	22724	43	22681
B16R11C03	16-3-11	MAPKAP~N/A	85	44	41
B16R11C04	16-4-11	MAPKAP~N/A	108	61	47
B16R11C05	16-5-11	Buffer	398	46	352
B16R11C06	16-6-11	Buffer	422	44	378
B16R11C07	16-7-11	BSA~N/A	8266	47	8219
B16R11C08	16-8-11	BSA~N/A	8045	45	8000
B16R11C09	16-9-11	Anti-HumanIgG1~N/A	1577	42	1535
B16R11C10	16-10-11	Anti-HumanIgG1~N/A	1617	40	1577
B16R11C11	16-11-11	Anti-HumanIgG2~N/A	3119	41	3078
B16R11C12	16-12-11	Anti-HumanIgG2~N/A	2909	42	2867
B16R11C13	16-13-11	Anti-HumanIgG3~N/A	5304	42	5262
B16R11C14	16-14-11	Anti-HumanIgG3~N/A	5109	43	5066
B16R11C15	16-15-11	Anti-HumanIgG4~N/A	9838	46	9792
B16R11C16	16-16-11	Anti-HumanIgG4~N/A	9271	44	9227
B16R11C17	16-17-11	AntiBiotinAb~N/A	11444	44	11400
B16R11C18	16-18-11	AntiBiotinAb~N/A	11157	45	11112
B16R11C19	16-19-11	Buffer	45	44	1
B16R11C20	16-20-11	Buffer	43	44	-1
B16R11C21	16-21-11	Hs~Ref:NM_004311.1~uORF:IOH22951	566	53	513
B16R11C22	16-22-11	Hs~Ref:NM_004311.1~uORF:IOH22951	561	432	129
B16R12C01	16-1-12	Hs~Ref:NM_002774.2~uORF:IOH10423	566	42	524
B16R12C02	16-2-12	Hs~Ref:NM_002774.2~uORF:IOH10423	641	44	597
B16R12C03	16-3-12	Hs~MGC:NM_181503.1~uORF:IOH10049	438	46	392
B16R12C04	16-4-12	Hs~MGC:NM_181503.1~uORF:IOH10049	467	49	418
B16R12C05	16-5-12	Hs~MGC:BC017163.1~uORF:IOH10096	466	47	419
B16R12C06	16-6-12	Hs~MGC:BC017163.1~uORF:IOH10096	443	45	398
B16R12C07	16-7-12	Hs~Ref:NM_012383.2~uORF:IOH7180	766	41	725
B16R12C08	16-8-12	Hs~Ref:NM_012383.2~uORF:IOH7180	738	42	696
B16R12C09	16-9-12	Hs~MGC:BC005259.1~uORF:IOH7202	684	42	642
B16R12C10	16-10-12	Hs~MGC:BC005259.1~uORF:IOH7202	688	42	646
B16R12C11	16-11-12	Hs~MGC:BC026091.2~uORF:IOH11113	715	41	674
B16R12C12	16-12-12	Hs~MGC:BC026091.2~uORF:IOH11113	670	41	629
B16R12C13	16-13-12	Hs~Ref:NM_024668.1~uORF:IOH5012	797	43	754
B16R12C14	16-14-12	Hs~Ref:NM_024668.1~uORF:IOH5012	775	43	732
B16R12C15	16-15-12	Hs~Ref:NM_003735.2~uORF:IOH36258	218	52	166
B16R12C16	16-16-12	Hs~Ref:NM_003735.2~uORF:IOH36258	87	41	46
B16R12C17	16-17-12	Hs~Ref:NM_001003937.1~uORF:IOH40055	801	45	756
B16R12C18	16-18-12	Hs~Ref:NM_001003937.1~uORF:IOH40055	756	46	710
B16R12C19	16-19-12	Hs~MGC:BC063792.1~uORF:IOH40513	300	93	207
B16R12C20	16-20-12	Hs~MGC:BC063792.1~uORF:IOH40513	330	56	274
B16R12C21	16-21-12	Hs~Ref:NM_020525.4~uORF:IOH40162	127	72	55
B16R12C22	16-22-12	Hs~Ref:NM_020525.4~uORF:IOH40162	102	56	46
B16R13C01	16-1-13	Hs~Ref:NM_025161.2~uORF:IOH14763	605	52	553
B16R13C02	16-2-13	Hs~Ref:NM_025161.2~uORF:IOH14763	493	66	427
B16R13C03	16-3-13	Hs~Ref:NM_024060.1~uORF:IOH21405	488	101	387
B16R13C04	16-4-13	Hs~Ref:NM_024060.1~uORF:IOH21405	171	103	68
B16R13C05	16-5-13	Hs~MGC:BC009631.1~uORF:IOH21422	570	56	514
B16R13C06	16-6-13	Hs~MGC:BC009631.1~uORF:IOH21422	601	48	553
B16R13C07	16-7-13	Hs~MGC:NM_173541.1~uORF:IOH21426	663	50	613
B16R13C08	16-8-13	Hs~MGC:NM_173541.1~uORF:IOH21426	644	57	587
B16R13C09	16-9-13	Hs~Ref:NM_004927.1~uORF:IOH5582	241	51	190
B16R13C10	16-10-13	Hs~Ref:NM_004927.1~uORF:IOH5582	240	50	190
B16R13C11	16-11-13	Hs~MGC:BC002374.1~uORF:IOH3595	2682	51	2631
B16R13C12	16-12-13	Hs~MGC:BC002374.1~uORF:IOH3595	2634	54	2580
B16R13C13	16-13-13	Hs~MGC:BC000623.1~uORF:IOH4257	354	77	277
B16R13C14	16-14-13	Hs~MGC:BC000623.1~uORF:IOH4257	195	43	152
B16R13C15	16-15-13	Hs~MGC:BC002424.1~uORF:IOH4157	886	44	842
B16R13C16	16-16-13	Hs~MGC:BC002424.1~uORF:IOH4157	832	46	786
B16R13C17	16-17-13	Hs~MGC:BC037168.2~uORF:IOH29347	313	83	230
B16R13C18	16-18-13	Hs~MGC:BC037168.2~uORF:IOH29347	344	142	202
B16R13C19	16-19-13	Hs~MGC:BC054520.1~uORF:IOH28900	170	46	124
B16R13C20	16-20-13	Hs~MGC:BC054520.1~uORF:IOH28900	162	47	115
B16R13C21	16-21-13	Hs~MGC:BC052991.1~uORF:IOH28907	172	47	125
B16R13C22	16-22-13	Hs~MGC:BC052991.1~uORF:IOH28907	195	122	73
B16R14C01	16-1-14	Hs~MGC:BC032833.2~uORF:IOH28637	801	52	749
B16R14C02	16-2-14	Hs~MGC:BC032833.2~uORF:IOH28637	72	85	-13
B16R14C03	16-3-14	Hs~MGC:BC004236.2~uORF:IOH3887	640	105	535
B16R14C04	16-4-14	Hs~MGC:BC004236.2~uORF:IOH3887	751	101	650
B16R14C05	16-5-14	Hs~Ref:NM_031219.2~uORF:IOH6593	541	79	462
B16R14C06	16-6-14	Hs~Ref:NM_031219.2~uORF:IOH6593	1027	521	506
B16R14C07	16-7-14	Hs~Ref:NM_183373.2~uORF:IOH29104	617	88	529
B16R14C08	16-8-14	Hs~Ref:NM_183373.2~uORF:IOH29104	700	171	529
B16R14C09	16-9-14	Hs~Ref:NM_198204.1~uORF:IOH9777	911	142	769
B16R14C10	16-10-14	Hs~Ref:NM_198204.1~uORF:IOH9777	831	74	757
B16R14C11	16-11-14	Hs~Ref:NM_018032.2~uORF:IOH4849	968	81	887
B16R14C12	16-12-14	Hs~Ref:NM_018032.2~uORF:IOH4849	728	292	436
B16R14C13	16-13-14	Hs~Ref:NM_006459.1~uORF:IOH22186	454	58	396
B16R14C14	16-14-14	Hs~Ref:NM_006459.1~uORF:IOH22186	51	55	-4
B16R14C15	16-15-14	Hs~Ref:NM_002754.3~uORF:IOH3435	45	140	-95
B16R14C16	16-16-14	Hs~Ref:NM_002754.3~uORF:IOH3435	513	291	222
B16R14C17	16-17-14	Hs~MGC:BC001045.1~uORF:IOH4660	590	51	539
B16R14C18	16-18-14	Hs~MGC:BC001045.1~uORF:IOH4660	668	75	593
B16R14C19	16-19-14	Hs~MGC:BC002559.1~uORF:IOH4053	2048	62	1986
B16R14C20	16-20-14	Hs~MGC:BC002559.1~uORF:IOH4053	1849	63	1786
B16R14C21	16-21-14	Hs~MGC:NM_152912.3~uORF:IOH26907	736	49	687
B16R14C22	16-22-14	Hs~MGC:NM_152912.3~uORF:IOH26907	690	51	639
B16R15C01	16-1-15	Hs~MGC:BC048301.1~uORF:IOH26612	398	293	105
B16R15C02	16-2-15	Hs~MGC:BC048301.1~uORF:IOH26612	441	161	280
B16R15C03	16-3-15	Hs~Ref:NM_138413.1~uORF:IOH26880	261	48	213
B16R15C04	16-4-15	Hs~Ref:NM_138413.1~uORF:IOH26880	250	48	202
B16R15C05	16-5-15	Hs~Ref:NM_015869.2~uORF:IOH36704	304	58	246
B16R15C06	16-6-15	Hs~Ref:NM_015869.2~uORF:IOH36704	343	103	240
B16R15C07	16-7-15	Hs~Ref:NM_004882.3~uORF:IOH26927	1045	85	960
B16R15C08	16-8-15	Hs~Ref:NM_004882.3~uORF:IOH26927	1070	65	1005
B16R15C09	16-9-15	Hs~Ref:NM_000402.2~uORF:IOH2390	727	259	468
B16R15C10	16-10-15	Hs~Ref:NM_000402.2~uORF:IOH2390	890	340	550
B16R15C11	16-11-15	Hs~MGC:BC015548.1~uORF:IOH10351	964	619	345
B16R15C12	16-12-15	Hs~MGC:BC015548.1~uORF:IOH10351	736	93	643
B16R15C13	16-13-15	Hs~Ref:NM_001799.2~CAT:PV3868	259	52	207
B16R15C14	16-14-15	Hs~Ref:NM_001799.2~CAT:PV3868	202	48	154
B16R15C15	16-15-15	Hs~Ref:NM_001032296.2~CAT:PV3650	1027	682	345
B16R15C16	16-16-15	Hs~Ref:NM_001032296.2~CAT:PV3650	465	61	404
B16R15C17	16-17-15	Hs~Ref:NM_001319.5~CAT:PV3499	724	55	669
B16R15C18	16-18-15	Hs~Ref:NM_001319.5~CAT:PV3499	341	115	226
B16R15C19	16-19-15	Hs~Ref:NM_000142.2~CAT:PV4392	349	74	275
B16R15C20	16-20-15	Hs~Ref:NM_000142.2~CAT:PV4392	162	85	77
B16R15C21	16-21-15	Hs~N/A:NM_001005735.1~CAT:PV3367	244	56	188
B16R15C22	16-22-15	Hs~N/A:NM_001005735.1~CAT:PV3367	233	51	182
B16R16C01	16-1-16	Hs~Ref:NM_000899.3~CAT_PHC2116	166	47	119
B16R16C02	16-2-16	Hs~Ref:NM_000899.3~CAT_PHC2116	193	83	110
B16R16C03	16-3-16	Hs~Ref:NM_002608.1~CAT_PHG0046	150	54	96
B16R16C04	16-4-16	Hs~Ref:NM_002608.1~CAT_PHG0046	540	140	400
B16R16C05	16-5-16	Hs~Ref:NM_030906.2~CAT:PV4343	421	50	371
B16R16C06	16-6-16	Hs~Ref:NM_030906.2~CAT:PV4343	502	350	152
B16R16C07	16-7-16	Hs~Ref:NM_001001709.1~uORF:IOH58672	358	218	140
B16R16C08	16-8-16	Hs~Ref:NM_001001709.1~uORF:IOH58672	349	53	296
B16R16C09	16-9-16	Hs~MGC:BC032747.1~uORF:IOH56229	366	54	312
B16R16C10	16-10-16	Hs~MGC:BC032747.1~uORF:IOH56229	364	303	61
B16R16C11	16-11-16	Hs~Ref:NM_003980.3~uORF:IOH55674	1182	52	1130
B16R16C12	16-12-16	Hs~Ref:NM_003980.3~uORF:IOH55674	958	51	907
B16R16C13	16-13-16	Hs~Ref:NM_002192.2~uORF:IOH56970	199	59	140
B16R16C14	16-14-16	Hs~Ref:NM_002192.2~uORF:IOH56970	162	63	99
B16R16C15	16-15-16	Hs~MGC:BC025930.1~uORF:IOH57231	386	289	97
B16R16C16	16-16-16	Hs~MGC:BC025930.1~uORF:IOH57231	563	91	472
B16R16C17	16-17-16	Hs~Ref:NM_006844.3~uORF:IOH57193	145	53	92
B16R16C18	16-18-16	Hs~Ref:NM_006844.3~uORF:IOH57193	130	49	81
B16R16C19	16-19-16	Hs~Ref:NM_182720.1~uORF:IOH58613	299	80	219
B16R16C20	16-20-16	Hs~Ref:NM_182720.1~uORF:IOH58613	58	70	-12
B16R16C21	16-21-16	Hs~Ref:NM_199173.2~uORF:IOH58586	166	69	97
B16R16C22	16-22-16	Hs~Ref:NM_199173.2~uORF:IOH58586	339	55	284
B16R17C01	16-1-17	Hs~MGC:BC074742.2~uORF:IOH61949	125	43	82
B16R17C02	16-2-17	Hs~MGC:BC074742.2~uORF:IOH61949	108	49	59
B16R17C03	16-3-17	Hs~MGC:BC093743.1~uORF:IOH61985	282	49	233
B16R17C04	16-4-17	Hs~MGC:BC093743.1~uORF:IOH61985	513	68	445
B16R17C05	16-5-17	Hs~MGC:BC034045.1~uORF:IOH62046	211	91	120
B16R17C06	16-6-17	Hs~MGC:BC034045.1~uORF:IOH62046	196	58	138
B16R17C07	16-7-17	Hs~Ref:NM_001039656.1~uORF:IOH62081	764	60	704
B16R17C08	16-8-17	Hs~Ref:NM_001039656.1~uORF:IOH62081	744	629	115
B16R17C09	16-9-17	Hs~MGC:BC011562.1~uORF:IOH12462	486	58	428
B16R17C10	16-10-17	Hs~MGC:BC011562.1~uORF:IOH12462	460	57	403
B16R17C11	16-11-17	Hs~MGC:NM_153350.2~uORF:IOH22461	309	105	204
B16R17C12	16-12-17	Hs~MGC:NM_153350.2~uORF:IOH22461	264	52	212
B16R17C13	16-13-17	Hs~Ref:NM_000404.1~uORF:IOH5894	217	49	168
B16R17C14	16-14-17	Hs~Ref:NM_000404.1~uORF:IOH5894	150	52	98
B16R17C15	16-15-17	Hs~Ref:NM_022048.1~uORF:IOH21026	635	56	579
B16R17C16	16-16-17	Hs~Ref:NM_022048.1~uORF:IOH21026	714	61	653
B16R17C17	16-17-17	Hs~Ref:NM_016082.3~uORF:IOH45468	266	50	216
B16R17C18	16-18-17	Hs~Ref:NM_016082.3~uORF:IOH45468	316	53	263
B16R17C19	16-19-17	Hs~Ref:NM_004059.3~uORF:IOH45917	1054	67	987
B16R17C20	16-20-17	Hs~Ref:NM_004059.3~uORF:IOH45917	63	61	2
B16R17C21	16-21-17	Hs~Ref:NM_207316.1~uORF:IOH45939	299	55	244
B16R17C22	16-22-17	Hs~Ref:NM_207316.1~uORF:IOH45939	51	59	-8
B16R18C01	16-1-18	Hs~MGC:BC039362.1~uORF:IOH27730	226	46	180
B16R18C02	16-2-18	Hs~MGC:BC039362.1~uORF:IOH27730	223	50	173
B16R18C03	16-3-18	Hs~Ref:NM_006739.1~uORF:IOH2893	276	92	184
B16R18C04	16-4-18	Hs~Ref:NM_006739.1~uORF:IOH2893	342	55	287
B16R18C05	16-5-18	Hs~MGC:NM_014089.2~uORF:IOH4601	195	52	143
B16R18C06	16-6-18	Hs~MGC:NM_014089.2~uORF:IOH4601	272	50	222
B16R18C07	16-7-18	Hs~MGC:BC009780.1~uORF:IOH13685	510	187	323
B16R18C08	16-8-18	Hs~MGC:BC009780.1~uORF:IOH13685	398	53	345
B16R18C09	16-9-18	Hs~Ref:NM_024056.1~uORF:IOH3247	451	52	399
B16R18C10	16-10-18	Hs~Ref:NM_024056.1~uORF:IOH3247	454	57	397
B16R18C11	16-11-18	Hs~Ref:NM_012153.1~uORF:IOH26169	653	66	587
B16R18C12	16-12-18	Hs~Ref:NM_012153.1~uORF:IOH26169	921	101	820
B16R18C13	16-13-18	Hs~MGC:BC041164.1~uORF:IOH26258	207	53	154
B16R18C14	16-14-18	Hs~MGC:BC041164.1~uORF:IOH26258	225	49	176
B16R18C15	16-15-18	Hs~Ref:NM_058170.1~uORF:IOH10815	211	52	159
B16R18C16	16-16-18	Hs~Ref:NM_058170.1~uORF:IOH10815	189	53	136
B16R18C17	16-17-18	Hs~Ref:NM_005736.2~uORF:IOH4325	299	97	202
B16R18C18	16-18-18	Hs~Ref:NM_005736.2~uORF:IOH4325	245	53	192
B16R18C19	16-19-18	Hs~Ref:NM_001007067.1~uORF:IOH41337	347	53	294
B16R18C20	16-20-18	Hs~Ref:NM_001007067.1~uORF:IOH41337	366	55	311
B16R18C21	16-21-18	Hs~Ref:NM_198243.1~uORF:IOH42495	388	56	332
B16R18C22	16-22-18	Hs~Ref:NM_198243.1~uORF:IOH42495	55	68	-13
B16R19C01	16-1-19	Hs~Ref:NM_138809.1~uORF:IOH11307	506	44	462
B16R19C02	16-2-19	Hs~Ref:NM_138809.1~uORF:IOH11307	555	45	510
B16R19C03	16-3-19	Hs~MGC:BC035911.1~uORF:IOH25946	749	48	701
B16R19C04	16-4-19	Hs~MGC:BC035911.1~uORF:IOH25946	785	48	737
B16R19C05	16-5-19	Hs~MGC:NM_173796.2~uORF:IOH23049	176	45	131
B16R19C06	16-6-19	Hs~MGC:NM_173796.2~uORF:IOH23049	177	48	129
B16R19C07	16-7-19	Hs~Ref:NM_032757.1~uORF:IOH6930	515	110	405
B16R19C08	16-8-19	Hs~Ref:NM_032757.1~uORF:IOH6930	318	46	272
B16R19C09	16-9-19	Hs~MGC:BC008417.1~uORF:IOH7579	144	44	100
B16R19C10	16-10-19	Hs~MGC:BC008417.1~uORF:IOH7579	126	46	80
B16R19C11	16-11-19	Hs~MGC:BC000393.1~uORF:IOH3524	220	48	172
B16R19C12	16-12-19	Hs~MGC:BC000393.1~uORF:IOH3524	210	50	160
B16R19C13	16-13-19	Hs~Ref:NM_006911.2~uORF:IOH7561	68	60	8
B16R19C14	16-14-19	Hs~Ref:NM_006911.2~uORF:IOH7561	425	165	260
B16R19C15	16-15-19	Hs~Ref:NM_005112.4~uORF:IOH21634	1001	56	945
B16R19C16	16-16-19	Hs~Ref:NM_005112.4~uORF:IOH21634	1038	60	978
B16R19C17	16-17-19	Hs~Ref:NM_014055.2~uORF:IOH41832	526	181	345
B16R19C18	16-18-19	Hs~Ref:NM_014055.2~uORF:IOH41832	508	57	451
B16R19C19	16-19-19	Hs~Ref:NM_024787.2~uORF:IOH42086	262	48	214
B16R19C20	16-20-19	Hs~Ref:NM_024787.2~uORF:IOH42086	227	49	178
B16R19C21	16-21-19	Hs~Ref:NM_005127.2~uORF:IOH54638	49	63	-14
B16R19C22	16-22-19	Hs~Ref:NM_005127.2~uORF:IOH54638	100	64	36
B16R20C01	16-1-20	Hs~MGC:BC068530.1~uORF:IOH40123	98	43	55
B16R20C02	16-2-20	Hs~MGC:BC068530.1~uORF:IOH40123	104	44	60
B16R20C03	16-3-20	Hs~Ref:NM_015891.2~uORF:IOH44384	16257	46	16211
B16R20C04	16-4-20	Hs~Ref:NM_015891.2~uORF:IOH44384	16124	46	16078
B16R20C05	16-5-20	Hs~MGC:BC008726.1~N/A	2401	44	2357
B16R20C06	16-6-20	Hs~MGC:BC008726.1~N/A	2447	45	2402
B16R20C07	16-7-20	Hs~MGC:BC003595.1~uORF:IOH3758	150	45	105
B16R20C08	16-8-20	Hs~MGC:BC003595.1~uORF:IOH3758	184	50	134
B16R20C09	16-9-20	Hs~MGC:BC031997.1~uORF:IOH22163	52	42	10
B16R20C10	16-10-20	Hs~MGC:BC031997.1~uORF:IOH22163	326	54	272
B16R20C11	16-11-20	Hs~Ref:NM_002805.1~uORF:IOH3508	204	56	148
B16R20C12	16-12-20	Hs~Ref:NM_002805.1~uORF:IOH3508	221	101	120
B16R20C13	16-13-20	Hs~MGC:BC031661.1~uORF:IOH22763	120	45	75
B16R20C14	16-14-20	Hs~MGC:BC031661.1~uORF:IOH22763	114	46	68
B16R20C15	16-15-20	Hs~MGC:BC043437.2~uORF:IOH25863	1327	49	1278
B16R20C16	16-16-20	Hs~MGC:BC043437.2~uORF:IOH25863	1299	46	1253
B16R20C17	16-17-20	Hs~Ref:NM_020408.3~uORF:IOH57363	521	48	473
B16R20C18	16-18-20	Hs~Ref:NM_020408.3~uORF:IOH57363	775	50	725
B16R20C19	16-19-20	Hs~Ref:NM_001003841.1~uORF:IOH38150	51	50	1
B16R20C20	16-20-20	Hs~Ref:NM_001003841.1~uORF:IOH38150	65	53	12
B16R20C21	16-21-20	Hs~Ref:NM_197975.1~uORF:IOH34760	51	59	-8
B16R20C22	16-22-20	Hs~Ref:NM_197975.1~uORF:IOH34760	68	62	6
B16R21C01	16-1-21	Hs~Ref:NM_030782.2~uORF:IOH13343	292	43	249
B16R21C02	16-2-21	Hs~Ref:NM_030782.2~uORF:IOH13343	286	45	241
B16R21C03	16-3-21	Hs~MGC:BC033211.1~uORF:IOH23256	252	54	198
B16R21C04	16-4-21	Hs~MGC:BC033211.1~uORF:IOH23256	255	68	187
B16R21C05	16-5-21	Hs~MGC:BC025290.1~uORF:IOH13205	636	43	593
B16R21C06	16-6-21	Hs~MGC:BC025290.1~uORF:IOH13205	646	42	604
B16R21C07	16-7-21	Hs~MGC:BC021228.2~uORF:IOH12091	1166	43	1123
B16R21C08	16-8-21	Hs~MGC:BC021228.2~uORF:IOH12091	1225	42	1183
B16R21C09	16-9-21	Hs~Ref:NP_071762.2~CAT_11756-H08H-25	39	40	-1
B16R21C10	16-10-21	Hs~Ref:NP_071762.2~CAT_11756-H08H-25	41	41	0
B16R21C11	16-11-21	Internal_1007209	42	41	1
B16R21C12	16-12-21	Internal_1007209	42	41	1
B16R21C13	16-13-21	Hs~Ref:Q9UGN4-1~CAT_12449-H08H-25	43	41	2
B16R21C14	16-14-21	Hs~Ref:Q9UGN4-1~CAT_12449-H08H-25	43	41	2
B16R21C15	16-15-21	Internal_1007209	44	40	4
B16R21C16	16-16-21	Internal_1007209	43	40	3
B16R21C17	16-17-21	Hs~Ref:P08962-1~CAT_11271-H08H-25	39	41	-2
B16R21C18	16-18-21	Hs~Ref:P08962-1~CAT_11271-H08H-25	45	47	-2
B16R21C19	16-19-21	Internal_1007209	284	47	237
B16R21C20	16-20-21	Internal_1007209	46	44	2
B16R21C21	16-21-21	Internal_1007209	45	44	1
B16R21C22	16-22-21	Internal_1007209	44	45	-1
B16R22C01	16-1-22	ERa~N/A	2608	40	2568
B16R22C02	16-2-22	ERa~N/A	2605	42	2563
B16R22C03	16-3-22	PKCeta~N/A	193	42	151
B16R22C04	16-4-22	PKCeta~N/A	211	44	167
B16R22C05	16-5-22	Calmodulin~N/A	66	44	22
B16R22C06	16-6-22	Calmodulin~N/A	67	42	25
B16R22C07	16-7-22	V5control5~N/A	268	42	226
B16R22C08	16-8-22	V5control5~N/A	240	42	198
B16R22C09	16-9-22	V5control4~N/A	136	49	87
B16R22C10	16-10-22	V5control4~N/A	104	44	60
B16R22C11	16-11-22	V5control3~N/A	61	44	17
B16R22C12	16-12-22	V5control3~N/A	66	55	11
B16R22C13	16-13-22	V5control2~N/A	54	43	11
B16R22C14	16-14-22	V5control2~N/A	55	42	13
B16R22C15	16-15-22	V5control1~N/A	52	42	10
B16R22C16	16-16-22	V5control1~N/A	52	43	9
B16R22C17	16-17-22	CMK2A~N/A	658	50	608
B16R22C18	16-18-22	CMK2A~N/A	649	51	598
B16R22C19	16-19-22	ERa~N/A	2177	47	2130
B16R22C20	16-20-22	ERa~N/A	1845	46	1799
B16R22C21	16-21-22	AlexaAntiMouseAb~N/A	8263	47	8216
B16R22C22	16-22-22	AlexaAntiMouseAb~N/A	7879	47	7832
B17R01C01	17-1-1	AlexaAntiMouseAb~N/A	32193	35	32158
B17R01C02	17-2-1	AlexaAntiMouseAb~N/A	32590	35	32555
B17R01C03	17-3-1	ERa~N/A	1686	35	1651
B17R01C04	17-4-1	ERa~N/A	1889	35	1854
B17R01C05	17-5-1	HumanIgG1~N/A	571	35	536
B17R01C06	17-6-1	HumanIgG1~N/A	925	35	890
B17R01C07	17-7-1	HumanIgG2~N/A	1424	35	1389
B17R01C08	17-8-1	HumanIgG2~N/A	2097	35	2062
B17R01C09	17-9-1	HumanIgG3~N/A	8191	37	8154
B17R01C10	17-10-1	HumanIgG3~N/A	11689	38	11651
B17R01C11	17-11-1	HumanIgG4~N/A	24672	38	24634
B17R01C12	17-12-1	HumanIgG4~N/A	34079	39	34040
B17R01C13	17-13-1	BiotinAb~N/A	270	38	232
B17R01C14	17-14-1	BiotinAb~N/A	278	37	241
B17R01C15	17-15-1	RanBP2deltaFG~N/A	252	36	216
B17R01C16	17-16-1	RanBP2deltaFG~N/A	279	37	242
B17R01C17	17-17-1	hMDM2~N/A	573	36	537
B17R01C18	17-18-1	hMDM2~N/A	654	38	616
B17R01C19	17-19-1	PKCeta~N/A	323	42	281
B17R01C20	17-20-1	PKCeta~N/A	325	42	283
B17R01C21	17-21-1	AlexaAntiMouseAb~N/A	34607	39	34568
B17R01C22	17-22-1	AlexaAntiMouseAb~N/A	33928	39	33889
B17R02C01	17-1-2	PKCeta~N/A	702	34	668
B17R02C02	17-2-2	PKCeta~N/A	874	34	840
B17R02C03	17-3-2	Buffer	210	43	167
B17R02C04	17-4-2	Buffer	181	46	135
B17R02C05	17-5-2	HumanIgA~N/A	15876	35	15841
B17R02C06	17-6-2	HumanIgA~N/A	16656	35	16621
B17R02C07	17-7-2	Buffer	164	36	128
B17R02C08	17-8-2	Buffer	61	37	24
B17R02C09	17-9-2	BSA~N/A	10305	47	10258
B17R02C10	17-10-2	BSA~N/A	10602	42	10560
B17R02C11	17-11-2	Hs~MGC:BC010128.2~uORF:IOH12234	555	38	517
B17R02C12	17-12-2	Hs~MGC:BC010128.2~uORF:IOH12234	566	40	526
B17R02C13	17-13-2	Hs~Ref:NM_003280.1~uORF:IOH21526	331	53	278
B17R02C14	17-14-2	Hs~Ref:NM_003280.1~uORF:IOH21526	309	140	169
B17R02C15	17-15-2	Hs~MGC:NM_152353.1~uORF:IOH22553	414	42	372
B17R02C16	17-16-2	Hs~MGC:NM_152353.1~uORF:IOH22553	409	39	370
B17R02C17	17-17-2	Hs~MGC:BC011940.2~uORF:IOH12131	397	37	360
B17R02C18	17-18-2	Hs~MGC:BC011940.2~uORF:IOH12131	435	39	396
B17R02C19	17-19-2	Hs~MGC:BC032452.1~uORF:IOH21664	21008	46	20962
B17R02C20	17-20-2	Hs~MGC:BC032452.1~uORF:IOH21664	21946	45	21901
B17R02C21	17-21-2	Hs~MGC:BC032567.1~uORF:IOH21895	387	41	346
B17R02C22	17-22-2	Hs~MGC:BC032567.1~uORF:IOH21895	370	38	332
B17R03C01	17-1-3	Hs~Ref:NM_024900.2~uORF:IOH21646	381	33	348
B17R03C02	17-2-3	Hs~Ref:NM_024900.2~uORF:IOH21646	418	33	385
B17R03C03	17-3-3	Hs~MGC:BC032393.1~uORF:IOH21681	410	34	376
B17R03C04	17-4-3	Hs~MGC:BC032393.1~uORF:IOH21681	393	34	359
B17R03C05	17-5-3	Hs~MGC:BC018728.1~uORF:IOH14027	344	34	310
B17R03C06	17-6-3	Hs~MGC:BC018728.1~uORF:IOH14027	378	36	342
B17R03C07	17-7-3	Hs~Ref:NM_004492.1~uORF:IOH6006	388	35	353
B17R03C08	17-8-3	Hs~Ref:NM_004492.1~uORF:IOH6006	505	40	465
B17R03C09	17-9-3	Hs~Ref:NM_002904.4~uORF:IOH14621	13934	46	13888
B17R03C10	17-10-3	Hs~Ref:NM_002904.4~uORF:IOH14621	14630	43	14587
B17R03C11	17-11-3	Hs~Ref:NM_006815.2~uORF:IOH14559	317	42	275
B17R03C12	17-12-3	Hs~Ref:NM_006815.2~uORF:IOH14559	279	40	239
B17R03C13	17-13-3	Hs~Ref:NM_020830.1~uORF:IOH27506	207	49	158
B17R03C14	17-14-3	Hs~Ref:NM_020830.1~uORF:IOH27506	288	104	184
B17R03C15	17-15-3	Hs~MGC:BC034554.1~uORF:IOH25751	294	45	249
B17R03C16	17-16-3	Hs~MGC:BC034554.1~uORF:IOH25751	145	112	33
B17R03C17	17-17-3	Hs~Ref:NM_000071.1~uORF:IOH10211	367	38	329
B17R03C18	17-18-3	Hs~Ref:NM_000071.1~uORF:IOH10211	362	37	325
B17R03C19	17-19-3	Hs~Ref:NM_003805.2~uORF:IOH10393	455	40	415
B17R03C20	17-20-3	Hs~Ref:NM_003805.2~uORF:IOH10393	459	40	419
B17R03C21	17-21-3	Hs~MGC:BC005911.1~uORF:IOH7548	375	39	336
B17R03C22	17-22-3	Hs~MGC:BC005911.1~uORF:IOH7548	343	37	306
B17R04C01	17-1-4	Hs~Ref:NM_001983.1~uORF:IOH5754	767	33	734
B17R04C02	17-2-4	Hs~Ref:NM_001983.1~uORF:IOH5754	807	34	773
B17R04C03	17-3-4	Hs~Ref:NM_032712.1~uORF:IOH6582	631	35	596
B17R04C04	17-4-4	Hs~Ref:NM_032712.1~uORF:IOH6582	659	34	625
B17R04C05	17-5-4	Hs~Ref:NM_025108.1~uORF:IOH13954	7302	34	7268
B17R04C06	17-6-4	Hs~Ref:NM_025108.1~uORF:IOH13954	8001	37	7964
B17R04C07	17-7-4	Hs~Ref:NM_032461.2~uORF:IOH22292	369	38	331
B17R04C08	17-8-4	Hs~Ref:NM_032461.2~uORF:IOH22292	363	37	326
B17R04C09	17-9-4	Hs~MGC:BC036365.1~uORF:IOH22309	677	35	642
B17R04C10	17-10-4	Hs~MGC:BC036365.1~uORF:IOH22309	693	35	658
B17R04C11	17-11-4	Hs~Ref:NM_147180.1~uORF:IOH22320	299	61	238
B17R04C12	17-12-4	Hs~Ref:NM_147180.1~uORF:IOH22320	213	102	111
B17R04C13	17-13-4	Hs~MGC:BC014607.2~uORF:IOH10910	382	79	303
B17R04C14	17-14-4	Hs~MGC:BC014607.2~uORF:IOH10910	262	169	93
B17R04C15	17-15-4	Hs~Ref:NM_006120.2~uORF:IOH12744	339	40	299
B17R04C16	17-16-4	Hs~Ref:NM_006120.2~uORF:IOH12744	313	38	275
B17R04C17	17-17-4	Hs~MGC:BC007833.2~uORF:IOH6700	375	36	339
B17R04C18	17-18-4	Hs~MGC:BC007833.2~uORF:IOH6700	385	36	349
B17R04C19	17-19-4	Hs~Ref:NM_153339.1~uORF:IOH22364	595	37	558
B17R04C20	17-20-4	Hs~Ref:NM_153339.1~uORF:IOH22364	629	36	593
B17R04C21	17-21-4	Hs~MGC:NM_152542.2~uORF:IOH27547	327	37	290
B17R04C22	17-22-4	Hs~MGC:NM_152542.2~uORF:IOH27547	325	36	289
B17R05C01	17-1-5	Hs~Ref:NM_130809.2~uORF:IOH40868	232	35	197
B17R05C02	17-2-5	Hs~Ref:NM_130809.2~uORF:IOH40868	219	35	184
B17R05C03	17-3-5	Hs~MGC:BC026030.1~uORF:IOH14611	784	35	749
B17R05C04	17-4-5	Hs~MGC:BC026030.1~uORF:IOH14611	844	34	810
B17R05C05	17-5-5	Hs~Ref:NM_019617.2~uORF:IOH39863	249	35	214
B17R05C06	17-6-5	Hs~Ref:NM_019617.2~uORF:IOH39863	258	37	221
B17R05C07	17-7-5	Hs~Ref:NM_000376.1~uORF:IOH39811	335	39	296
B17R05C08	17-8-5	Hs~Ref:NM_000376.1~uORF:IOH39811	331	37	294
B17R05C09	17-9-5	Hs~MGC:BC017785.1~uORF:IOH12191	822	36	786
B17R05C10	17-10-5	Hs~MGC:BC017785.1~uORF:IOH12191	854	35	819
B17R05C11	17-11-5	Hs~MGC:BC017589.2~uORF:IOH10834	501	38	463
B17R05C12	17-12-5	Hs~MGC:BC017589.2~uORF:IOH10834	504	39	465
B17R05C13	17-13-5	Hs~Ref:NM_032140.1~uORF:IOH6250	4591	44	4547
B17R05C14	17-14-5	Hs~Ref:NM_032140.1~uORF:IOH6250	5155	47	5108
B17R05C15	17-15-5	Hs~Ref:NM_007099.1~uORF:IOH6098	1066	45	1021
B17R05C16	17-16-5	Hs~Ref:NM_007099.1~uORF:IOH6098	1097	39	1058
B17R05C17	17-17-5	Hs~MGC:BC020898.1~uORF:IOH13022	197	41	156
B17R05C18	17-18-5	Hs~MGC:BC020898.1~uORF:IOH13022	126	45	81
B17R05C19	17-19-5	Hs~Ref:NM_016490.3~uORF:IOH40879	217	52	165
B17R05C20	17-20-5	Hs~Ref:NM_016490.3~uORF:IOH40879	51	38	13
B17R05C21	17-21-5	Hs~Ref:NM_024697.1~uORF:IOH6898	219	51	168
B17R05C22	17-22-5	Hs~Ref:NM_024697.1~uORF:IOH6898	58	39	19
B17R06C01	17-1-6	Hs~MGC:BC060863.1~uORF:IOH29170	146	36	110
B17R06C02	17-2-6	Hs~MGC:BC060863.1~uORF:IOH29170	66	35	31
B17R06C03	17-3-6	Hs~Ref:NM_020142.2~uORF:IOH12540	333	35	298
B17R06C04	17-4-6	Hs~Ref:NM_020142.2~uORF:IOH12540	328	35	293
B17R06C05	17-5-6	Hs~MGC:BC012120.1~uORF:IOH12484	389	35	354
B17R06C06	17-6-6	Hs~MGC:BC012120.1~uORF:IOH12484	411	35	376
B17R06C07	17-7-6	Hs~Ref:NM_007271.1~uORF:IOH13030	542	35	507
B17R06C08	17-8-6	Hs~Ref:NM_007271.1~uORF:IOH13030	551	36	515
B17R06C09	17-9-6	Hs~Ref:NM_014034.1~uORF:IOH12142	351	40	311
B17R06C10	17-10-6	Hs~Ref:NM_014034.1~uORF:IOH12142	339	39	300
B17R06C11	17-11-6	Hs~Ref:NM_053055.2~uORF:IOH39985	961	36	925
B17R06C12	17-12-6	Hs~Ref:NM_053055.2~uORF:IOH39985	1146	36	1110
B17R06C13	17-13-6	Hs~Ref:NM_002540.3~uORF:IOH40890	446	37	409
B17R06C14	17-14-6	Hs~Ref:NM_002540.3~uORF:IOH40890	528	41	487
B17R06C15	17-15-6	Hs~Ref:NM_001007246.1~uORF:IOH39941	961	44	917
B17R06C16	17-16-6	Hs~Ref:NM_001007246.1~uORF:IOH39941	940	40	900
B17R06C17	17-17-6	Hs~Ref:NM_175614.2~uORF:IOH40018	270	44	226
B17R06C18	17-18-6	Hs~Ref:NM_175614.2~uORF:IOH40018	259	48	211
B17R06C19	17-19-6	Hs~Ref:NM_018222.2~uORF:IOH27894	379	37	342
B17R06C20	17-20-6	Hs~Ref:NM_018222.2~uORF:IOH27894	369	37	332
B17R06C21	17-21-6	Hs~MGC:BC051304.1~uORF:IOH28074	356	43	313
B17R06C22	17-22-6	Hs~MGC:BC051304.1~uORF:IOH28074	330	40	290
B17R07C01	17-1-7	Hs~MGC:BC011719.1~uORF:IOH27841	310	72	238
B17R07C02	17-2-7	Hs~MGC:BC011719.1~uORF:IOH27841	248	41	207
B17R07C03	17-3-7	Hs~MGC:BC017917.1~uORF:IOH27928	325	37	288
B17R07C04	17-4-7	Hs~MGC:BC017917.1~uORF:IOH27928	362	36	326
B17R07C05	17-5-7	Hs~MGC:BC029482.1~uORF:IOH27979	371	37	334
B17R07C06	17-6-7	Hs~MGC:BC029482.1~uORF:IOH27979	382	36	346
B17R07C07	17-7-7	Hs~MGC:NM_199001.1~uORF:IOH28105	718	35	683
B17R07C08	17-8-7	Hs~MGC:NM_199001.1~uORF:IOH28105	771	35	736
B17R07C09	17-9-7	Hs~Ref:NM_007054.1~uORF:IOH26900	810	37	773
B17R07C10	17-10-7	Hs~Ref:NM_007054.1~uORF:IOH26900	866	38	828
B17R07C11	17-11-7	Hs~MGC:BC044590.1~uORF:IOH26759	284	40	244
B17R07C12	17-12-7	Hs~MGC:BC044590.1~uORF:IOH26759	254	38	216
B17R07C13	17-13-7	Hs~Ref:NM_009588.1~uORF:IOH44736	518	37	481
B17R07C14	17-14-7	Hs~Ref:NM_009588.1~uORF:IOH44736	483	36	447
B17R07C15	17-15-7	Hs~Ref:NM_000415.1~uORF:IOH43658	743	35	708
B17R07C16	17-16-7	Hs~Ref:NM_000415.1~uORF:IOH43658	765	36	729
B17R07C17	17-17-7	Hs~Ref:NM_173578.1~uORF:IOH42338	1071	36	1035
B17R07C18	17-18-7	Hs~Ref:NM_173578.1~uORF:IOH42338	1079	37	1042
B17R07C19	17-19-7	Hs~Ref:NM_024492.2~uORF:IOH42061	610	37	573
B17R07C20	17-20-7	Hs~Ref:NM_024492.2~uORF:IOH42061	638	40	598
B17R07C21	17-21-7	Hs~MGC:BC022098.1~uORF:IOH14790	13467	44	13423
B17R07C22	17-22-7	Hs~MGC:BC022098.1~uORF:IOH14790	14496	39	14457
B17R08C01	17-1-8	Hs~Ref:NM_004722.2~uORF:IOH14632	1155	34	1121
B17R08C02	17-2-8	Hs~Ref:NM_004722.2~uORF:IOH14632	1234	36	1198
B17R08C03	17-3-8	Hs~MGC:BC025281.1~uORF:IOH14071	1083	35	1048
B17R08C04	17-4-8	Hs~MGC:BC025281.1~uORF:IOH14071	1110	36	1074
B17R08C05	17-5-8	Hs~Ref:NM_144608.1~uORF:IOH14178	861	35	826
B17R08C06	17-6-8	Hs~Ref:NM_144608.1~uORF:IOH14178	867	35	832
B17R08C07	17-7-8	Hs~MGC:BC012547.1~uORF:IOH14261	438	34	404
B17R08C08	17-8-8	Hs~MGC:BC012547.1~uORF:IOH14261	429	35	394
B17R08C09	17-9-8	Hs~Ref:NM_031302.2~uORF:IOH13397	147	36	111
B17R08C10	17-10-8	Hs~Ref:NM_031302.2~uORF:IOH13397	83	38	45
B17R08C11	17-11-8	Hs~MGC:BC004424.1~uORF:IOH5017	390	38	352
B17R08C12	17-12-8	Hs~MGC:BC004424.1~uORF:IOH5017	370	36	334
B17R08C13	17-13-8	Hs~Ref:NM_032567.1~uORF:IOH21814	1360	36	1324
B17R08C14	17-14-8	Hs~Ref:NM_032567.1~uORF:IOH21814	1449	36	1413
B17R08C15	17-15-8	Hs~Ref:NM_018285.1~uORF:IOH10307	350	35	315
B17R08C16	17-16-8	Hs~Ref:NM_018285.1~uORF:IOH10307	389	35	354
B17R08C17	17-17-8	Hs~MGC:BC017423.1~uORF:IOH12806	302	37	265
B17R08C18	17-18-8	Hs~MGC:BC017423.1~uORF:IOH12806	304	38	266
B17R08C19	17-19-8	Hs~Ref:NM_017848.1~uORF:IOH11276	361	39	322
B17R08C20	17-20-8	Hs~Ref:NM_017848.1~uORF:IOH11276	352	42	310
B17R08C21	17-21-8	Hs~MGC:BC006182.1~uORF:IOH5966	309	61	248
B17R08C22	17-22-8	Hs~MGC:BC006182.1~uORF:IOH5966	255	46	209
B17R09C01	17-1-9	Hs~Ref:NM_002177.1~uORF:IOH35249	411	34	377
B17R09C02	17-2-9	Hs~Ref:NM_002177.1~uORF:IOH35249	421	35	386
B17R09C03	17-3-9	Hs~Ref:NM_004383.1~uORF:IOH29870	498	35	463
B17R09C04	17-4-9	Hs~Ref:NM_004383.1~uORF:IOH29870	482	35	447
B17R09C05	17-5-9	Hs~Ref:NM_020646.1~uORF:IOH35199	741	35	706
B17R09C06	17-6-9	Hs~Ref:NM_020646.1~uORF:IOH35199	766	35	731
B17R09C07	17-7-9	Hs~Ref:NM_012315.1~uORF:IOH35357	566	35	531
B17R09C08	17-8-9	Hs~Ref:NM_012315.1~uORF:IOH35357	560	35	525
B17R09C09	17-9-9	Hs~Ref:NM_000045.2~uORF:IOH14233	407	37	370
B17R09C10	17-10-9	Hs~Ref:NM_000045.2~uORF:IOH14233	435	37	398
B17R09C11	17-11-9	Hs~Ref:NM_004508.1~uORF:IOH7273	301	37	264
B17R09C12	17-12-9	Hs~Ref:NM_004508.1~uORF:IOH7273	331	37	294
B17R09C13	17-13-9	Hs~MGC:BC022374.1~uORF:IOH14795	282	38	244
B17R09C14	17-14-9	Hs~MGC:BC022374.1~uORF:IOH14795	263	41	222
B17R09C15	17-15-9	Hs~Ref:NM_002960.1~uORF:IOH11798	305	36	269
B17R09C16	17-16-9	Hs~Ref:NM_002960.1~uORF:IOH11798	306	36	270
B17R09C17	17-17-9	Hs~MGC:BC005169.1~uORF:IOH5215	298	40	258
B17R09C18	17-18-9	Hs~MGC:BC005169.1~uORF:IOH5215	287	39	248
B17R09C19	17-19-9	Hs~MGC:BC001213.1~uORF:IOH4785	325	42	283
B17R09C20	17-20-9	Hs~MGC:BC001213.1~uORF:IOH4785	295	44	251
B17R09C21	17-21-9	Hs~Ref:NM_002946.2~uORF:IOH4896	462	44	418
B17R09C22	17-22-9	Hs~Ref:NM_002946.2~uORF:IOH4896	461	40	421
B17R10C01	17-1-10	Hs~Ref:NM_024057.1~uORF:IOH3194	362	36	326
B17R10C02	17-2-10	Hs~Ref:NM_024057.1~uORF:IOH3194	337	36	301
B17R10C03	17-3-10	Hs~Ref:NM_078467.1~uORF:IOH4470	889	36	853
B17R10C04	17-4-10	Hs~Ref:NM_078467.1~uORF:IOH4470	939	35	904
B17R10C05	17-5-10	Hs~MGC:BC025727.1~uORF:IOH11431	701	36	665
B17R10C06	17-6-10	Hs~MGC:BC025727.1~uORF:IOH11431	677	36	641
B17R10C07	17-7-10	Hs~MGC:BC011878.2~uORF:IOH13403	691	35	656
B17R10C08	17-8-10	Hs~MGC:BC011878.2~uORF:IOH13403	705	36	669
B17R10C09	17-9-10	Hs~MGC:BC010117.1~uORF:IOH13999	457	36	421
B17R10C10	17-10-10	Hs~MGC:BC010117.1~uORF:IOH13999	452	36	416
B17R10C11	17-11-10	GST1	115	36	79
B17R10C12	17-12-10	GST1	38	35	3
B17R10C13	17-13-10	GST2	178	35	143
B17R10C14	17-14-10	GST2	50	35	15
B17R10C15	17-15-10	GST3	155	35	120
B17R10C16	17-16-10	GST3	43	35	8
B17R10C17	17-17-10	GST4	133	37	96
B17R10C18	17-18-10	GST4	54	36	18
B17R10C19	17-19-10	Anti-HumanIgA1~N/A	6569	37	6532
B17R10C20	17-20-10	Anti-HumanIgA1~N/A	8216	38	8178
B17R10C21	17-21-10	Anti-HumanIgA2~N/A	13242	37	13205
B17R10C22	17-22-10	Anti-HumanIgA2~N/A	14802	37	14765
B17R11C01	17-1-11	AlexaAntiMouseAb~N/A	19387	35	19352
B17R11C02	17-2-11	AlexaAntiMouseAb~N/A	21897	35	21862
B17R11C03	17-3-11	MAPKAP~N/A	184	50	134
B17R11C04	17-4-11	MAPKAP~N/A	63	45	18
B17R11C05	17-5-11	Buffer	846	34	812
B17R11C06	17-6-11	Buffer	1117	34	1083
B17R11C07	17-7-11	BSA~N/A	7505	35	7470
B17R11C08	17-8-11	BSA~N/A	7698	35	7663
B17R11C09	17-9-11	Anti-HumanIgG1~N/A	968	35	933
B17R11C10	17-10-11	Anti-HumanIgG1~N/A	1356	35	1321
B17R11C11	17-11-11	Anti-HumanIgG2~N/A	2306	35	2271
B17R11C12	17-12-11	Anti-HumanIgG2~N/A	3118	36	3082
B17R11C13	17-13-11	Anti-HumanIgG3~N/A	38	37	1
B17R11C14	17-14-11	Anti-HumanIgG3~N/A	35	36	-1
B17R11C15	17-15-11	Anti-HumanIgG4~N/A	36	34	2
B17R11C16	17-16-11	Anti-HumanIgG4~N/A	36	34	2
B17R11C17	17-17-11	AntiBiotinAb~N/A	349	35	314
B17R11C18	17-18-11	AntiBiotinAb~N/A	36	35	1
B17R11C19	17-19-11	Buffer	36	35	1
B17R11C20	17-20-11	Buffer	35	34	1
B17R11C21	17-21-11	Hs~Ref:NM_014312.3~uORF:IOH5839	149	35	114
B17R11C22	17-22-11	Hs~Ref:NM_014312.3~uORF:IOH5839	35	35	0
B17R12C01	17-1-12	Hs~Ref:NM_000550.1~uORF:IOH29383	34	34	0
B17R12C02	17-2-12	Hs~Ref:NM_000550.1~uORF:IOH29383	33	34	-1
B17R12C03	17-3-12	Hs~Ref:NM_015849.2~uORF:IOH40271	34	33	1
B17R12C04	17-4-12	Hs~Ref:NM_015849.2~uORF:IOH40271	34	34	0
B17R12C05	17-5-12	Hs~MGC:BC058288.1~uORF:IOH29443	40	34	6
B17R12C06	17-6-12	Hs~MGC:BC058288.1~uORF:IOH29443	34	34	0
B17R12C07	17-7-12	Hs~MGC:BC040280.1~uORF:IOH27452	798	34	764
B17R12C08	17-8-12	Hs~MGC:BC040280.1~uORF:IOH27452	853	35	818
B17R12C09	17-9-12	Hs~MGC:BC051835.1~uORF:IOH27073	553	36	517
B17R12C10	17-10-12	Hs~MGC:BC051835.1~uORF:IOH27073	485	35	450
B17R12C11	17-11-12	Hs~MGC:BC047016.1~uORF:IOH26591	633	34	599
B17R12C12	17-12-12	Hs~MGC:BC047016.1~uORF:IOH26591	668	36	632
B17R12C13	17-13-12	Hs~Ref:NM_032338.2~uORF:IOH7537	741	44	697
B17R12C14	17-14-12	Hs~Ref:NM_032338.2~uORF:IOH7537	717	43	674
B17R12C15	17-15-12	Hs~Ref:NM_198097.1~uORF:IOH13150	256	52	204
B17R12C16	17-16-12	Hs~Ref:NM_198097.1~uORF:IOH13150	238	37	201
B17R12C17	17-17-12	Hs~Ref:NM_006443.2~uORF:IOH12302	301	37	264
B17R12C18	17-18-12	Hs~Ref:NM_006443.2~uORF:IOH12302	234	59	175
B17R12C19	17-19-12	Hs~MGC:BC033758.1~uORF:IOH21879	324	36	288
B17R12C20	17-20-12	Hs~MGC:BC033758.1~uORF:IOH21879	318	34	284
B17R12C21	17-21-12	Hs~Ref:NM_080659.1~uORF:IOH7410	1763	34	1729
B17R12C22	17-22-12	Hs~Ref:NM_080659.1~uORF:IOH7410	1986	36	1950
B17R13C01	17-1-13	Hs~MGC:BC018950.2~uORF:IOH14350	1007	34	973
B17R13C02	17-2-13	Hs~MGC:BC018950.2~uORF:IOH14350	1053	34	1019
B17R13C03	17-3-13	Hs~Ref:NM_173565.1~uORF:IOH22306	397	36	361
B17R13C04	17-4-13	Hs~Ref:NM_173565.1~uORF:IOH22306	372	35	337
B17R13C05	17-5-13	Hs~Ref:NM_000100.2~uORF:IOH2908	274	40	234
B17R13C06	17-6-13	Hs~Ref:NM_000100.2~uORF:IOH2908	234	41	193
B17R13C07	17-7-13	Hs~MGC:BC034488.2~uORF:IOH22312	34	34	0
B17R13C08	17-8-13	Hs~MGC:BC034488.2~uORF:IOH22312	33	34	-1
B17R13C09	17-9-13	Hs~Ref:NM_021955.1~uORF:IOH23153	511	36	475
B17R13C10	17-10-13	Hs~Ref:NM_021955.1~uORF:IOH23153	502	36	466
B17R13C11	17-11-13	Hs~MGC:BC001935.1~uORF:IOH5068	336	35	301
B17R13C12	17-12-13	Hs~MGC:BC001935.1~uORF:IOH5068	366	36	330
B17R13C13	17-13-13	Hs~Ref:NM_020412.1~uORF:IOH22953	322	41	281
B17R13C14	17-14-13	Hs~Ref:NM_020412.1~uORF:IOH22953	280	45	235
B17R13C15	17-15-13	Hs~Ref:NM_002861.1~uORF:IOH3644	298	45	253
B17R13C16	17-16-13	Hs~Ref:NM_002861.1~uORF:IOH3644	223	43	180
B17R13C17	17-17-13	Hs~MGC:BC014847.1~uORF:IOH11791	418	37	381
B17R13C18	17-18-13	Hs~MGC:BC014847.1~uORF:IOH11791	436	37	399
B17R13C19	17-19-13	Hs~Ref:NM_005240.1~uORF:IOH13301	317	38	279
B17R13C20	17-20-13	Hs~Ref:NM_005240.1~uORF:IOH13301	298	37	261
B17R13C21	17-21-13	Hs~Ref:NM_138769.1~uORF:IOH13192	550	36	514
B17R13C22	17-22-13	Hs~Ref:NM_138769.1~uORF:IOH13192	570	38	532
B17R14C01	17-1-14	Hs~MGC:BC018140.1~uORF:IOH11816	333	35	298
B17R14C02	17-2-14	Hs~MGC:BC018140.1~uORF:IOH11816	378	36	342
B17R14C03	17-3-14	Hs~Ref:NM_152441.1~uORF:IOH11609	393	39	354
B17R14C04	17-4-14	Hs~Ref:NM_152441.1~uORF:IOH11609	442	44	398
B17R14C05	17-5-14	Hs~Ref:NM_001007097.1~uORF:IOH22213	377	38	339
B17R14C06	17-6-14	Hs~Ref:NM_001007097.1~uORF:IOH22213	369	37	332
B17R14C07	17-7-14	Hs~MGC:BC028138.1~uORF:IOH11540	298	36	262
B17R14C08	17-8-14	Hs~MGC:BC028138.1~uORF:IOH11540	268	36	232
B17R14C09	17-9-14	Hs~Ref:NM_004588.3~uORF:IOH22111	349	36	313
B17R14C10	17-10-14	Hs~Ref:NM_004588.3~uORF:IOH22111	336	36	300
B17R14C11	17-11-14	Hs~Ref:NM_198920.1~uORF:IOH41177	317	36	281
B17R14C12	17-12-14	Hs~Ref:NM_198920.1~uORF:IOH41177	317	36	281
B17R14C13	17-13-14	Hs~Ref:NM_017923.2~uORF:IOH42112	275	36	239
B17R14C14	17-14-14	Hs~Ref:NM_017923.2~uORF:IOH42112	302	36	266
B17R14C15	17-15-14	Hs~Ref:NM_002215.1~uORF:IOH42545	367	37	330
B17R14C16	17-16-14	Hs~Ref:NM_002215.1~uORF:IOH42545	321	38	283
B17R14C17	17-17-14	Hs~Ref:NM_003939.2~uORF:IOH42069	521	37	484
B17R14C18	17-18-14	Hs~Ref:NM_003939.2~uORF:IOH42069	534	36	498
B17R14C19	17-19-14	Hs~MGC:BC005345.1~uORF:IOH7283	301	38	263
B17R14C20	17-20-14	Hs~MGC:BC005345.1~uORF:IOH7283	302	38	264
B17R14C21	17-21-14	Hs~MGC:BC008429.1~uORF:IOH7505	380	38	342
B17R14C22	17-22-14	Hs~MGC:BC008429.1~uORF:IOH7505	410	40	370
B17R15C01	17-1-15	Hs~MGC:BC032474.1~uORF:IOH21712	346	35	311
B17R15C02	17-2-15	Hs~MGC:BC032474.1~uORF:IOH21712	394	36	358
B17R15C03	17-3-15	Hs~Ref:NM_182691.1~uORF:IOH26788	583	37	546
B17R15C04	17-4-15	Hs~Ref:NM_182691.1~uORF:IOH26788	623	36	587
B17R15C05	17-5-15	Hs~MGC:XM_379510.1~uORF:IOH44484	909	36	873
B17R15C06	17-6-15	Hs~MGC:XM_379510.1~uORF:IOH44484	940	35	905
B17R15C07	17-7-15	Hs~Ref:NM_174931.1~uORF:IOH45940	298	36	262
B17R15C08	17-8-15	Hs~Ref:NM_174931.1~uORF:IOH45940	267	39	228
B17R15C09	17-9-15	Hs~Ref:NM_173456.1~uORF:IOH45493	455	37	418
B17R15C10	17-10-15	Hs~Ref:NM_173456.1~uORF:IOH45493	508	37	471
B17R15C11	17-11-15	Hs~Ref:NM_000187.1~uORF:IOH45942	641	37	604
B17R15C12	17-12-15	Hs~Ref:NM_000187.1~uORF:IOH45942	651	36	615
B17R15C13	17-13-15	Hs~IVGN:PM_2148~Ext:CARDIOLIPIN~N/A	114	35	79
B17R15C14	17-14-15	Hs~IVGN:PM_2148~Ext:CARDIOLIPIN~N/A	36	35	1
B17R15C15	17-15-15	Hs~N/A:NM_001005862.1~CAT:PV3366	270	35	235
B17R15C16	17-16-15	Hs~N/A:NM_001005862.1~CAT:PV3366	270	36	234
B17R15C17	17-17-15	Hs~Ref:NM_004938.1~CAT:PV3969	272	37	235
B17R15C18	17-18-15	Hs~Ref:NM_004938.1~CAT:PV3969	238	94	144
B17R15C19	17-19-15	Hs~Ref:NM_001721.2~CAT:PV3371	872	36	836
B17R15C20	17-20-15	Hs~Ref:NM_001721.2~CAT:PV3371	978	35	943
B17R15C21	17-21-15	Hs~Ref:NM_004302.3~CAT:PV4312	315	39	276
B17R15C22	17-22-15	Hs~Ref:NM_004302.3~CAT:PV4312	156	37	119
B17R16C01	17-1-16	Hs~Ref:NM_004560.2~CAT:PV3861	804	35	769
B17R16C02	17-2-16	Hs~Ref:NM_004560.2~CAT:PV3861	780	35	745
B17R16C03	17-3-16	Hs~Ref:NM_004958.2~CAT:PV4753	241	36	205
B17R16C04	17-4-16	Hs~Ref:NM_004958.2~CAT:PV4753	238	42	196
B17R16C05	17-5-16	Hs~Ref:NM_005781.2~CAT:PV4807	215	60	155
B17R16C06	17-6-16	Hs~Ref:NM_005781.2~CAT:PV4807	94	35	59
B17R16C07	17-7-16	Hs~MGC:NM_172207.1~uORF:IOH22804	218	61	157
B17R16C08	17-8-16	Hs~MGC:NM_172207.1~uORF:IOH22804	109	36	73
B17R16C09	17-9-16	Hs~MGC:BC006376.1~uORF:IOH6481	283	36	247
B17R16C10	17-10-16	Hs~MGC:BC006376.1~uORF:IOH6481	310	56	254
B17R16C11	17-11-16	Hs~Ref:NM_000477.3~uORF:IOH23065	264	52	212
B17R16C12	17-12-16	Hs~Ref:NM_000477.3~uORF:IOH23065	241	97	144
B17R16C13	17-13-16	Hs~Ref:NM_022493.1~uORF:IOH21554	212	39	173
B17R16C14	17-14-16	Hs~Ref:NM_022493.1~uORF:IOH21554	206	42	164
B17R16C15	17-15-16	Hs~Ref:NM_001011667.1~uORF:IOH57352	402	37	365
B17R16C16	17-16-16	Hs~Ref:NM_001011667.1~uORF:IOH57352	402	39	363
B17R16C17	17-17-16	Hs~Ref:NM_001018062.1~uORF:IOH57354	405	44	361
B17R16C18	17-18-16	Hs~Ref:NM_001018062.1~uORF:IOH57354	401	43	358
B17R16C19	17-19-16	Hs~Ref:NM_001284.2~uORF:IOH3063	388	38	350
B17R16C20	17-20-16	Hs~Ref:NM_001284.2~uORF:IOH3063	398	38	360
B17R16C21	17-21-16	Hs~MGC:BC070055.1~uORF:IOH40142	414	38	376
B17R16C22	17-22-16	Hs~MGC:BC070055.1~uORF:IOH40142	410	36	374
B17R17C01	17-1-17	Hs~MGC:BC005026.1~uORF:IOH6532	729	35	694
B17R17C02	17-2-17	Hs~MGC:BC005026.1~uORF:IOH6532	751	35	716
B17R17C03	17-3-17	Hs~Ref:NM_003161.1~uORF:IOH29907	813	35	778
B17R17C04	17-4-17	Hs~Ref:NM_003161.1~uORF:IOH29907	797	35	762
B17R17C05	17-5-17	Hs~MGC:BC003408.2~uORF:IOH3031	598	35	563
B17R17C06	17-6-17	Hs~MGC:BC003408.2~uORF:IOH3031	585	35	550
B17R17C07	17-7-17	Hs~Ref:NM_024548.2~uORF:IOH27601	608	36	572
B17R17C08	17-8-17	Hs~Ref:NM_024548.2~uORF:IOH27601	564	35	529
B17R17C09	17-9-17	Hs~Ref:NM_032312.2~uORF:IOH5615	875	36	839
B17R17C10	17-10-17	Hs~Ref:NM_032312.2~uORF:IOH5615	907	39	868
B17R17C11	17-11-17	Hs~Ref:NM_006993.1~uORF:IOH29468	413	38	375
B17R17C12	17-12-17	Hs~Ref:NM_006993.1~uORF:IOH29468	429	37	392
B17R17C13	17-13-17	Hs~Ref:NM_000799.1~uORF:IOH44362	523	37	486
B17R17C14	17-14-17	Hs~Ref:NM_000799.1~uORF:IOH44362	468	37	431
B17R17C15	17-15-17	Hs~MGC:BC035744.1~uORF:IOH26021	771	36	735
B17R17C16	17-16-17	Hs~MGC:BC035744.1~uORF:IOH26021	830	39	791
B17R17C17	17-17-17	Hs~MGC:NM_152377.1~uORF:IOH11555	1151	45	1106
B17R17C18	17-18-17	Hs~MGC:NM_152377.1~uORF:IOH11555	1220	42	1178
B17R17C19	17-19-17	Hs~Ref:NM_138492.1~uORF:IOH11385	530	38	492
B17R17C20	17-20-17	Hs~Ref:NM_138492.1~uORF:IOH11385	529	37	492
B17R17C21	17-21-17	Hs~MGC:BC010357.1~uORF:IOH14260	756	36	720
B17R17C22	17-22-17	Hs~MGC:BC010357.1~uORF:IOH14260	690	36	654
B17R18C01	17-1-18	Hs~Ref:NM_001319.5~uORF:IOH10417	781	34	747
B17R18C02	17-2-18	Hs~Ref:NM_001319.5~uORF:IOH10417	802	34	768
B17R18C03	17-3-18	Hs~MGC:BC012883.1~uORF:IOH28614	381	35	346
B17R18C04	17-4-18	Hs~MGC:BC012883.1~uORF:IOH28614	404	36	368
B17R18C05	17-5-18	Hs~MGC:BC053610.1~uORF:IOH28998	472	38	434
B17R18C06	17-6-18	Hs~MGC:BC053610.1~uORF:IOH28998	469	37	432
B17R18C07	17-7-18	Hs~MGC:BC012368.1~uORF:IOH10555	556	36	520
B17R18C08	17-8-18	Hs~MGC:BC012368.1~uORF:IOH10555	503	36	467
B17R18C09	17-9-18	Hs~Ref:NM_019107.3~uORF:IOH13900	325	37	288
B17R18C10	17-10-18	Hs~Ref:NM_019107.3~uORF:IOH13900	370	40	330
B17R18C11	17-11-18	Hs~Ref:NM_153709.1~uORF:IOH21517	458	38	420
B17R18C12	17-12-18	Hs~Ref:NM_153709.1~uORF:IOH21517	473	35	438
B17R18C13	17-13-18	Hs~Ref:NM_014045.3~uORF:IOH41955	390	37	353
B17R18C14	17-14-18	Hs~Ref:NM_014045.3~uORF:IOH41955	370	37	333
B17R18C15	17-15-18	Hs~Ref:NM_003588.2~uORF:IOH27494	353	36	317
B17R18C16	17-16-18	Hs~Ref:NM_003588.2~uORF:IOH27494	349	37	312
B17R18C17	17-17-18	Hs~Ref:NM_174964.1~uORF:IOH37722	325	37	288
B17R18C18	17-18-18	Hs~Ref:NM_174964.1~uORF:IOH37722	313	40	273
B17R18C19	17-19-18	Hs~Ref:NM_004637.5~uORF:IOH40569	501	36	465
B17R18C20	17-20-18	Hs~Ref:NM_004637.5~uORF:IOH40569	489	36	453
B17R18C21	17-21-18	Hs~Ref:NM_199290.2~uORF:IOH40757	413	37	376
B17R18C22	17-22-18	Hs~Ref:NM_199290.2~uORF:IOH40757	423	38	385
B17R19C01	17-1-19	Hs~MGC:BC067262.1~uORF:IOH40509	521	34	487
B17R19C02	17-2-19	Hs~MGC:BC067262.1~uORF:IOH40509	486	35	451
B17R19C03	17-3-19	Hs~MGC:BC041054.1~uORF:IOH28014	447	35	412
B17R19C04	17-4-19	Hs~MGC:BC041054.1~uORF:IOH28014	472	35	437
B17R19C05	17-5-19	Hs~MGC:BC056413.1~uORF:IOH29098	351	39	312
B17R19C06	17-6-19	Hs~MGC:BC056413.1~uORF:IOH29098	353	39	314
B17R19C07	17-7-19	Hs~Ref:NM_013323.1~uORF:IOH3822	605	37	568
B17R19C08	17-8-19	Hs~Ref:NM_013323.1~uORF:IOH3822	592	36	556
B17R19C09	17-9-19	Hs~Ref:NM_002652.1~uORF:IOH12199	479	35	444
B17R19C10	17-10-19	Hs~Ref:NM_002652.1~uORF:IOH12199	470	36	434
B17R19C11	17-11-19	Hs~MGC:BC007835.1~uORF:IOH6703	218	41	177
B17R19C12	17-12-19	Hs~MGC:BC007835.1~uORF:IOH6703	246	37	209
B17R19C13	17-13-19	Hs~Ref:NM_020963.1~uORF:IOH4005	298	36	262
B17R19C14	17-14-19	Hs~Ref:NM_020963.1~uORF:IOH4005	274	60	214
B17R19C15	17-15-19	Hs~Ref:NM_000444.1~uORF:IOH29637	329	38	291
B17R19C16	17-16-19	Hs~Ref:NM_000444.1~uORF:IOH29637	316	38	278
B17R19C17	17-17-19	Hs~MGC:BC053985.1~uORF:IOH29363	299	40	259
B17R19C18	17-18-19	Hs~MGC:BC053985.1~uORF:IOH29363	281	36	245
B17R19C19	17-19-19	Hs~MGC:BC047690.1~uORF:IOH28834	394	36	358
B17R19C20	17-20-19	Hs~MGC:BC047690.1~uORF:IOH28834	374	36	338
B17R19C21	17-21-19	Hs~Ref:NM_032174.2~uORF:IOH13297	288	38	250
B17R19C22	17-22-19	Hs~Ref:NM_032174.2~uORF:IOH13297	286	39	247
B17R20C01	17-1-20	Hs~MGC:BC044215.1~uORF:IOH26376	390	36	354
B17R20C02	17-2-20	Hs~MGC:BC044215.1~uORF:IOH26376	375	35	340
B17R20C03	17-3-20	Hs~MGC:BC056256.1~uORF:IOH29440	16877	36	16841
B17R20C04	17-4-20	Hs~MGC:BC056256.1~uORF:IOH29440	17102	36	17066
B17R20C05	17-5-20	Hs~Ref:NM_025128.3~uORF:IOH45812	381	36	345
B17R20C06	17-6-20	Hs~Ref:NM_025128.3~uORF:IOH45812	388	36	352
B17R20C07	17-7-20	Hs~Ref:NM_018037.1~uORF:IOH45458	239	56	183
B17R20C08	17-8-20	Hs~Ref:NM_018037.1~uORF:IOH45458	122	82	40
B17R20C09	17-9-20	Hs~Ref:NM_017851.4~uORF:IOH45910	395	35	360
B17R20C10	17-10-20	Hs~Ref:NM_017851.4~uORF:IOH45910	407	35	372
B17R20C11	17-11-20	Hs~Ref:NM_001007024.1~uORF:IOH45919	182	85	97
B17R20C12	17-12-20	Hs~Ref:NM_001007024.1~uORF:IOH45919	190	39	151
B17R20C13	17-13-20	Hs~MGC:BC016911.1~uORF:IOH11149	317	35	282
B17R20C14	17-14-20	Hs~MGC:BC016911.1~uORF:IOH11149	324	36	288
B17R20C15	17-15-20	Hs~Ref:NM_024683.2~uORF:IOH45914	310	37	273
B17R20C16	17-16-20	Hs~Ref:NM_024683.2~uORF:IOH45914	244	53	191
B17R20C17	17-17-20	Hs~Ref:NM_198440.2~uORF:IOH45490	207	63	144
B17R20C18	17-18-20	Hs~Ref:NM_198440.2~uORF:IOH45490	138	38	100
B17R20C19	17-19-20	Hs~Ref:NM_058190.2~uORF:IOH13437	216	44	172
B17R20C20	17-20-20	Hs~Ref:NM_058190.2~uORF:IOH13437	139	67	72
B17R20C21	17-21-20	Hs~Ref:NM_032109.2~uORF:IOH4445	274	48	226
B17R20C22	17-22-20	Hs~Ref:NM_032109.2~uORF:IOH4445	185	77	108
B17R21C01	17-1-21	Hs~Ref:NM_001017971.1~uORF:IOH43752	269	47	222
B17R21C02	17-2-21	Hs~Ref:NM_001017971.1~uORF:IOH43752	267	35	232
B17R21C03	17-3-21	Hs~Ref:NM_198722.1~uORF:IOH42181	317	37	280
B17R21C04	17-4-21	Hs~Ref:NM_198722.1~uORF:IOH42181	314	38	276
B17R21C05	17-5-21	Hs~Ref:NM_006675.3~uORF:IOH41496	321	36	285
B17R21C06	17-6-21	Hs~Ref:NM_006675.3~uORF:IOH41496	314	35	279
B17R21C07	17-7-21	Hs~Ref:NM_181643.2~uORF:IOH42316	293	35	258
B17R21C08	17-8-21	Hs~Ref:NM_181643.2~uORF:IOH42316	318	37	281
B17R21C09	17-9-21	Hs~Ref:P23515-1~CAT_10269-H08H-25	39	34	5
B17R21C10	17-10-21	Hs~Ref:P23515-1~CAT_10269-H08H-25	37	34	3
B17R21C11	17-11-21	Internal_1007209	240	36	204
B17R21C12	17-12-21	Internal_1007209	182	36	146
B17R21C13	17-13-21	Hs~Ref:NP_001834.2~CAT_10383-H08H-25	56	34	22
B17R21C14	17-14-21	Hs~Ref:NP_001834.2~CAT_10383-H08H-25	51	34	17
B17R21C15	17-15-21	Internal_1007209	164	39	125
B17R21C16	17-16-21	Internal_1007209	56	34	22
B17R21C17	17-17-21	Hs~Ref:NP_001069.1~CAT_10113-H08H-25	42	35	7
B17R21C18	17-18-21	Hs~Ref:NP_001069.1~CAT_10113-H08H-25	92	35	57
B17R21C19	17-19-21	Internal_1007209	192	35	157
B17R21C20	17-20-21	Internal_1007209	39	34	5
B17R21C21	17-21-21	Hs~IVGN:M-CSF_Recombinant~CAT_PHC9501~N/A	425	41	384
B17R21C22	17-22-21	Hs~IVGN:M-CSF_Recombinant~CAT_PHC9501~N/A	41	35	6
B17R22C01	17-1-22	ERa~N/A	2577	34	2543
B17R22C02	17-2-22	ERa~N/A	2546	34	2512
B17R22C03	17-3-22	PKCeta~N/A	261	34	227
B17R22C04	17-4-22	PKCeta~N/A	252	34	218
B17R22C05	17-5-22	Calmodulin~N/A	117	37	80
B17R22C06	17-6-22	Calmodulin~N/A	57	33	24
B17R22C07	17-7-22	V5control5~N/A	273	34	239
B17R22C08	17-8-22	V5control5~N/A	316	34	282
B17R22C09	17-9-22	V5control4~N/A	122	38	84
B17R22C10	17-10-22	V5control4~N/A	139	37	102
B17R22C11	17-11-22	V5control3~N/A	71	34	37
B17R22C12	17-12-22	V5control3~N/A	72	34	38
B17R22C13	17-13-22	V5control2~N/A	161	41	120
B17R22C14	17-14-22	V5control2~N/A	51	34	17
B17R22C15	17-15-22	V5control1~N/A	178	36	142
B17R22C16	17-16-22	V5control1~N/A	47	34	13
B17R22C17	17-17-22	CMK2A~N/A	423	34	389
B17R22C18	17-18-22	CMK2A~N/A	483	34	449
B17R22C19	17-19-22	ERa~N/A	2084	34	2050
B17R22C20	17-20-22	ERa~N/A	2119	35	2084
B17R22C21	17-21-22	AlexaAntiMouseAb~N/A	8993	36	8957
B17R22C22	17-22-22	AlexaAntiMouseAb~N/A	10193	35	10158
B18R01C01	18-1-1	AlexaAntiMouseAb~N/A	33615	38	33577
B18R01C02	18-2-1	AlexaAntiMouseAb~N/A	33419	37	33382
B18R01C03	18-3-1	ERa~N/A	1329	37	1292
B18R01C04	18-4-1	ERa~N/A	1377	37	1340
B18R01C05	18-5-1	HumanIgG1~N/A	1302	37	1265
B18R01C06	18-6-1	HumanIgG1~N/A	1435	38	1397
B18R01C07	18-7-1	HumanIgG2~N/A	3262	38	3224
B18R01C08	18-8-1	HumanIgG2~N/A	3517	39	3478
B18R01C09	18-9-1	HumanIgG3~N/A	14626	40	14586
B18R01C10	18-10-1	HumanIgG3~N/A	18004	56	17948
B18R01C11	18-11-1	HumanIgG4~N/A	65535	75	65460
B18R01C12	18-12-1	HumanIgG4~N/A	65535	56	65479
B18R01C13	18-13-1	BiotinAb~N/A	653	45	608
B18R01C14	18-14-1	BiotinAb~N/A	694	43	651
B18R01C15	18-15-1	RanBP2deltaFG~N/A	354	42	312
B18R01C16	18-16-1	RanBP2deltaFG~N/A	337	40	297
B18R01C17	18-17-1	hMDM2~N/A	728	39	689
B18R01C18	18-18-1	hMDM2~N/A	758	40	718
B18R01C19	18-19-1	PKCeta~N/A	416	42	374
B18R01C20	18-20-1	PKCeta~N/A	440	42	398
B18R01C21	18-21-1	AlexaAntiMouseAb~N/A	39358	42	39316
B18R01C22	18-22-1	AlexaAntiMouseAb~N/A	37492	42	37450
B18R02C01	18-1-2	PKCeta~N/A	657	37	620
B18R02C02	18-2-2	PKCeta~N/A	702	38	664
B18R02C03	18-3-2	Buffer	267	46	221
B18R02C04	18-4-2	Buffer	282	102	180
B18R02C05	18-5-2	HumanIgA~N/A	21600	38	21562
B18R02C06	18-6-2	HumanIgA~N/A	20883	38	20845
B18R02C07	18-7-2	Buffer	46	40	6
B18R02C08	18-8-2	Buffer	53	39	14
B18R02C09	18-9-2	BSA~N/A	16404	44	16360
B18R02C10	18-10-2	BSA~N/A	13637	69	13568
B18R02C11	18-11-2	Hs~MGC:BC029510.1~uORF:IOH22576	376	220	156
B18R02C12	18-12-2	Hs~MGC:BC029510.1~uORF:IOH22576	343	145	198
B18R02C13	18-13-2	Hs~MGC:NM_152452.1~uORF:IOH11129	264	52	212
B18R02C14	18-14-2	Hs~MGC:NM_152452.1~uORF:IOH11129	203	52	151
B18R02C15	18-15-2	Hs~MGC:BC018109.1~uORF:IOH11274	206	50	156
B18R02C16	18-16-2	Hs~MGC:BC018109.1~uORF:IOH11274	232	50	182
B18R02C17	18-17-2	Hs~MGC:BC031041.1~uORF:IOH22517	341	42	299
B18R02C18	18-18-2	Hs~MGC:BC031041.1~uORF:IOH22517	353	42	311
B18R02C19	18-19-2	Hs~MGC:BC000112.1~uORF:IOH4632	423	43	380
B18R02C20	18-20-2	Hs~MGC:BC000112.1~uORF:IOH4632	434	43	391
B18R02C21	18-21-2	Hs~MGC:BC010074.2~uORF:IOH13694	757	46	711
B18R02C22	18-22-2	Hs~MGC:BC010074.2~uORF:IOH13694	810	44	766
B18R03C01	18-1-3	Hs~Ref:NM_014042.1~uORF:IOH5151	382	40	342
B18R03C02	18-2-3	Hs~Ref:NM_014042.1~uORF:IOH5151	364	50	314
B18R03C03	18-3-3	Hs~MGC:BC001715.2~uORF:IOH4551	755	41	714
B18R03C04	18-4-3	Hs~MGC:BC001715.2~uORF:IOH4551	735	41	694
B18R03C05	18-5-3	Hs~Ref:NM_032329.4~uORF:IOH44706	393	58	335
B18R03C06	18-6-3	Hs~Ref:NM_032329.4~uORF:IOH44706	338	43	295
B18R03C07	18-7-3	Hs~Ref:NM_002489.2~uORF:IOH41391	238	39	199
B18R03C08	18-8-3	Hs~Ref:NM_002489.2~uORF:IOH41391	242	39	203
B18R03C09	18-9-3	Hs~Ref:NM_006799.2~uORF:IOH45736	326	48	278
B18R03C10	18-10-3	Hs~Ref:NM_006799.2~uORF:IOH45736	234	102	132
B18R03C11	18-11-3	Hs~Ref:NM_080390.3~uORF:IOH41393	1087	70	1017
B18R03C12	18-12-3	Hs~Ref:NM_080390.3~uORF:IOH41393	1071	56	1015
B18R03C13	18-13-3	Hs~Ref:NM_144969.1~uORF:IOH43013	119	50	69
B18R03C14	18-14-3	Hs~Ref:NM_144969.1~uORF:IOH43013	113	76	37
B18R03C15	18-15-3	Hs~MGC:NM_005737.3~uORF:IOH44753	995	47	948
B18R03C16	18-16-3	Hs~MGC:NM_005737.3~uORF:IOH44753	993	43	950
B18R03C17	18-17-3	Hs~Ref:XM_373800.2~uORF:IOH43694	3103	41	3062
B18R03C18	18-18-3	Hs~Ref:XM_373800.2~uORF:IOH43694	3074	41	3033
B18R03C19	18-19-3	Hs~Ref:NM_016829.1~uORF:IOH42070	98	41	57
B18R03C20	18-20-3	Hs~Ref:NM_016829.1~uORF:IOH42070	125	43	82
B18R03C21	18-21-3	Hs~MGC:BC011006.1~uORF:IOH14184	522	45	477
B18R03C22	18-22-3	Hs~MGC:BC011006.1~uORF:IOH14184	460	47	413
B18R04C01	18-1-4	Hs~MGC:BC008438.1~uORF:IOH7448	598	38	560
B18R04C02	18-2-4	Hs~MGC:BC008438.1~uORF:IOH7448	606	42	564
B18R04C03	18-3-4	Hs~Ref:NM_004578.2~uORF:IOH5541	416	42	374
B18R04C04	18-4-4	Hs~Ref:NM_004578.2~uORF:IOH5541	410	42	368
B18R04C05	18-5-4	Hs~Ref:NM_003825.2~uORF:IOH3269	473	256	217
B18R04C06	18-6-4	Hs~Ref:NM_003825.2~uORF:IOH3269	339	46	293
B18R04C07	18-7-4	Hs~MGC:BC019292.1~uORF:IOH13802	315	38	277
B18R04C08	18-8-4	Hs~MGC:BC019292.1~uORF:IOH13802	273	38	235
B18R04C09	18-9-4	Hs~MGC:BC015802.1~uORF:IOH10059	253	55	198
B18R04C10	18-10-4	Hs~MGC:BC015802.1~uORF:IOH10059	310	176	134
B18R04C11	18-11-4	Hs~Ref:NM_016304.2~uORF:IOH7552	1465	52	1413
B18R04C12	18-12-4	Hs~Ref:NM_016304.2~uORF:IOH7552	1398	46	1352
B18R04C13	18-13-4	Hs~Ref:NM_145237.1~uORF:IOH6581	396	45	351
B18R04C14	18-14-4	Hs~Ref:NM_145237.1~uORF:IOH6581	332	55	277
B18R04C15	18-15-4	Hs~Ref:NM_021969.1~uORF:IOH22604	360	41	319
B18R04C16	18-16-4	Hs~Ref:NM_021969.1~uORF:IOH22604	382	42	340
B18R04C17	18-17-4	Hs~MGC:BC030290.1~uORF:IOH21571	533	73	460
B18R04C18	18-18-4	Hs~MGC:BC030290.1~uORF:IOH21571	578	161	417
B18R04C19	18-19-4	Hs~MGC:BC000450.1~uORF:IOH3506	189	44	145
B18R04C20	18-20-4	Hs~MGC:BC000450.1~uORF:IOH3506	291	44	247
B18R04C21	18-21-4	Hs~MGC:BC013119.1~uORF:IOH10459	802	43	759
B18R04C22	18-22-4	Hs~MGC:BC013119.1~uORF:IOH10459	855	42	813
B18R05C01	18-1-5	Hs~Ref:NM_001788.3~uORF:IOH43444	313	40	273
B18R05C02	18-2-5	Hs~Ref:NM_001788.3~uORF:IOH43444	270	39	231
B18R05C03	18-3-5	Hs~Ref:NM_018698.3~uORF:IOH43204	3050	38	3012
B18R05C04	18-4-5	Hs~Ref:NM_018698.3~uORF:IOH43204	2799	38	2761
B18R05C05	18-5-5	Hs~Ref:NM_001009959.1~uORF:IOH43447	883	41	842
B18R05C06	18-6-5	Hs~Ref:NM_001009959.1~uORF:IOH43447	857	39	818
B18R05C07	18-7-5	Hs~Ref:NM_181726.1~uORF:IOH43299	251	38	213
B18R05C08	18-8-5	Hs~Ref:NM_181726.1~uORF:IOH43299	243	37	206
B18R05C09	18-9-5	Hs~MGC:BC031090.1~uORF:IOH22578	359	47	312
B18R05C10	18-10-5	Hs~MGC:BC031090.1~uORF:IOH22578	215	63	152
B18R05C11	18-11-5	Hs~Ref:NM_019612.2~uORF:IOH40077	577	53	524
B18R05C12	18-12-5	Hs~Ref:NM_019612.2~uORF:IOH40077	609	51	558
B18R05C13	18-13-5	Hs~Ref:NM_004391.1~uORF:IOH40170	454	46	408
B18R05C14	18-14-5	Hs~Ref:NM_004391.1~uORF:IOH40170	463	45	418
B18R05C15	18-15-5	Hs~MGC:BC069568.1~uORF:IOH40320	567	40	527
B18R05C16	18-16-5	Hs~MGC:BC069568.1~uORF:IOH40320	549	41	508
B18R05C17	18-17-5	Hs~Ref:NM_004179.1~uORF:IOH35768	366	71	295
B18R05C18	18-18-5	Hs~Ref:NM_004179.1~uORF:IOH35768	331	79	252
B18R05C19	18-19-5	Hs~Ref:NM_000956.2~uORF:IOH35606	198	45	153
B18R05C20	18-20-5	Hs~Ref:NM_000956.2~uORF:IOH35606	226	48	178
B18R05C21	18-21-5	Hs~Ref:NM_052926.1~uORF:IOH35779	428	44	384
B18R05C22	18-22-5	Hs~Ref:NM_052926.1~uORF:IOH35779	449	45	404
B18R06C01	18-1-6	Hs~Ref:NM_177973.1~uORF:IOH22150	1103	36	1067
B18R06C02	18-2-6	Hs~Ref:NM_177973.1~uORF:IOH22150	1160	38	1122
B18R06C03	18-3-6	Hs~Ref:NM_015584.2~uORF:IOH4335	181	61	120
B18R06C04	18-4-6	Hs~Ref:NM_015584.2~uORF:IOH4335	237	59	178
B18R06C05	18-5-6	Hs~MGC:BC005941.1~uORF:IOH7423	63	37	26
B18R06C06	18-6-6	Hs~MGC:BC005941.1~uORF:IOH7423	55	37	18
B18R06C07	18-7-6	Hs~MGC:BC095521.1~uORF:IOH62751	58	43	15
B18R06C08	18-8-6	Hs~MGC:BC095521.1~uORF:IOH62751	58	40	18
B18R06C09	18-9-6	Hs~MGC:BC007104.1~uORF:IOH7532	186	48	138
B18R06C10	18-10-6	Hs~MGC:BC007104.1~uORF:IOH7532	118	93	25
B18R06C11	18-11-6	Hs~Ref:NM_052848.1~uORF:IOH13249	558	59	499
B18R06C12	18-12-6	Hs~Ref:NM_052848.1~uORF:IOH13249	587	61	526
B18R06C13	18-13-6	Hs~MGC:BC021092.1~uORF:IOH13243	672	48	624
B18R06C14	18-14-6	Hs~MGC:BC021092.1~uORF:IOH13243	592	45	547
B18R06C15	18-15-6	Hs~Ref:NM_004881.1~uORF:IOH3658	631	41	590
B18R06C16	18-16-6	Hs~Ref:NM_004881.1~uORF:IOH3658	581	42	539
B18R06C17	18-17-6	Hs~MGC:BC003132.1~uORF:IOH5147	268	47	221
B18R06C18	18-18-6	Hs~MGC:BC003132.1~uORF:IOH5147	325	231	94
B18R06C19	18-19-6	Hs~Ref:NM_207181.1~uORF:IOH60410	504	186	318
B18R06C20	18-20-6	Hs~Ref:NM_207181.1~uORF:IOH60410	425	49	376
B18R06C21	18-21-6	Hs~MGC:BC089411.1~uORF:IOH62715	361	53	308
B18R06C22	18-22-6	Hs~MGC:BC089411.1~uORF:IOH62715	349	124	225
B18R07C01	18-1-7	Hs~MGC:BC090928.1~uORF:IOH62702	275	35	240
B18R07C02	18-2-7	Hs~MGC:BC090928.1~uORF:IOH62702	284	36	248
B18R07C03	18-3-7	Hs~MGC:BC096212.2~uORF:IOH63220	379	37	342
B18R07C04	18-4-7	Hs~MGC:BC096212.2~uORF:IOH63220	398	40	358
B18R07C05	18-5-7	Hs~Ref:NM_182612.1~uORF:IOH42453	226	144	82
B18R07C06	18-6-7	Hs~Ref:NM_182612.1~uORF:IOH42453	194	42	152
B18R07C07	18-7-7	Hs~Ref:NM_016226.2~uORF:IOH41532	249	41	208
B18R07C08	18-8-7	Hs~Ref:NM_016226.2~uORF:IOH41532	245	40	205
B18R07C09	18-9-7	Hs~Ref:NM_080838.1~uORF:IOH42456	231	48	183
B18R07C10	18-10-7	Hs~Ref:NM_080838.1~uORF:IOH42456	163	65	98
B18R07C11	18-11-7	Hs~Ref:XM_293886.3~uORF:IOH41635	418	132	286
B18R07C12	18-12-7	Hs~Ref:XM_293886.3~uORF:IOH41635	254	54	200
B18R07C13	18-13-7	Hs~Ref:NM_005053.2~uORF:IOH22983	61	45	16
B18R07C14	18-14-7	Hs~Ref:NM_005053.2~uORF:IOH22983	111	49	62
B18R07C15	18-15-7	Hs~MGC:BC006429.1~uORF:IOH6564	52	43	9
B18R07C16	18-16-7	Hs~MGC:BC006429.1~uORF:IOH6564	61	46	15
B18R07C17	18-17-7	Hs~Ref:NM_003688.1~N/A	149	62	87
B18R07C18	18-18-7	Hs~Ref:NM_003688.1~N/A	115	45	70
B18R07C19	18-19-7	Hs~Ref:NM_003242.2~N/A	80	42	38
B18R07C20	18-20-7	Hs~Ref:NM_003242.2~N/A	83	44	39
B18R07C21	18-21-7	Hs~Ref:NM_001031617.1~uORF:IOH63148	858	48	810
B18R07C22	18-22-7	Hs~Ref:NM_001031617.1~uORF:IOH63148	801	45	756
B18R08C01	18-1-8	Hs~MGC:BC018069.1~uORF:IOH61405	272	36	236
B18R08C02	18-2-8	Hs~MGC:BC018069.1~uORF:IOH61405	316	37	279
B18R08C03	18-3-8	Hs~MGC:BC066944.1~uORF:IOH61484	422	35	387
B18R08C04	18-4-8	Hs~MGC:BC066944.1~uORF:IOH61484	407	37	370
B18R08C05	18-5-8	Hs~MGC:BC070129.1~uORF:IOH63021	322	101	221
B18R08C06	18-6-8	Hs~MGC:BC070129.1~uORF:IOH63021	248	139	109
B18R08C07	18-7-8	Hs~MGC:BC011713.2~uORF:IOH22973	576	40	536
B18R08C08	18-8-8	Hs~MGC:BC011713.2~uORF:IOH22973	498	39	459
B18R08C09	18-9-8	Hs~Ref:NM_080423.1~uORF:IOH23012	681	54	627
B18R08C10	18-10-8	Hs~Ref:NM_080423.1~uORF:IOH23012	1367	147	1220
B18R08C11	18-11-8	Hs~Ref:NM_006147.1~uORF:IOH10956	1070	52	1018
B18R08C12	18-12-8	Hs~Ref:NM_006147.1~uORF:IOH10956	1066	47	1019
B18R08C13	18-13-8	Hs~MGC:BC029054.1~uORF:IOH22631	1575	43	1532
B18R08C14	18-14-8	Hs~MGC:BC029054.1~uORF:IOH22631	1566	44	1522
B18R08C15	18-15-8	Hs~Ref:NM_145271.1~uORF:IOH14111	635	45	590
B18R08C16	18-16-8	Hs~Ref:NM_145271.1~uORF:IOH14111	652	45	607
B18R08C17	18-17-8	Hs~MGC:BC011014.1~uORF:IOH12165	920	48	872
B18R08C18	18-18-8	Hs~MGC:BC011014.1~uORF:IOH12165	858	44	814
B18R08C19	18-19-8	Hs~Ref:ENST00000444588~uORF:IOH12557	533	42	491
B18R08C20	18-20-8	Hs~Ref:ENST00000444588~uORF:IOH12557	561	42	519
B18R08C21	18-21-8	Hs~MGC:BC012984.2~uORF:IOH13016	483	43	440
B18R08C22	18-22-8	Hs~MGC:BC012984.2~uORF:IOH13016	481	43	438
B18R09C01	18-1-9	Hs~Ref:NM_020427.2~uORF:IOH40403	276	38	238
B18R09C02	18-2-9	Hs~Ref:NM_020427.2~uORF:IOH40403	239	38	201
B18R09C03	18-3-9	Hs~Ref:NM_032506.1~uORF:IOH40533	296	37	259
B18R09C04	18-4-9	Hs~Ref:NM_032506.1~uORF:IOH40533	276	38	238
B18R09C05	18-5-9	Hs~MGC:BC014519.1~uORF:IOH40595	217	47	170
B18R09C06	18-6-9	Hs~MGC:BC014519.1~uORF:IOH40595	1052	52	1000
B18R09C07	18-7-9	Hs~MGC:BC059405.1~uORF:IOH40433	910	41	869
B18R09C08	18-8-9	Hs~MGC:BC059405.1~uORF:IOH40433	865	39	826
B18R09C09	18-9-9	Hs~MGC:BC039711.1~uORF:IOH26100	1165	47	1118
B18R09C10	18-10-9	Hs~MGC:BC039711.1~uORF:IOH26100	1124	62	1062
B18R09C11	18-11-9	Hs~MGC:NM_152376.2~uORF:IOH26515	975	44	931
B18R09C12	18-12-9	Hs~MGC:NM_152376.2~uORF:IOH26515	927	44	883
B18R09C13	18-13-9	Hs~MGC:BC044574.1~uORF:IOH26906	297	44	253
B18R09C14	18-14-9	Hs~MGC:BC044574.1~uORF:IOH26906	353	41	312
B18R09C15	18-15-9	Hs~MGC:BC038998.1~uORF:IOH26172	916	43	873
B18R09C16	18-16-9	Hs~MGC:BC038998.1~uORF:IOH26172	903	42	861
B18R09C17	18-17-9	Hs~Ref:NM_005138.1~uORF:IOH1913	783	43	740
B18R09C18	18-18-9	Hs~Ref:NM_005138.1~uORF:IOH1913	675	42	633
B18R09C19	18-19-9	Hs~Ref:NM_018438.2~uORF:IOH1960	879	45	834
B18R09C20	18-20-9	Hs~Ref:NM_018438.2~uORF:IOH1960	797	45	752
B18R09C21	18-21-9	Hs~Ref:NM_000067.1~uORF:IOH1900	737	45	692
B18R09C22	18-22-9	Hs~Ref:NM_000067.1~uORF:IOH1900	741	43	698
B18R10C01	18-1-10	Hs~Ref:NM_138453.1~uORF:IOH13462	487	39	448
B18R10C02	18-2-10	Hs~Ref:NM_138453.1~uORF:IOH13462	497	39	458
B18R10C03	18-3-10	Hs~MGC:BC057219.1~uORF:IOH29425	317	38	279
B18R10C04	18-4-10	Hs~MGC:BC057219.1~uORF:IOH29425	319	37	282
B18R10C05	18-5-10	Hs~MGC:BC041421.1~uORF:IOH28778	355	42	313
B18R10C06	18-6-10	Hs~MGC:BC041421.1~uORF:IOH28778	349	40	309
B18R10C07	18-7-10	Hs~MGC:BC056872.1~uORF:IOH29082	3369	38	3331
B18R10C08	18-8-10	Hs~MGC:BC056872.1~uORF:IOH29082	3339	39	3300
B18R10C09	18-9-10	Hs~MGC:BC051382.1~uORF:IOH28098	801	49	752
B18R10C10	18-10-10	Hs~MGC:BC051382.1~uORF:IOH28098	657	51	606
B18R10C11	18-11-10	GST1	36	42	-6
B18R10C12	18-12-10	GST1	285	45	240
B18R10C13	18-13-10	GST2	56	42	14
B18R10C14	18-14-10	GST2	58	40	18
B18R10C15	18-15-10	GST3	67	42	25
B18R10C16	18-16-10	GST3	86	44	42
B18R10C17	18-17-10	GST4	815	51	764
B18R10C18	18-18-10	GST4	76	47	29
B18R10C19	18-19-10	Anti-HumanIgA1~N/A	10110	42	10068
B18R10C20	18-20-10	Anti-HumanIgA1~N/A	10028	43	9985
B18R10C21	18-21-10	Anti-HumanIgA2~N/A	17356	46	17310
B18R10C22	18-22-10	Anti-HumanIgA2~N/A	17459	44	17415
B18R11C01	18-1-11	AlexaAntiMouseAb~N/A	22825	38	22787
B18R11C02	18-2-11	AlexaAntiMouseAb~N/A	26229	39	26190
B18R11C03	18-3-11	MAPKAP~N/A	121	43	78
B18R11C04	18-4-11	MAPKAP~N/A	87	57	30
B18R11C05	18-5-11	Buffer	103	38	65
B18R11C06	18-6-11	Buffer	94	37	57
B18R11C07	18-7-11	BSA~N/A	11658	38	11620
B18R11C08	18-8-11	BSA~N/A	12436	40	12396
B18R11C09	18-9-11	Anti-HumanIgG1~N/A	2442	52	2390
B18R11C10	18-10-11	Anti-HumanIgG1~N/A	2435	51	2384
B18R11C11	18-11-11	Anti-HumanIgG2~N/A	4218	44	4174
B18R11C12	18-12-11	Anti-HumanIgG2~N/A	3739	43	3696
B18R11C13	18-13-11	Anti-HumanIgG3~N/A	6647	42	6605
B18R11C14	18-14-11	Anti-HumanIgG3~N/A	6250	41	6209
B18R11C15	18-15-11	Anti-HumanIgG4~N/A	11600	42	11558
B18R11C16	18-16-11	Anti-HumanIgG4~N/A	12775	44	12731
B18R11C17	18-17-11	AntiBiotinAb~N/A	17079	56	17023
B18R11C18	18-18-11	AntiBiotinAb~N/A	16826	49	16777
B18R11C19	18-19-11	Buffer	65	42	23
B18R11C20	18-20-11	Buffer	61	44	17
B18R11C21	18-21-11	Hs~MGC:BC050616.1~uORF:IOH27025	2557	45	2512
B18R11C22	18-22-11	Hs~MGC:BC050616.1~uORF:IOH27025	2483	42	2441
B18R12C01	18-1-12	Hs~MGC:BC042110.1~uORF:IOH26318	675	58	617
B18R12C02	18-2-12	Hs~MGC:BC042110.1~uORF:IOH26318	581	52	529
B18R12C03	18-3-12	Hs~MGC:BC010855.1~uORF:IOH9926	498	49	449
B18R12C04	18-4-12	Hs~MGC:BC010855.1~uORF:IOH9926	516	45	471
B18R12C05	18-5-12	Hs~MGC:BC009829.1~uORF:IOH12161	465	42	423
B18R12C06	18-6-12	Hs~MGC:BC009829.1~uORF:IOH12161	499	41	458
B18R12C07	18-7-12	Hs~MGC:BC041031.1~uORF:IOH28000	595	39	556
B18R12C08	18-8-12	Hs~MGC:BC041031.1~uORF:IOH28000	982	45	937
B18R12C09	18-9-12	Hs~MGC:BC010362.1~uORF:IOH27799	640	349	291
B18R12C10	18-10-12	Hs~MGC:BC010362.1~uORF:IOH27799	624	54	570
B18R12C11	18-11-12	Hs~Ref:NM_033540.2~uORF:IOH27728	626	47	579
B18R12C12	18-12-12	Hs~Ref:NM_033540.2~uORF:IOH27728	566	46	520
B18R12C13	18-13-12	Hs~Ref:NM_020931.1~uORF:IOH26150	641	44	597
B18R12C14	18-14-12	Hs~Ref:NM_020931.1~uORF:IOH26150	653	44	609
B18R12C15	18-15-12	Hs~MGC:BC012815.1~uORF:IOH13053	96	49	47
B18R12C16	18-16-12	Hs~MGC:BC012815.1~uORF:IOH13053	103	44	59
B18R12C17	18-17-12	Hs~Ref:NM_005780.1~uORF:IOH13636	208	55	153
B18R12C18	18-18-12	Hs~Ref:NM_005780.1~uORF:IOH13636	545	48	497
B18R12C19	18-19-12	Hs~MGC:BC098149.1~uORF:IOH63298	640	51	589
B18R12C20	18-20-12	Hs~MGC:BC098149.1~uORF:IOH63298	381	229	152
B18R12C21	18-21-12	Hs~MGC:BC098117.1~uORF:IOH63340	589	48	541
B18R12C22	18-22-12	Hs~MGC:BC098117.1~uORF:IOH63340	539	45	494
B18R13C01	18-1-13	Hs~MGC:BC017918.1~uORF:IOH12709	1471	58	1413
B18R13C02	18-2-13	Hs~MGC:BC017918.1~uORF:IOH12709	1424	56	1368
B18R13C03	18-3-13	Hs~MGC:BC029427.1~uORF:IOH23192	763	50	713
B18R13C04	18-4-13	Hs~MGC:BC029427.1~uORF:IOH23192	768	47	721
B18R13C05	18-5-13	Hs~Ref:NM_032204.3~uORF:IOH12073	883	41	842
B18R13C06	18-6-13	Hs~Ref:NM_032204.3~uORF:IOH12073	858	40	818
B18R13C07	18-7-13	Hs~MGC:BC029359.1~uORF:IOH23174	345	39	306
B18R13C08	18-8-13	Hs~MGC:BC029359.1~uORF:IOH23174	580	50	530
B18R13C09	18-9-13	Hs~Ref:NM_017431.2~uORF:IOH40966	253	65	188
B18R13C10	18-10-13	Hs~Ref:NM_017431.2~uORF:IOH40966	378	55	323
B18R13C11	18-11-13	Hs~Ref:NM_032054.1~uORF:IOH36169	319	69	250
B18R13C12	18-12-13	Hs~Ref:NM_032054.1~uORF:IOH36169	293	85	208
B18R13C13	18-13-13	Hs~Ref:NM_007000.2~uORF:IOH35385	859	46	813
B18R13C14	18-14-13	Hs~Ref:NM_007000.2~uORF:IOH35385	812	42	770
B18R13C15	18-15-13	Hs~Ref:NM_183382.1~uORF:IOH40957	3778	42	3736
B18R13C16	18-16-13	Hs~Ref:NM_183382.1~uORF:IOH40957	3679	41	3638
B18R13C17	18-17-13	Hs~MGC:BC015904.1~uORF:IOH10110	324	42	282
B18R13C18	18-18-13	Hs~MGC:BC015904.1~uORF:IOH10110	273	44	229
B18R13C19	18-19-13	Hs~MGC:BC033819.1~uORF:IOH21870	467	51	416
B18R13C20	18-20-13	Hs~MGC:BC033819.1~uORF:IOH21870	819	60	759
B18R13C21	18-21-13	Hs~MGC:BC036450.1~uORF:IOH22401	361	84	277
B18R13C22	18-22-13	Hs~MGC:BC036450.1~uORF:IOH22401	216	77	139
B18R14C01	18-1-14	Hs~MGC:NM_138778.1~uORF:IOH14208	1338	389	949
B18R14C02	18-2-14	Hs~MGC:NM_138778.1~uORF:IOH14208	1387	244	1143
B18R14C03	18-3-14	Hs~Ref:NM_153183.1~uORF:IOH54677	202	42	160
B18R14C04	18-4-14	Hs~Ref:NM_153183.1~uORF:IOH54677	331	62	269
B18R14C05	18-5-14	Hs~Ref:NM_031431.2~uORF:IOH52865	701	40	661
B18R14C06	18-6-14	Hs~Ref:NM_031431.2~uORF:IOH52865	648	39	609
B18R14C07	18-7-14	Hs~Ref:NM_134268.3~uORF:IOH54738	164	42	122
B18R14C08	18-8-14	Hs~Ref:NM_134268.3~uORF:IOH54738	143	58	85
B18R14C09	18-9-14	Hs~Ref:NM_005101.1~uORF:IOH54680	414	274	140
B18R14C10	18-10-14	Hs~Ref:NM_005101.1~uORF:IOH54680	383	54	329
B18R14C11	18-11-14	Hs~Ref:NM_033214.2~uORF:IOH60256	268	50	218
B18R14C12	18-12-14	Hs~Ref:NM_033214.2~uORF:IOH60256	192	57	135
B18R14C13	18-13-14	Hs~Ref:NM_000758.2~uORF:IOH44352	631	43	588
B18R14C14	18-14-14	Hs~Ref:NM_000758.2~uORF:IOH44352	549	42	507
B18R14C15	18-15-14	Hs~MGC:BC102024.1~uORF:IOH63593	192	45	147
B18R14C16	18-16-14	Hs~MGC:BC102024.1~uORF:IOH63593	143	61	82
B18R14C17	18-17-14	Hs~MGC:BC005127.2~uORF:IOH5658	162	44	118
B18R14C18	18-18-14	Hs~MGC:BC005127.2~uORF:IOH5658	128	47	81
B18R14C19	18-19-14	Hs~MGC:BC009851.1~uORF:IOH12351	1370	52	1318
B18R14C20	18-20-14	Hs~MGC:BC009851.1~uORF:IOH12351	1432	57	1375
B18R14C21	18-21-14	Hs~Ref:NM_001005496.1~uORF:IOH60789	457	73	384
B18R14C22	18-22-14	Hs~Ref:NM_001005496.1~uORF:IOH60789	477	85	392
B18R15C01	18-1-15	Hs~Ref:NM_002642.1~uORF:IOH14889	12370	59	12311
B18R15C02	18-2-15	Hs~Ref:NM_002642.1~uORF:IOH14889	12079	49	12030
B18R15C03	18-3-15	Hs~MGC:BC101305.1~uORF:IOH63570	423	49	374
B18R15C04	18-4-15	Hs~MGC:BC101305.1~uORF:IOH63570	370	65	305
B18R15C05	18-5-15	Hs~MGC:BC024243.2~uORF:IOH22385	503	51	452
B18R15C06	18-6-15	Hs~MGC:BC024243.2~uORF:IOH22385	344	39	305
B18R15C07	18-7-15	Hs~MGC:BC041793.1~uORF:IOH27245	362	44	318
B18R15C08	18-8-15	Hs~MGC:BC041793.1~uORF:IOH27245	330	43	287
B18R15C09	18-9-15	Hs~Ref:NM_000167.1~uORF:IOH27543	304	61	243
B18R15C10	18-10-15	Hs~Ref:NM_000167.1~uORF:IOH27543	269	63	206
B18R15C11	18-11-15	Hs~MGC:BC047056.1~uORF:IOH27319	416	49	367
B18R15C12	18-12-15	Hs~MGC:BC047056.1~uORF:IOH27319	387	50	337
B18R15C13	18-13-15	Hs~IVGN:PM_2136~Ext:U1snRNP68~N/A	446	107	339
B18R15C14	18-14-15	Hs~IVGN:PM_2136~Ext:U1snRNP68~N/A	214	48	166
B18R15C15	18-15-15	Hs~Ref:NM_006875.1~CAT:PV3649	380	43	337
B18R15C16	18-16-15	Hs~Ref:NM_006875.1~CAT:PV3649	406	46	360
B18R15C17	18-17-15	Hs~Ref:NM_005607.1~CAT:PV3832	433	47	386
B18R15C18	18-18-15	Hs~Ref:NM_005607.1~CAT:PV3832	478	196	282
B18R15C19	18-19-15	Hs~Ref:NM_004333.1~CAT:PV3848	853	45	808
B18R15C20	18-20-15	Hs~Ref:NM_004333.1~CAT:PV3848	923	47	876
B18R15C21	18-21-15	Hs~Ref:NM_001896.2~CAT:PV3624	1934	43	1891
B18R15C22	18-22-15	Hs~Ref:NM_001896.2~CAT:PV3624	1695	40	1655
B18R16C01	18-1-16	Hs~Ref:NM_001348.1~CAT:PV3686	598	36	562
B18R16C02	18-2-16	Hs~Ref:NM_001348.1~CAT:PV3686	564	36	528
B18R16C03	18-3-16	Hs~Ref:NM_021803.1~CAT_PHC0215	768	36	732
B18R16C04	18-4-16	Hs~Ref:NM_021803.1~CAT_PHC0215	801	36	765
B18R16C05	18-5-16	Hs~Ref:NM_005026.2~CAT:PV5273	545	39	506
B18R16C06	18-6-16	Hs~Ref:NM_005026.2~CAT:PV5273	522	37	485
B18R16C07	18-7-16	Hs~Ref:NM_001025239.1~uORF:IOH58999	210	38	172
B18R16C08	18-8-16	Hs~Ref:NM_001025239.1~uORF:IOH58999	223	40	183
B18R16C09	18-9-16	Hs~Ref:NM_207448.1~uORF:IOH59696	275	62	213
B18R16C10	18-10-16	Hs~Ref:NM_207448.1~uORF:IOH59696	359	56	303
B18R16C11	18-11-16	Hs~Ref:NM_006850.2~uORF:IOH59724	252	53	199
B18R16C12	18-12-16	Hs~Ref:NM_006850.2~uORF:IOH59724	220	46	174
B18R16C13	18-13-16	Hs~Ref:NM_014220.2~uORF:IOH59024	289	64	225
B18R16C14	18-14-16	Hs~Ref:NM_014220.2~uORF:IOH59024	285	179	106
B18R16C15	18-15-16	Hs~Ref:NM_001012424.1~uORF:IOH57355	380	42	338
B18R16C16	18-16-16	Hs~Ref:NM_001012424.1~uORF:IOH57355	416	45	371
B18R16C17	18-17-16	Hs~MGC:BC023251.1~uORF:IOH25816	555	212	343
B18R16C18	18-18-16	Hs~MGC:BC023251.1~uORF:IOH25816	422	67	355
B18R16C19	18-19-16	Hs~Ref:NM_006004.1~uORF:IOH57362	325	119	206
B18R16C20	18-20-16	Hs~Ref:NM_006004.1~uORF:IOH57362	428	228	200
B18R16C21	18-21-16	Hs~MGC:BC064898.1~uORF:IOH39949	406	45	361
B18R16C22	18-22-16	Hs~MGC:BC064898.1~uORF:IOH39949	368	41	327
B18R17C01	18-1-17	Hs~MGC:BC011676.1~uORF:IOH13772	166	58	108
B18R17C02	18-2-17	Hs~MGC:BC011676.1~uORF:IOH13772	104	39	65
B18R17C03	18-3-17	Hs~Ref:NM_138385.1~uORF:IOH13771	135	64	71
B18R17C04	18-4-17	Hs~Ref:NM_138385.1~uORF:IOH13771	83	37	46
B18R17C05	18-5-17	Hs~Ref:NM_002065.3~uORF:IOH13814	361	39	322
B18R17C06	18-6-17	Hs~Ref:NM_002065.3~uORF:IOH13814	438	40	398
B18R17C07	18-7-17	Hs~MGC:BC010030.1~uORF:IOH14573	98	60	38
B18R17C08	18-8-17	Hs~MGC:BC010030.1~uORF:IOH14573	287	55	232
B18R17C09	18-9-17	Hs~MGC:BC064566.1~uORF:IOH39906	232	131	101
B18R17C10	18-10-17	Hs~MGC:BC064566.1~uORF:IOH39906	172	71	101
B18R17C11	18-11-17	Hs~MGC:BC011526.1~uORF:IOH9712	800	49	751
B18R17C12	18-12-17	Hs~MGC:BC011526.1~uORF:IOH9712	681	62	619
B18R17C13	18-13-17	Hs~MGC:BC022270.1~uORF:IOH12872	778	46	732
B18R17C14	18-14-17	Hs~MGC:BC022270.1~uORF:IOH12872	728	44	684
B18R17C15	18-15-17	Hs~Ref:NM_032138.2~uORF:IOH10969	623	42	581
B18R17C16	18-16-17	Hs~Ref:NM_032138.2~uORF:IOH10969	603	43	560
B18R17C17	18-17-17	Hs~Ref:NM_172028.1~uORF:IOH42497	564	290	274
B18R17C18	18-18-17	Hs~Ref:NM_172028.1~uORF:IOH42497	535	281	254
B18R17C19	18-19-17	Hs~Ref:NM_153284.1~uORF:IOH41629	312	46	266
B18R17C20	18-20-17	Hs~Ref:NM_153284.1~uORF:IOH41629	343	143	200
B18R17C21	18-21-17	Hs~Ref:NM_177974.1~uORF:IOH41242	676	43	633
B18R17C22	18-22-17	Hs~Ref:NM_177974.1~uORF:IOH41242	635	42	593
B18R18C01	18-1-18	Hs~Ref:NM_006438.2~uORF:IOH42479	351	37	314
B18R18C02	18-2-18	Hs~Ref:NM_006438.2~uORF:IOH42479	371	37	334
B18R18C03	18-3-18	Hs~MGC:BC058924.1~uORF:IOH29105	328	42	286
B18R18C04	18-4-18	Hs~MGC:BC058924.1~uORF:IOH29105	312	44	268
B18R18C05	18-5-18	Hs~Ref:NM_003856.1~uORF:IOH29806	81	42	39
B18R18C06	18-6-18	Hs~Ref:NM_003856.1~uORF:IOH29806	151	52	99
B18R18C07	18-7-18	Hs~MGC:BC067741.1~uORF:IOH61679	588	53	535
B18R18C08	18-8-18	Hs~MGC:BC067741.1~uORF:IOH61679	238	79	159
B18R18C09	18-9-18	Hs~MGC:BC101006.1~uORF:IOH63457	159	75	84
B18R18C10	18-10-18	Hs~MGC:BC101006.1~uORF:IOH63457	171	56	115
B18R18C11	18-11-18	Hs~MGC:BC072409.1~uORF:IOH62546	332	54	278
B18R18C12	18-12-18	Hs~MGC:BC072409.1~uORF:IOH62546	304	104	200
B18R18C13	18-13-18	Hs~MGC:BC000967.2~uORF:IOH61493	380	48	332
B18R18C14	18-14-18	Hs~MGC:BC000967.2~uORF:IOH61493	399	44	355
B18R18C15	18-15-18	Hs~MGC:BC005139.2~uORF:IOH4709	488	44	444
B18R18C16	18-16-18	Hs~MGC:BC005139.2~uORF:IOH4709	493	44	449
B18R18C17	18-17-18	Hs~Ref:NM_014815.2~uORF:IOH9726	995	45	950
B18R18C18	18-18-18	Hs~Ref:NM_014815.2~uORF:IOH9726	1004	43	961
B18R18C19	18-19-18	Hs~MGC:BC047883.2~uORF:IOH26992	381	43	338
B18R18C20	18-20-18	Hs~MGC:BC047883.2~uORF:IOH26992	340	54	286
B18R18C21	18-21-18	Hs~Ref:NM_005926.2~uORF:IOH27077	452	43	409
B18R18C22	18-22-18	Hs~Ref:NM_005926.2~uORF:IOH27077	495	43	452
B18R19C01	18-1-19	Hs~MGC:BC056257.1~uORF:IOH29441	389	37	352
B18R19C02	18-2-19	Hs~MGC:BC056257.1~uORF:IOH29441	388	38	350
B18R19C03	18-3-19	Hs~MGC:BC035972.1~uORF:IOH27964	353	40	313
B18R19C04	18-4-19	Hs~MGC:BC035972.1~uORF:IOH27964	328	41	287
B18R19C05	18-5-19	Hs~MGC:BC067826.1~uORF:IOH61627	396	43	353
B18R19C06	18-6-19	Hs~MGC:BC067826.1~uORF:IOH61627	363	42	321
B18R19C07	18-7-19	Hs~MGC:BC093051.1~uORF:IOH63174	549	60	489
B18R19C08	18-8-19	Hs~MGC:BC093051.1~uORF:IOH63174	272	91	181
B18R19C09	18-9-19	Hs~MGC:BC064422.1~uORF:IOH61572	175	68	107
B18R19C10	18-10-19	Hs~MGC:BC064422.1~uORF:IOH61572	229	91	138
B18R19C11	18-11-19	Hs~MGC:BC063672.1~uORF:IOH61517	93	46	47
B18R19C12	18-12-19	Hs~MGC:BC063672.1~uORF:IOH61517	94	48	46
B18R19C13	18-13-19	Hs~Ref:NM_012339.3~uORF:IOH6065	286	54	232
B18R19C14	18-14-19	Hs~Ref:NM_012339.3~uORF:IOH6065	330	48	282
B18R19C15	18-15-19	Hs~Ref:NM_006327.2~uORF:IOH40094	166	100	66
B18R19C16	18-16-19	Hs~Ref:NM_006327.2~uORF:IOH40094	162	52	110
B18R19C17	18-17-19	Hs~Ref:NM_206834.1~uORF:IOH40081	995	42	953
B18R19C18	18-18-19	Hs~Ref:NM_206834.1~uORF:IOH40081	981	41	940
B18R19C19	18-19-19	Hs~MGC:BC068537.1~uORF:IOH40089	235	58	177
B18R19C20	18-20-19	Hs~MGC:BC068537.1~uORF:IOH40089	276	156	120
B18R19C21	18-21-19	Hs~MGC:BC000607.1~uORF:IOH4250	213	43	170
B18R19C22	18-22-19	Hs~MGC:BC000607.1~uORF:IOH4250	50	42	8
B18R20C01	18-1-20	Hs~Ref:NM_001549.1~uORF:IOH3948	220	42	178
B18R20C02	18-2-20	Hs~Ref:NM_001549.1~uORF:IOH3948	256	116	140
B18R20C03	18-3-20	Hs~MGC:BC000651.1~uORF:IOH4188	259	44	215
B18R20C04	18-4-20	Hs~MGC:BC000651.1~uORF:IOH4188	289	42	247
B18R20C05	18-5-20	Hs~MGC:BC022524.1~uORF:IOH10757	37	37	0
B18R20C06	18-6-20	Hs~MGC:BC022524.1~uORF:IOH10757	36	37	-1
B18R20C07	18-7-20	Hs~MGC:BC007919.2~uORF:IOH40619	370	64	306
B18R20C08	18-8-20	Hs~MGC:BC007919.2~uORF:IOH40619	332	95	237
B18R20C09	18-9-20	Hs~Ref:NM_002355.2~uORF:IOH40579	594	68	526
B18R20C10	18-10-20	Hs~Ref:NM_002355.2~uORF:IOH40579	597	55	542
B18R20C11	18-11-20	Hs~MGC:BC000601.1~uORF:IOH4258	512	47	465
B18R20C12	18-12-20	Hs~MGC:BC000601.1~uORF:IOH4258	481	46	435
B18R20C13	18-13-20	Hs~Ref:NM_174933.2~uORF:IOH12686	2222	48	2174
B18R20C14	18-14-20	Hs~Ref:NM_174933.2~uORF:IOH12686	2169	43	2126
B18R20C15	18-15-20	Hs~Ref:NM_181287.1~uORF:IOH50170	838	43	795
B18R20C16	18-16-20	Hs~Ref:NM_181287.1~uORF:IOH50170	810	40	770
B18R20C17	18-17-20	Hs~MGC:BC008492.1~uORF:IOH7568	1038	39	999
B18R20C18	18-18-20	Hs~MGC:BC008492.1~uORF:IOH7568	1066	39	1027
B18R20C19	18-19-20	Hs~Ref:NM_001608.1~uORF:IOH27335	884	40	844
B18R20C20	18-20-20	Hs~Ref:NM_001608.1~uORF:IOH27335	956	40	916
B18R20C21	18-21-20	Hs~MGC:BC008884.1~uORF:IOH14312	761	40	721
B18R20C22	18-22-20	Hs~MGC:BC008884.1~uORF:IOH14312	751	40	711
B18R21C01	18-1-21	Hs~Ref:NM_022562.2~uORF:IOH50057	299	48	251
B18R21C02	18-2-21	Hs~Ref:NM_022562.2~uORF:IOH50057	183	177	6
B18R21C03	18-3-21	Hs~Ref:NM_022308.1~uORF:IOH50155	480	43	437
B18R21C04	18-4-21	Hs~Ref:NM_022308.1~uORF:IOH50155	396	41	355
B18R21C05	18-5-21	Hs~Ref:BC112433.1~uORF:IOH50072	918	39	879
B18R21C06	18-6-21	Hs~Ref:BC112433.1~uORF:IOH50072	938	39	899
B18R21C07	18-7-21	Hs~Ref:NM_001036646.1~uORF:IOH50127	499	57	442
B18R21C08	18-8-21	Hs~Ref:NM_001036646.1~uORF:IOH50127	312	86	226
B18R21C09	18-9-21	Hs~Ref:P02649~CAT_10817-H30E-25	63	63	0
B18R21C10	18-10-21	Hs~Ref:P02649~CAT_10817-H30E-25	57	47	10
B18R21C11	18-11-21	Internal_1007209	66	53	13
B18R21C12	18-12-21	Internal_1007209	56	43	13
B18R21C13	18-13-21	Hs~Ref:NP_001551.1~CAT_10943-H08H-25	44	39	5
B18R21C14	18-14-21	Hs~Ref:NP_001551.1~CAT_10943-H08H-25	45	38	7
B18R21C15	18-15-21	Internal_1007209	153	42	111
B18R21C16	18-16-21	Internal_1007209	143	40	103
B18R21C17	18-17-21	Hs~Ref:NP_006557.2~CAT_10565-H08H-25	37	38	-1
B18R21C18	18-18-21	Hs~Ref:NP_006557.2~CAT_10565-H08H-25	39	37	2
B18R21C19	18-19-21	Internal_1007209	40	38	2
B18R21C20	18-20-21	Internal_1007209	41	39	2
B18R21C21	18-21-21	Internal_1007209	43	39	4
B18R21C22	18-22-21	Internal_1007209	45	42	3
B18R22C01	18-1-22	ERa~N/A	2456	35	2421
B18R22C02	18-2-22	ERa~N/A	2457	36	2421
B18R22C03	18-3-22	PKCeta~N/A	116	36	80
B18R22C04	18-4-22	PKCeta~N/A	66	37	29
B18R22C05	18-5-22	Calmodulin~N/A	59	36	23
B18R22C06	18-6-22	Calmodulin~N/A	60	36	24
B18R22C07	18-7-22	V5control5~N/A	340	40	300
B18R22C08	18-8-22	V5control5~N/A	329	75	254
B18R22C09	18-9-22	V5control4~N/A	234	79	155
B18R22C10	18-10-22	V5control4~N/A	179	53	126
B18R22C11	18-11-22	V5control3~N/A	57	61	-4
B18R22C12	18-12-22	V5control3~N/A	102	46	56
B18R22C13	18-13-22	V5control2~N/A	58	41	17
B18R22C14	18-14-22	V5control2~N/A	56	39	17
B18R22C15	18-15-22	V5control1~N/A	53	38	15
B18R22C16	18-16-22	V5control1~N/A	72	40	32
B18R22C17	18-17-22	CMK2A~N/A	325	38	287
B18R22C18	18-18-22	CMK2A~N/A	340	38	302
B18R22C19	18-19-22	ERa~N/A	1733	38	1695
B18R22C20	18-20-22	ERa~N/A	1831	39	1792
B18R22C21	18-21-22	AlexaAntiMouseAb~N/A	9885	39	9846
B18R22C22	18-22-22	AlexaAntiMouseAb~N/A	10404	39	10365
B19R01C01	19-1-1	AlexaAntiMouseAb~N/A	38563	41	38522
B19R01C02	19-2-1	AlexaAntiMouseAb~N/A	37050	41	37009
B19R01C03	19-3-1	ERa~N/A	1589	41	1548
B19R01C04	19-4-1	ERa~N/A	1784	42	1742
B19R01C05	19-5-1	HumanIgG1~N/A	1131	42	1089
B19R01C06	19-6-1	HumanIgG1~N/A	1289	41	1248
B19R01C07	19-7-1	HumanIgG2~N/A	2650	41	2609
B19R01C08	19-8-1	HumanIgG2~N/A	3062	42	3020
B19R01C09	19-9-1	HumanIgG3~N/A	13159	43	13116
B19R01C10	19-10-1	HumanIgG3~N/A	14110	44	14066
B19R01C11	19-11-1	HumanIgG4~N/A	39725	45	39680
B19R01C12	19-12-1	HumanIgG4~N/A	46879	45	46834
B19R01C13	19-13-1	BiotinAb~N/A	422	45	377
B19R01C14	19-14-1	BiotinAb~N/A	768	54	714
B19R01C15	19-15-1	RanBP2deltaFG~N/A	672	299	373
B19R01C16	19-16-1	RanBP2deltaFG~N/A	841	61	780
B19R01C17	19-17-1	hMDM2~N/A	828	46	782
B19R01C18	19-18-1	hMDM2~N/A	828	47	781
B19R01C19	19-19-1	PKCeta~N/A	277	54	223
B19R01C20	19-20-1	PKCeta~N/A	568	129	439
B19R01C21	19-21-1	AlexaAntiMouseAb~N/A	37348	56	37292
B19R01C22	19-22-1	AlexaAntiMouseAb~N/A	35950	58	35892
B19R02C01	19-1-2	PKCeta~N/A	1616	46	1570
B19R02C02	19-2-2	PKCeta~N/A	1652	48	1604
B19R02C03	19-3-2	Buffer	200	47	153
B19R02C04	19-4-2	Buffer	235	59	176
B19R02C05	19-5-2	HumanIgA~N/A	21446	44	21402
B19R02C06	19-6-2	HumanIgA~N/A	21742	42	21700
B19R02C07	19-7-2	Buffer	106	41	65
B19R02C08	19-8-2	Buffer	97	42	55
B19R02C09	19-9-2	BSA~N/A	12761	45	12716
B19R02C10	19-10-2	BSA~N/A	12883	44	12839
B19R02C11	19-11-2	Hs~Ref:NM_006658.1~uORF:IOH21548	1356	45	1311
B19R02C12	19-12-2	Hs~Ref:NM_006658.1~uORF:IOH21548	1383	46	1337
B19R02C13	19-13-2	Hs~MGC:NM_182541.1~uORF:IOH21588	568	47	521
B19R02C14	19-14-2	Hs~MGC:NM_182541.1~uORF:IOH21588	716	211	505
B19R02C15	19-15-2	Hs~MGC:NM_174903.2~uORF:IOH22522	1165	74	1091
B19R02C16	19-16-2	Hs~MGC:NM_174903.2~uORF:IOH22522	906	65	841
B19R02C17	19-17-2	Hs~MGC:BC020814.1~uORF:IOH12692	455	52	403
B19R02C18	19-18-2	Hs~MGC:BC020814.1~uORF:IOH12692	456	250	206
B19R02C19	19-19-2	Hs~MGC:BC032454.1~uORF:IOH21666	460	61	399
B19R02C20	19-20-2	Hs~MGC:BC032454.1~uORF:IOH21666	469	71	398
B19R02C21	19-21-2	Hs~MGC:BC032372.1~uORF:IOH21643	1085	110	975
B19R02C22	19-22-2	Hs~MGC:BC032372.1~uORF:IOH21643	1329	979	350
B19R03C01	19-1-3	Hs~Ref:NM_145177.1~uORF:IOH21679	1255	44	1211
B19R03C02	19-2-3	Hs~Ref:NM_145177.1~uORF:IOH21679	1179	46	1133
B19R03C03	19-3-3	Hs~Ref:NM_152789.1~uORF:IOH21683	1362	44	1318
B19R03C04	19-4-3	Hs~Ref:NM_152789.1~uORF:IOH21683	1334	47	1287
B19R03C05	19-5-3	Hs~Ref:NM_005339.3~uORF:IOH13913	339	50	289
B19R03C06	19-6-3	Hs~Ref:NM_005339.3~uORF:IOH13913	354	49	305
B19R03C07	19-7-3	Hs~MGC:BC025278.1~uORF:IOH14045	397	83	314
B19R03C08	19-8-3	Hs~MGC:BC025278.1~uORF:IOH14045	92	48	44
B19R03C09	19-9-3	Hs~Ref:NM_021105.1~uORF:IOH13995	476	50	426
B19R03C10	19-10-3	Hs~Ref:NM_021105.1~uORF:IOH13995	558	49	509
B19R03C11	19-11-3	Hs~Ref:NM_022758.2~uORF:IOH14405	391	50	341
B19R03C12	19-12-3	Hs~Ref:NM_022758.2~uORF:IOH14405	481	89	392
B19R03C13	19-13-3	Hs~Ref:NM_007208.2~uORF:IOH2930	137	53	84
B19R03C14	19-14-3	Hs~Ref:NM_007208.2~uORF:IOH2930	72	45	27
B19R03C15	19-15-3	Hs~MGC:BC042869.1~uORF:IOH26487	1560	53	1507
B19R03C16	19-16-3	Hs~MGC:BC042869.1~uORF:IOH26487	82	44	38
B19R03C17	19-17-3	Hs~Ref:NM_007268.1~uORF:IOH10254	338	123	215
B19R03C18	19-18-3	Hs~Ref:NM_007268.1~uORF:IOH10254	245	47	198
B19R03C19	19-19-3	Hs~Ref:NM_024102.2~uORF:IOH10338	593	192	401
B19R03C20	19-20-3	Hs~Ref:NM_024102.2~uORF:IOH10338	436	65	371
B19R03C21	19-21-3	Hs~MGC:BC005930.1~uORF:IOH7549	632	366	266
B19R03C22	19-22-3	Hs~MGC:BC005930.1~uORF:IOH7549	598	62	536
B19R04C01	19-1-4	Hs~MGC:BC019102.1~uORF:IOH14069	524	41	483
B19R04C02	19-2-4	Hs~MGC:BC019102.1~uORF:IOH14069	506	42	464
B19R04C03	19-3-4	Hs~MGC:BC021105.1~uORF:IOH14081	743	41	702
B19R04C04	19-4-4	Hs~MGC:BC021105.1~uORF:IOH14081	724	45	679
B19R04C05	19-5-4	Hs~Ref:NM_001168.1~uORF:IOH5749	276	129	147
B19R04C06	19-6-4	Hs~Ref:NM_001168.1~uORF:IOH5749	292	128	164
B19R04C07	19-7-4	Hs~MGC:BC030643.2~uORF:IOH22296	171	53	118
B19R04C08	19-8-4	Hs~MGC:BC030643.2~uORF:IOH22296	115	50	65
B19R04C09	19-9-4	Hs~MGC:NM_152763.2~uORF:IOH22315	634	48	586
B19R04C10	19-10-4	Hs~MGC:NM_152763.2~uORF:IOH22315	652	49	603
B19R04C11	19-11-4	Hs~MGC:BC033009.2~uORF:IOH22324	39	42	-3
B19R04C12	19-12-4	Hs~MGC:BC033009.2~uORF:IOH22324	40	41	-1
B19R04C13	19-13-4	Hs~Ref:NM_000023.1~uORF:IOH10645	844	44	800
B19R04C14	19-14-4	Hs~Ref:NM_000023.1~uORF:IOH10645	801	44	757
B19R04C15	19-15-4	Hs~Ref:NM_004227.3~uORF:IOH11547	1073	45	1028
B19R04C16	19-16-4	Hs~Ref:NM_004227.3~uORF:IOH11547	1147	44	1103
B19R04C17	19-17-4	Hs~Ref:NM_006870.2~uORF:IOH12247	162	58	104
B19R04C18	19-18-4	Hs~Ref:NM_006870.2~uORF:IOH12247	286	98	188
B19R04C19	19-19-4	Hs~MGC:BC007722.2~uORF:IOH6489	35	54	-19
B19R04C20	19-20-4	Hs~MGC:BC007722.2~uORF:IOH6489	169	46	123
B19R04C21	19-21-4	Hs~Ref:NM_002046.2~uORF:IOH3380	390	51	339
B19R04C22	19-22-4	Hs~Ref:NM_002046.2~uORF:IOH3380	368	53	315
B19R05C01	19-1-5	Hs~Ref:NM_024117.3~uORF:IOH3756	251	43	208
B19R05C02	19-2-5	Hs~Ref:NM_024117.3~uORF:IOH3756	228	44	184
B19R05C03	19-3-5	Hs~Ref:NM_001011538.1~uORF:IOH39826	281	51	230
B19R05C04	19-4-5	Hs~Ref:NM_001011538.1~uORF:IOH39826	284	49	235
B19R05C05	19-5-5	Hs~Ref:NM_152688.1~uORF:IOH22222	361	48	313
B19R05C06	19-6-5	Hs~Ref:NM_152688.1~uORF:IOH22222	395	90	305
B19R05C07	19-7-5	Hs~Ref:NM_014321.2~uORF:IOH39827	715	47	668
B19R05C08	19-8-5	Hs~Ref:NM_014321.2~uORF:IOH39827	787	46	741
B19R05C09	19-9-5	Hs~MGC:BC011904.1~uORF:IOH13374	750	48	702
B19R05C10	19-10-5	Hs~MGC:BC011904.1~uORF:IOH13374	720	47	673
B19R05C11	19-11-5	Hs~Ref:NM_024295.1~uORF:IOH4224	773	47	726
B19R05C12	19-12-5	Hs~Ref:NM_024295.1~uORF:IOH4224	732	47	685
B19R05C13	19-13-5	Hs~MGC:BC001116.1~uORF:IOH3881	516	49	467
B19R05C14	19-14-5	Hs~MGC:BC001116.1~uORF:IOH3881	634	62	572
B19R05C15	19-15-5	Hs~Ref:NM_003404.2~uORF:IOH3955	1103	47	1056
B19R05C16	19-16-5	Hs~Ref:NM_003404.2~uORF:IOH3955	994	44	950
B19R05C17	19-17-5	Hs~Ref:NM_021735.1~uORF:IOH29577	68	43	25
B19R05C18	19-18-5	Hs~Ref:NM_021735.1~uORF:IOH29577	65	44	21
B19R05C19	19-19-5	Hs~MGC:BC042147.1~uORF:IOH27991	100	45	55
B19R05C20	19-20-5	Hs~MGC:BC042147.1~uORF:IOH27991	93	48	45
B19R05C21	19-21-5	Hs~Ref:NM_138771.2~uORF:IOH40866	49	57	-8
B19R05C22	19-22-5	Hs~Ref:NM_138771.2~uORF:IOH40866	54	56	-2
B19R06C01	19-1-6	Hs~Ref:NM_144711.3~uORF:IOH40820	89	43	46
B19R06C02	19-2-6	Hs~Ref:NM_144711.3~uORF:IOH40820	74	42	32
B19R06C03	19-3-6	Hs~MGC:BC012333.1~uORF:IOH12139	359	44	315
B19R06C04	19-4-6	Hs~MGC:BC012333.1~uORF:IOH12139	544	53	491
B19R06C05	19-5-6	Hs~MGC:BC012056.1~uORF:IOH13300	391	95	296
B19R06C06	19-6-6	Hs~MGC:BC012056.1~uORF:IOH13300	200	48	152
B19R06C07	19-7-6	Hs~MGC:BC015912.1~uORF:IOH13084	99	53	46
B19R06C08	19-8-6	Hs~MGC:BC015912.1~uORF:IOH13084	501	57	444
B19R06C09	19-9-6	Hs~MGC:BC010394.1~uORF:IOH12343	343	48	295
B19R06C10	19-10-6	Hs~MGC:BC010394.1~uORF:IOH12343	409	127	282
B19R06C11	19-11-6	Hs~Ref:NM_138334.1~uORF:IOH40016	396	53	343
B19R06C12	19-12-6	Hs~Ref:NM_138334.1~uORF:IOH40016	430	56	374
B19R06C13	19-13-6	Hs~MGC:BC064545.1~uORF:IOH39915	316	52	264
B19R06C14	19-14-6	Hs~MGC:BC064545.1~uORF:IOH39915	514	61	453
B19R06C15	19-15-6	Hs~MGC:BC066364.1~uORF:IOH39987	450	70	380
B19R06C16	19-16-6	Hs~MGC:BC066364.1~uORF:IOH39987	391	49	342
B19R06C17	19-17-6	Hs~Ref:NM_033495.2~uORF:IOH40892	255	45	210
B19R06C18	19-18-6	Hs~Ref:NM_033495.2~uORF:IOH40892	262	47	215
B19R06C19	19-19-6	Hs~MGC:BC013900.1~uORF:IOH27818	2344	48	2296
B19R06C20	19-20-6	Hs~MGC:BC013900.1~uORF:IOH27818	2401	52	2349
B19R06C21	19-21-6	Hs~MGC:BC035969.1~uORF:IOH27974	495	69	426
B19R06C22	19-22-6	Hs~MGC:BC035969.1~uORF:IOH27974	62	50	12
B19R07C01	19-1-7	Hs~MGC:BC009251.1~uORF:IOH27776	270	42	228
B19R07C02	19-2-7	Hs~MGC:BC009251.1~uORF:IOH27776	252	45	207
B19R07C03	19-3-7	Hs~MGC:BC035968.1~uORF:IOH27970	343	47	296
B19R07C04	19-4-7	Hs~MGC:BC035968.1~uORF:IOH27970	351	53	298
B19R07C05	19-5-7	Hs~MGC:BC051031.1~uORF:IOH26563	394	57	337
B19R07C06	19-6-7	Hs~MGC:BC051031.1~uORF:IOH26563	382	55	327
B19R07C07	19-7-7	Hs~MGC:BC000157.2~uORF:IOH2943	780	50	730
B19R07C08	19-8-7	Hs~MGC:BC000157.2~uORF:IOH2943	747	47	700
B19R07C09	19-9-7	Hs~MGC:BC041563.1~uORF:IOH28055	381	53	328
B19R07C10	19-10-7	Hs~MGC:BC041563.1~uORF:IOH28055	339	52	287
B19R07C11	19-11-7	Hs~MGC:BC000934.2~uORF:IOH2996	931	53	878
B19R07C12	19-12-7	Hs~MGC:BC000934.2~uORF:IOH2996	1151	116	1035
B19R07C13	19-13-7	Hs~Ref:XM_371167.3~uORF:IOH43598	956	46	910
B19R07C14	19-14-7	Hs~Ref:XM_371167.3~uORF:IOH43598	981	45	936
B19R07C15	19-15-7	Hs~Ref:NM_175571.2~uORF:IOH44212	911	43	868
B19R07C16	19-16-7	Hs~Ref:NM_175571.2~uORF:IOH44212	916	43	873
B19R07C17	19-17-7	Hs~Ref:XM_085236.6~uORF:IOH43659	1014	44	970
B19R07C18	19-18-7	Hs~Ref:XM_085236.6~uORF:IOH43659	997	44	953
B19R07C19	19-19-7	Hs~Ref:XM_379114.1~uORF:IOH42885	4278	46	4232
B19R07C20	19-20-7	Hs~Ref:XM_379114.1~uORF:IOH42885	4393	49	4344
B19R07C21	19-21-7	Hs~Ref:NM_016207.2~uORF:IOH14059	6170	59	6111
B19R07C22	19-22-7	Hs~Ref:NM_016207.2~uORF:IOH14059	6025	48	5977
B19R08C01	19-1-8	Hs~MGC:BC021561.1~uORF:IOH14131	743	40	703
B19R08C02	19-2-8	Hs~MGC:BC021561.1~uORF:IOH14131	776	43	733
B19R08C03	19-3-8	Hs~Ref:NM_005347.2~uORF:IOH14762	602	49	553
B19R08C04	19-4-8	Hs~Ref:NM_005347.2~uORF:IOH14762	687	51	636
B19R08C05	19-5-8	Hs~MGC:BC028840.1~uORF:IOH13887	564	54	510
B19R08C06	19-6-8	Hs~MGC:BC028840.1~uORF:IOH13887	637	112	525
B19R08C07	19-7-8	Hs~MGC:BC017810.1~uORF:IOH12948	594	78	516
B19R08C08	19-8-8	Hs~MGC:BC017810.1~uORF:IOH12948	497	54	443
B19R08C09	19-9-8	Hs~Ref:NM_000327.2~uORF:IOH3307	246	89	157
B19R08C10	19-10-8	Hs~Ref:NM_000327.2~uORF:IOH3307	294	50	244
B19R08C11	19-11-8	Hs~MGC:BC031068.1~uORF:IOH22548	373	47	326
B19R08C12	19-12-8	Hs~MGC:BC031068.1~uORF:IOH22548	432	46	386
B19R08C13	19-13-8	Hs~Ref:NM_018107.2~uORF:IOH4028	652	44	608
B19R08C14	19-14-8	Hs~Ref:NM_018107.2~uORF:IOH4028	650	43	607
B19R08C15	19-15-8	Hs~Ref:NM_016041.1~uORF:IOH14205	282	42	240
B19R08C16	19-16-8	Hs~Ref:NM_016041.1~uORF:IOH14205	255	57	198
B19R08C17	19-17-8	Hs~Ref:NM_005851.2~uORF:IOH5446	564	42	522
B19R08C18	19-18-8	Hs~Ref:NM_005851.2~uORF:IOH5446	579	42	537
B19R08C19	19-19-8	Hs~Ref:NM_004223.1~uORF:IOH21743	277	62	215
B19R08C20	19-20-8	Hs~Ref:NM_004223.1~uORF:IOH21743	192	47	145
B19R08C21	19-21-8	Hs~Ref:NM_004066.1~uORF:IOH22566	1731	81	1650
B19R08C22	19-22-8	Hs~Ref:NM_004066.1~uORF:IOH22566	1764	63	1701
B19R09C01	19-1-9	Hs~Ref:NM_182578.1~uORF:IOH35353	697	40	657
B19R09C02	19-2-9	Hs~Ref:NM_182578.1~uORF:IOH35353	712	41	671
B19R09C03	19-3-9	Hs~Ref:NM_176870.1~uORF:IOH11808	507	46	461
B19R09C04	19-4-9	Hs~Ref:NM_176870.1~uORF:IOH11808	547	334	213
B19R09C05	19-5-9	Hs~Ref:NM_025212.1~uORF:IOH35255	583	49	534
B19R09C06	19-6-9	Hs~Ref:NM_025212.1~uORF:IOH35255	531	48	483
B19R09C07	19-7-9	Hs~Ref:NM_006246.2~uORF:IOH29856	898	45	853
B19R09C08	19-8-9	Hs~Ref:NM_006246.2~uORF:IOH29856	988	48	940
B19R09C09	19-9-9	Hs~MGC:BC024001.2~uORF:IOH11161	466	57	409
B19R09C10	19-10-9	Hs~MGC:BC024001.2~uORF:IOH11161	391	286	105
B19R09C11	19-11-9	Hs~Ref:NM_017946.1~uORF:IOH7284	364	44	320
B19R09C12	19-12-9	Hs~Ref:NM_017946.1~uORF:IOH7284	400	45	355
B19R09C13	19-13-9	Hs~Ref:NM_138796.1~uORF:IOH10943	251	43	208
B19R09C14	19-14-9	Hs~Ref:NM_138796.1~uORF:IOH10943	241	44	197
B19R09C15	19-15-9	Hs~MGC:BC020692.1~uORF:IOH13652	310	46	264
B19R09C16	19-16-9	Hs~MGC:BC020692.1~uORF:IOH13652	303	45	258
B19R09C17	19-17-9	Hs~Ref:NM_025187.2~uORF:IOH6362	426	43	383
B19R09C18	19-18-9	Hs~Ref:NM_025187.2~uORF:IOH6362	422	42	380
B19R09C19	19-19-9	Hs~MGC:NM_002791.1~uORF:IOH4917	391	49	342
B19R09C20	19-20-9	Hs~MGC:NM_002791.1~uORF:IOH4917	428	276	152
B19R09C21	19-21-9	Hs~Ref:NM_016025.2~uORF:IOH4369	330	90	240
B19R09C22	19-22-9	Hs~Ref:NM_016025.2~uORF:IOH4369	400	123	277
B19R10C01	19-1-10	Hs~MGC:BC008959.1~uORF:IOH6087	167	46	121
B19R10C02	19-2-10	Hs~MGC:BC008959.1~uORF:IOH6087	205	46	159
B19R10C03	19-3-10	Hs~MGC:NM_175899.2~uORF:IOH14092	597	46	551
B19R10C04	19-4-10	Hs~MGC:NM_175899.2~uORF:IOH14092	654	49	605
B19R10C05	19-5-10	Hs~MGC:BC004938.1~uORF:IOH5465	509	44	465
B19R10C06	19-6-10	Hs~MGC:BC004938.1~uORF:IOH5465	650	45	605
B19R10C07	19-7-10	Hs~MGC:BC015899.1~uORF:IOH10023	516	44	472
B19R10C08	19-8-10	Hs~MGC:BC015899.1~uORF:IOH10023	595	47	548
B19R10C09	19-9-10	Hs~MGC:BC001511.1~uORF:IOH14531	287	57	230
B19R10C10	19-10-10	Hs~MGC:BC001511.1~uORF:IOH14531	296	54	242
B19R10C11	19-11-10	GST1	44	42	2
B19R10C12	19-12-10	GST1	45	40	5
B19R10C13	19-13-10	GST2	116	44	72
B19R10C14	19-14-10	GST2	49	40	9
B19R10C15	19-15-10	GST3	55	43	12
B19R10C16	19-16-10	GST3	269	48	221
B19R10C17	19-17-10	GST4	118	44	74
B19R10C18	19-18-10	GST4	61	41	20
B19R10C19	19-19-10	Anti-HumanIgA1~N/A	7335	43	7292
B19R10C20	19-20-10	Anti-HumanIgA1~N/A	7477	43	7434
B19R10C21	19-21-10	Anti-HumanIgA2~N/A	15183	46	15137
B19R10C22	19-22-10	Anti-HumanIgA2~N/A	16400	45	16355
B19R11C01	19-1-11	AlexaAntiMouseAb~N/A	26367	41	26326
B19R11C02	19-2-11	AlexaAntiMouseAb~N/A	27702	43	27659
B19R11C03	19-3-11	MAPKAP~N/A	153	44	109
B19R11C04	19-4-11	MAPKAP~N/A	61	48	13
B19R11C05	19-5-11	Buffer	125	42	83
B19R11C06	19-6-11	Buffer	244	55	189
B19R11C07	19-7-11	BSA~N/A	10001	45	9956
B19R11C08	19-8-11	BSA~N/A	9488	44	9444
B19R11C09	19-9-11	Anti-HumanIgG1~N/A	1660	51	1609
B19R11C10	19-10-11	Anti-HumanIgG1~N/A	1555	47	1508
B19R11C11	19-11-11	Anti-HumanIgG2~N/A	2879	41	2838
B19R11C12	19-12-11	Anti-HumanIgG2~N/A	3001	41	2960
B19R11C13	19-13-11	Anti-HumanIgG3~N/A	5281	40	5241
B19R11C14	19-14-11	Anti-HumanIgG3~N/A	5743	41	5702
B19R11C15	19-15-11	Anti-HumanIgG4~N/A	10850	43	10807
B19R11C16	19-16-11	Anti-HumanIgG4~N/A	11832	43	11789
B19R11C17	19-17-11	AntiBiotinAb~N/A	12276	42	12234
B19R11C18	19-18-11	AntiBiotinAb~N/A	13037	41	12996
B19R11C19	19-19-11	Buffer	60	41	19
B19R11C20	19-20-11	Buffer	57	40	17
B19R11C21	19-21-11	Hs~Ref:NM_020892.1~uORF:IOH25783	963	42	921
B19R11C22	19-22-11	Hs~Ref:NM_020892.1~uORF:IOH25783	1043	42	1001
B19R12C01	19-1-12	Hs~Ref:NM_018038.1~uORF:IOH35119	355	40	315
B19R12C02	19-2-12	Hs~Ref:NM_018038.1~uORF:IOH35119	363	43	320
B19R12C03	19-3-12	Hs~Ref:NM_020415.2~uORF:IOH40390	965	43	922
B19R12C04	19-4-12	Hs~Ref:NM_020415.2~uORF:IOH40390	856	43	813
B19R12C05	19-5-12	Hs~Ref:NM_006349.2~uORF:IOH27942	516	45	471
B19R12C06	19-6-12	Hs~Ref:NM_006349.2~uORF:IOH27942	449	49	400
B19R12C07	19-7-12	Hs~Ref:NM_002429.3~uORF:IOH26664	530	45	485
B19R12C08	19-8-12	Hs~Ref:NM_002429.3~uORF:IOH26664	475	46	429
B19R12C09	19-9-12	Hs~Ref:NM_014466.2~uORF:IOH27569	1037	64	973
B19R12C10	19-10-12	Hs~Ref:NM_014466.2~uORF:IOH27569	1034	51	983
B19R12C11	19-11-12	Hs~Ref:NM_004873.1~uORF:IOH26366	1379	42	1337
B19R12C12	19-12-12	Hs~Ref:NM_004873.1~uORF:IOH26366	1394	42	1352
B19R12C13	19-13-12	Hs~MGC:BC042628.1~uORF:IOH27650	550	41	509
B19R12C14	19-14-12	Hs~MGC:BC042628.1~uORF:IOH27650	582	41	541
B19R12C15	19-15-12	Hs~MGC:BC024011.2~uORF:IOH10804	233	43	190
B19R12C16	19-16-12	Hs~MGC:BC024011.2~uORF:IOH10804	257	77	180
B19R12C17	19-17-12	Hs~Ref:NM_004085.2~uORF:IOH7324	204	42	162
B19R12C18	19-18-12	Hs~Ref:NM_004085.2~uORF:IOH7324	199	43	156
B19R12C19	19-19-12	Hs~Ref:NM_001643.1~uORF:IOH7290	240	53	187
B19R12C20	19-20-12	Hs~Ref:NM_001643.1~uORF:IOH7290	171	83	88
B19R12C21	19-21-12	Hs~MGC:BC047023.1~uORF:IOH26604	283	59	224
B19R12C22	19-22-12	Hs~MGC:BC047023.1~uORF:IOH26604	240	43	197
B19R13C01	19-1-13	Hs~MGC:BC028583.1~uORF:IOH11658	417	41	376
B19R13C02	19-2-13	Hs~MGC:BC028583.1~uORF:IOH11658	423	48	375
B19R13C03	19-3-13	Hs~Ref:NM_006247.2~uORF:IOH3193	394	50	344
B19R13C04	19-4-13	Hs~Ref:NM_006247.2~uORF:IOH3193	385	59	326
B19R13C05	19-5-13	Hs~MGC:BC011686.2~uORF:IOH13816	924	60	864
B19R13C06	19-6-13	Hs~MGC:BC011686.2~uORF:IOH13816	501	53	448
B19R13C07	19-7-13	Hs~MGC:BC025765.1~uORF:IOH10803	197	48	149
B19R13C08	19-8-13	Hs~MGC:BC025765.1~uORF:IOH10803	500	114	386
B19R13C09	19-9-13	Hs~MGC:NM_177435.1~uORF:IOH5357	228	71	157
B19R13C10	19-10-13	Hs~MGC:NM_177435.1~uORF:IOH5357	342	79	263
B19R13C11	19-11-13	Hs~MGC:BC013648.1~uORF:IOH10208	659	48	611
B19R13C12	19-12-13	Hs~MGC:BC013648.1~uORF:IOH10208	660	45	615
B19R13C13	19-13-13	Hs~MGC:BC016440.1~uORF:IOH10264	375	46	329
B19R13C14	19-14-13	Hs~MGC:BC016440.1~uORF:IOH10264	353	45	308
B19R13C15	19-15-13	Hs~Ref:NM_001564.1~uORF:IOH22913	379	43	336
B19R13C16	19-16-13	Hs~Ref:NM_001564.1~uORF:IOH22913	363	41	322
B19R13C17	19-17-13	Hs~Ref:NM_021149.1~uORF:IOH12644	548	40	508
B19R13C18	19-18-13	Hs~Ref:NM_021149.1~uORF:IOH12644	546	40	506
B19R13C19	19-19-13	Hs~Ref:NM_022905.2~uORF:IOH13278	1212	41	1171
B19R13C20	19-20-13	Hs~Ref:NM_022905.2~uORF:IOH13278	1345	42	1303
B19R13C21	19-21-13	Hs~MGC:BC014486.1~uORF:IOH13590	604	42	562
B19R13C22	19-22-13	Hs~MGC:BC014486.1~uORF:IOH13590	589	41	548
B19R14C01	19-1-14	Hs~MGC:BC022851.1~uORF:IOH12748	450	42	408
B19R14C02	19-2-14	Hs~MGC:BC022851.1~uORF:IOH12748	502	47	455
B19R14C03	19-3-14	Hs~MGC:BC013187.1~uORF:IOH22114	55	51	4
B19R14C04	19-4-14	Hs~MGC:BC013187.1~uORF:IOH22114	276	48	228
B19R14C05	19-5-14	Hs~MGC:BC028135.1~uORF:IOH11327	310	65	245
B19R14C06	19-6-14	Hs~MGC:BC028135.1~uORF:IOH11327	378	53	325
B19R14C07	19-7-14	Hs~Ref:NM_005785.2~uORF:IOH21937	308	45	263
B19R14C08	19-8-14	Hs~Ref:NM_005785.2~uORF:IOH21937	532	53	479
B19R14C09	19-9-14	Hs~Ref:NM_024038.2~uORF:IOH5926	5779	63	5716
B19R14C10	19-10-14	Hs~Ref:NM_024038.2~uORF:IOH5926	5828	59	5769
B19R14C11	19-11-14	Hs~Ref:NM_000788.1~uORF:IOH42066	289	49	240
B19R14C12	19-12-14	Hs~Ref:NM_000788.1~uORF:IOH42066	292	46	246
B19R14C13	19-13-14	Hs~Ref:NM_001012978.1~uORF:IOH42168	330	45	285
B19R14C14	19-14-14	Hs~Ref:NM_001012978.1~uORF:IOH42168	316	43	273
B19R14C15	19-15-14	Hs~Ref:NM_002875.2~uORF:IOH41191	315	41	274
B19R14C16	19-16-14	Hs~Ref:NM_002875.2~uORF:IOH41191	312	39	273
B19R14C17	19-17-14	Hs~Ref:NM_032263.2~uORF:IOH42364	270	40	230
B19R14C18	19-18-14	Hs~Ref:NM_032263.2~uORF:IOH42364	295	41	254
B19R14C19	19-19-14	Hs~MGC:NM_178324.1~uORF:IOH7417	356	43	313
B19R14C20	19-20-14	Hs~MGC:NM_178324.1~uORF:IOH7417	338	44	294
B19R14C21	19-21-14	Hs~Ref:NM_032027.2~uORF:IOH22514	275	43	232
B19R14C22	19-22-14	Hs~Ref:NM_032027.2~uORF:IOH22514	284	43	241
B19R15C01	19-1-15	Hs~Ref:NM_152563.1~uORF:IOH21932	302	42	260
B19R15C02	19-2-15	Hs~Ref:NM_152563.1~uORF:IOH21932	385	45	340
B19R15C03	19-3-15	Hs~Ref:NM_004867.2~uORF:IOH26247	243	49	194
B19R15C04	19-4-15	Hs~Ref:NM_004867.2~uORF:IOH26247	342	93	249
B19R15C05	19-5-15	Hs~Ref:NM_004871.2~uORF:IOH45920	1566	46	1520
B19R15C06	19-6-15	Hs~Ref:NM_004871.2~uORF:IOH45920	1661	48	1613
B19R15C07	19-7-15	Hs~Ref:NM_207519.1~uORF:IOH45475	422	116	306
B19R15C08	19-8-15	Hs~Ref:NM_207519.1~uORF:IOH45475	362	46	316
B19R15C09	19-9-15	Hs~Ref:NM_006800.2~uORF:IOH45528	2315	40	2275
B19R15C10	19-10-15	Hs~Ref:NM_006800.2~uORF:IOH45528	2510	43	2467
B19R15C11	19-11-15	Hs~Ref:NM_199163.2~uORF:IOH45459	242	112	130
B19R15C12	19-12-15	Hs~Ref:NM_199163.2~uORF:IOH45459	128	50	78
B19R15C13	19-13-15	Hs~N/A:NM_006206.3~CAT:PV4203	368	45	323
B19R15C14	19-14-15	Hs~N/A:NM_006206.3~CAT:PV4203	309	42	267
B19R15C15	19-15-15	Hs~Ref:NM_002969.2~CAT:PV3654	90	44	46
B19R15C16	19-16-15	Hs~Ref:NM_002969.2~CAT:PV3654	98	43	55
B19R15C17	19-17-15	Hs~Ref:NM_006257.2~CAT:P2996	304	41	263
B19R15C18	19-18-15	Hs~Ref:NM_006257.2~CAT:P2996	327	42	285
B19R15C19	19-19-15	Hs~Ref:NM_005627.1~CAT:PV3818	200	44	156
B19R15C20	19-20-15	Hs~Ref:NM_005627.1~CAT:PV3818	199	52	147
B19R15C21	19-21-15	Hs~Ref:NM_002578.1~CAT:PV3789	414	42	372
B19R15C22	19-22-15	Hs~Ref:NM_002578.1~CAT:PV3789	412	42	370
B19R16C01	19-1-16	Hs~Ref:NM_138993.1~CAT:PV3679	207	40	167
B19R16C02	19-2-16	Hs~Ref:NM_138993.1~CAT:PV3679	194	41	153
B19R16C03	19-3-16	Hs~Ref:NM_021976.3~CAT:PV4390	167	45	122
B19R16C04	19-4-16	Hs~Ref:NM_021976.3~CAT:PV4390	266	136	130
B19R16C05	19-5-16	Hs~Ref:NM_002755.2~CAT:P3093	87	45	42
B19R16C06	19-6-16	Hs~Ref:NM_002755.2~CAT:P3093	123	58	65
B19R16C07	19-7-16	Hs~Ref:NM_005828.1~uORF:IOH3135	100	44	56
B19R16C08	19-8-16	Hs~Ref:NM_005828.1~uORF:IOH3135	108	42	66
B19R16C09	19-9-16	Hs~Ref:NM_006112.1~uORF:IOH5219	438	40	398
B19R16C10	19-10-16	Hs~Ref:NM_006112.1~uORF:IOH5219	428	41	387
B19R16C11	19-11-16	Hs~Ref:NM_021972.2~uORF:IOH13586	150	45	105
B19R16C12	19-12-16	Hs~Ref:NM_021972.2~uORF:IOH13586	295	111	184
B19R16C13	19-13-16	Hs~Ref:NM_005276.1~uORF:IOH22621	108	44	64
B19R16C14	19-14-16	Hs~Ref:NM_005276.1~uORF:IOH22621	248	56	192
B19R16C15	19-15-16	Hs~Ref:NM_001010918.1~uORF:IOH57360	465	42	423
B19R16C16	19-16-16	Hs~Ref:NM_001010918.1~uORF:IOH57360	542	41	501
B19R16C17	19-17-16	Hs~Ref:NM_012320.3~uORF:IOH39852	402	44	358
B19R16C18	19-18-16	Hs~Ref:NM_012320.3~uORF:IOH39852	380	43	337
B19R16C19	19-19-16	Hs~Ref:NM_004889.2~uORF:IOH57366	426	42	384
B19R16C20	19-20-16	Hs~Ref:NM_004889.2~uORF:IOH57366	442	42	400
B19R16C21	19-21-16	Hs~Ref:NM_017646.3~uORF:IOH37769	1226	42	1184
B19R16C22	19-22-16	Hs~Ref:NM_017646.3~uORF:IOH37769	1224	42	1182
B19R17C01	19-1-17	Hs~MGC:BC042864.1~uORF:IOH26525	432	43	389
B19R17C02	19-2-17	Hs~MGC:BC042864.1~uORF:IOH26525	234	45	189
B19R17C03	19-3-17	Hs~Ref:NM_203305.1~uORF:IOH26383	735	45	690
B19R17C04	19-4-17	Hs~Ref:NM_203305.1~uORF:IOH26383	749	45	704
B19R17C05	19-5-17	Hs~MGC:BC008748.2~uORF:IOH5941	1109	44	1065
B19R17C06	19-6-17	Hs~MGC:BC008748.2~uORF:IOH5941	1105	46	1059
B19R17C07	19-7-17	Hs~MGC:BC035404.2~uORF:IOH27426	793	44	749
B19R17C08	19-8-17	Hs~MGC:BC035404.2~uORF:IOH27426	709	42	667
B19R17C09	19-9-17	Hs~Ref:NM_145310.1~uORF:IOH7356	820	42	778
B19R17C10	19-10-17	Hs~Ref:NM_145310.1~uORF:IOH7356	917	43	874
B19R17C11	19-11-17	Hs~Ref:NM_152480.1~uORF:IOH12619	870	49	821
B19R17C12	19-12-17	Hs~Ref:NM_152480.1~uORF:IOH12619	773	51	722
B19R17C13	19-13-17	Hs~MGC:BC022360.1~uORF:IOH29341	454	44	410
B19R17C14	19-14-17	Hs~MGC:BC022360.1~uORF:IOH29341	481	43	438
B19R17C15	19-15-17	Hs~MGC:BC010942.1~uORF:IOH13002	580	42	538
B19R17C16	19-16-17	Hs~MGC:BC010942.1~uORF:IOH13002	537	42	495
B19R17C17	19-17-17	Hs~MGC:BC001280.1~uORF:IOH21165	1746	42	1704
B19R17C18	19-18-17	Hs~MGC:BC001280.1~uORF:IOH21165	1745	42	1703
B19R17C19	19-19-17	Hs~MGC:BC025307.1~uORF:IOH14776	417	41	376
B19R17C20	19-20-17	Hs~MGC:BC025307.1~uORF:IOH14776	423	41	382
B19R17C21	19-21-17	Hs~Ref:NM_006223.1~uORF:IOH7192	723	41	682
B19R17C22	19-22-17	Hs~Ref:NM_006223.1~uORF:IOH7192	708	40	668
B19R18C01	19-1-18	Hs~MGC:BC016330.1~uORF:IOH14709	2680	43	2637
B19R18C02	19-2-18	Hs~MGC:BC016330.1~uORF:IOH14709	2530	45	2485
B19R18C03	19-3-18	Hs~MGC:BC035572.1~uORF:IOH27588	450	44	406
B19R18C04	19-4-18	Hs~MGC:BC035572.1~uORF:IOH27588	297	47	250
B19R18C05	19-5-18	Hs~MGC:BC027937.1~uORF:IOH11501	474	62	412
B19R18C06	19-6-18	Hs~MGC:BC027937.1~uORF:IOH11501	437	60	377
B19R18C07	19-7-18	Hs~MGC:NM_182906.1~uORF:IOH26131	517	45	472
B19R18C08	19-8-18	Hs~MGC:NM_182906.1~uORF:IOH26131	534	43	491
B19R18C09	19-9-18	Hs~Ref:NM_032906.2~uORF:IOH6693	350	43	307
B19R18C10	19-10-18	Hs~Ref:NM_032906.2~uORF:IOH6693	371	44	327
B19R18C11	19-11-18	Hs~Ref:NM_199190.1~uORF:IOH42760	17081	48	17033
B19R18C12	19-12-18	Hs~Ref:NM_199190.1~uORF:IOH42760	17598	47	17551
B19R18C13	19-13-18	Hs~Ref:NM_170672.1~uORF:IOH27295	490	44	446
B19R18C14	19-14-18	Hs~Ref:NM_170672.1~uORF:IOH27295	479	43	436
B19R18C15	19-15-18	Hs~MGC:BC050522.1~uORF:IOH26996	348	42	306
B19R18C16	19-16-18	Hs~MGC:BC050522.1~uORF:IOH26996	373	42	331
B19R18C17	19-17-18	Hs~Ref:NM_015638.2~uORF:IOH41869	345	42	303
B19R18C18	19-18-18	Hs~Ref:NM_015638.2~uORF:IOH41869	319	42	277
B19R18C19	19-19-18	Hs~MGC:BC014217.2~uORF:IOH14859	455	41	414
B19R18C20	19-20-18	Hs~MGC:BC014217.2~uORF:IOH14859	456	41	415
B19R18C21	19-21-18	Hs~Ref:NM_052875.2~uORF:IOH14292	706	40	666
B19R18C22	19-22-18	Hs~Ref:NM_052875.2~uORF:IOH14292	683	39	644
B19R19C01	19-1-19	Hs~Ref:NM_003512.3~uORF:IOH14485	676	41	635
B19R19C02	19-2-19	Hs~Ref:NM_003512.3~uORF:IOH14485	623	43	580
B19R19C03	19-3-19	Hs~MGC:BC052946.1~uORF:IOH28826	292	76	216
B19R19C04	19-4-19	Hs~MGC:BC052946.1~uORF:IOH28826	256	45	211
B19R19C05	19-5-19	Hs~MGC:BC061590.1~uORF:IOH29302	450	49	401
B19R19C06	19-6-19	Hs~MGC:BC061590.1~uORF:IOH29302	342	55	287
B19R19C07	19-7-19	Hs~MGC:BC004101.1~uORF:IOH5622	396	48	348
B19R19C08	19-8-19	Hs~MGC:BC004101.1~uORF:IOH5622	403	46	357
B19R19C09	19-9-19	Hs~MGC:BC047703.2~uORF:IOH26704	297	52	245
B19R19C10	19-10-19	Hs~MGC:BC047703.2~uORF:IOH26704	297	53	244
B19R19C11	19-11-19	Hs~MGC:BC027607.1~uORF:IOH11737	371	48	323
B19R19C12	19-12-19	Hs~MGC:BC027607.1~uORF:IOH11737	299	42	257
B19R19C13	19-13-19	Hs~MGC:BC057808.1~uORF:IOH29176	701	41	660
B19R19C14	19-14-19	Hs~MGC:BC057808.1~uORF:IOH29176	658	42	616
B19R19C15	19-15-19	Hs~Ref:NM_002426.1~uORF:IOH29597	258	70	188
B19R19C16	19-16-19	Hs~Ref:NM_002426.1~uORF:IOH29597	243	46	197
B19R19C17	19-17-19	Hs~MGC:BC000850.1~uORF:IOH3242	308	43	265
B19R19C18	19-18-19	Hs~MGC:BC000850.1~uORF:IOH3242	339	43	296
B19R19C19	19-19-19	Hs~MGC:BC047575.1~uORF:IOH26425	1804	41	1763
B19R19C20	19-20-19	Hs~MGC:BC047575.1~uORF:IOH26425	1808	40	1768
B19R19C21	19-21-19	Hs~Ref:NM_013343.1~uORF:IOH11992	276	41	235
B19R19C22	19-22-19	Hs~Ref:NM_013343.1~uORF:IOH11992	269	41	228
B19R20C01	19-1-20	Hs~MGC:BC035365.1~uORF:IOH28679	303	43	260
B19R20C02	19-2-20	Hs~MGC:BC035365.1~uORF:IOH28679	298	44	254
B19R20C03	19-3-20	Hs~MGC:BC059376.1~uORF:IOH29245	311	82	229
B19R20C04	19-4-20	Hs~MGC:BC059376.1~uORF:IOH29245	176	46	130
B19R20C05	19-5-20	Hs~Ref:NM_014279.2~uORF:IOH46139	656	51	605
B19R20C06	19-6-20	Hs~Ref:NM_014279.2~uORF:IOH46139	692	46	646
B19R20C07	19-7-20	Hs~Ref:NM_002452.3~uORF:IOH45904	209	47	162
B19R20C08	19-8-20	Hs~Ref:NM_002452.3~uORF:IOH45904	51	43	8
B19R20C09	19-9-20	Hs~Ref:NM_004740.3~uORF:IOH45454	167	66	101
B19R20C10	19-10-20	Hs~Ref:NM_004740.3~uORF:IOH45454	88	41	47
B19R20C11	19-11-20	Hs~MGC:BC020786.1~uORF:IOH14667	529	41	488
B19R20C12	19-12-20	Hs~MGC:BC020786.1~uORF:IOH14667	440	40	400
B19R20C13	19-13-20	Hs~Ref:NM_138807.1~uORF:IOH12627	328	41	287
B19R20C14	19-14-20	Hs~Ref:NM_138807.1~uORF:IOH12627	356	42	314
B19R20C15	19-15-20	Hs~Ref:NM_017883.3~uORF:IOH45959	305	43	262
B19R20C16	19-16-20	Hs~Ref:NM_017883.3~uORF:IOH45959	363	43	320
B19R20C17	19-17-20	Hs~MGC:BC012081.1~uORF:IOH12703	333	41	292
B19R20C18	19-18-20	Hs~MGC:BC012081.1~uORF:IOH12703	318	44	274
B19R20C19	19-19-20	Hs~Ref:NM_002131.2~uORF:IOH5224	448	39	409
B19R20C20	19-20-20	Hs~Ref:NM_002131.2~uORF:IOH5224	457	39	418
B19R20C21	19-21-20	Hs~Ref:NM_003355.2~uORF:IOH12356	168	54	114
B19R20C22	19-22-20	Hs~Ref:NM_003355.2~uORF:IOH12356	62	41	21
B19R21C01	19-1-21	Hs~Ref:XM_371714.1~uORF:IOH43094	418	40	378
B19R21C02	19-2-21	Hs~Ref:XM_371714.1~uORF:IOH43094	367	41	326
B19R21C03	19-3-21	Hs~Ref:XM_379060.1~uORF:IOH44018	5947	45	5902
B19R21C04	19-4-21	Hs~Ref:XM_379060.1~uORF:IOH44018	5595	44	5551
B19R21C05	19-5-21	Hs~Ref:NM_152901.1~uORF:IOH42416	170	44	126
B19R21C06	19-6-21	Hs~Ref:NM_152901.1~uORF:IOH42416	166	44	122
B19R21C07	19-7-21	Hs~Ref:NM_198275.1~uORF:IOH43737	230	51	179
B19R21C08	19-8-21	Hs~Ref:NM_198275.1~uORF:IOH43737	237	68	169
B19R21C09	19-9-21	Hs~Ref:P17931~CAT_10289-HNAE-25	50	39	11
B19R21C10	19-10-21	Hs~Ref:P17931~CAT_10289-HNAE-25	50	39	11
B19R21C11	19-11-21	Internal_1007209	1396	39	1357
B19R21C12	19-12-21	Internal_1007209	1539	39	1500
B19R21C13	19-13-21	Hs~Ref:AAH17865.1~CAT_10389-H08H1-25	1572	39	1533
B19R21C14	19-14-21	Hs~Ref:AAH17865.1~CAT_10389-H08H1-25	1348	38	1310
B19R21C15	19-15-21	Internal_1007209	53	39	14
B19R21C16	19-16-21	Internal_1007209	121	47	74
B19R21C17	19-17-21	Hs~Ref:NP_001091996.1~CAT_10120-H08H-25	50	39	11
B19R21C18	19-18-21	Hs~Ref:NP_001091996.1~CAT_10120-H08H-25	50	39	11
B19R21C19	19-19-21	Internal_1007209	150	41	109
B19R21C20	19-20-21	Internal_1007209	41	39	2
B19R21C21	19-21-21	Internal_1007209	50	39	11
B19R21C22	19-22-21	Internal_1007209	132	41	91
B19R22C01	19-1-22	ERa~N/A	2320	39	2281
B19R22C02	19-2-22	ERa~N/A	2482	41	2441
B19R22C03	19-3-22	PKCeta~N/A	290	47	243
B19R22C04	19-4-22	PKCeta~N/A	351	87	264
B19R22C05	19-5-22	Calmodulin~N/A	75	41	34
B19R22C06	19-6-22	Calmodulin~N/A	67	39	28
B19R22C07	19-7-22	V5control5~N/A	333	39	294
B19R22C08	19-8-22	V5control5~N/A	346	39	307
B19R22C09	19-9-22	V5control4~N/A	183	52	131
B19R22C10	19-10-22	V5control4~N/A	174	51	123
B19R22C11	19-11-22	V5control3~N/A	80	39	41
B19R22C12	19-12-22	V5control3~N/A	120	45	75
B19R22C13	19-13-22	V5control2~N/A	140	46	94
B19R22C14	19-14-22	V5control2~N/A	97	46	51
B19R22C15	19-15-22	V5control1~N/A	397	41	356
B19R22C16	19-16-22	V5control1~N/A	226	54	172
B19R22C17	19-17-22	CMK2A~N/A	540	39	501
B19R22C18	19-18-22	CMK2A~N/A	578	39	539
B19R22C19	19-19-22	ERa~N/A	1894	39	1855
B19R22C20	19-20-22	ERa~N/A	1805	39	1766
B19R22C21	19-21-22	AlexaAntiMouseAb~N/A	10193	40	10153
B19R22C22	19-22-22	AlexaAntiMouseAb~N/A	10305	40	10265
B20R01C01	20-1-1	AlexaAntiMouseAb~N/A	42592	47	42545
B20R01C02	20-2-1	AlexaAntiMouseAb~N/A	41514	51	41463
B20R01C03	20-3-1	ERa~N/A	1484	54	1430
B20R01C04	20-4-1	ERa~N/A	1439	58	1381
B20R01C05	20-5-1	HumanIgG1~N/A	1124	66	1058
B20R01C06	20-6-1	HumanIgG1~N/A	1390	57	1333
B20R01C07	20-7-1	HumanIgG2~N/A	2078	52	2026
B20R01C08	20-8-1	HumanIgG2~N/A	3074	50	3024
B20R01C09	20-9-1	HumanIgG3~N/A	10373	50	10323
B20R01C10	20-10-1	HumanIgG3~N/A	13909	51	13858
B20R01C11	20-11-1	HumanIgG4~N/A	44547	58	44489
B20R01C12	20-12-1	HumanIgG4~N/A	55329	60	55269
B20R01C13	20-13-1	BiotinAb~N/A	265	52	213
B20R01C14	20-14-1	BiotinAb~N/A	178	57	121
B20R01C15	20-15-1	RanBP2deltaFG~N/A	313	60	253
B20R01C16	20-16-1	RanBP2deltaFG~N/A	293	64	229
B20R01C17	20-17-1	hMDM2~N/A	769	60	709
B20R01C18	20-18-1	hMDM2~N/A	854	54	800
B20R01C19	20-19-1	PKCeta~N/A	554	54	500
B20R01C20	20-20-1	PKCeta~N/A	344	52	292
B20R01C21	20-21-1	AlexaAntiMouseAb~N/A	32648	53	32595
B20R01C22	20-22-1	AlexaAntiMouseAb~N/A	31403	53	31350
B20R02C01	20-1-2	PKCeta~N/A	1339	61	1278
B20R02C02	20-2-2	PKCeta~N/A	1721	73	1648
B20R02C03	20-3-2	Buffer	136	70	66
B20R02C04	20-4-2	Buffer	157	64	93
B20R02C05	20-5-2	HumanIgA~N/A	21072	62	21010
B20R02C06	20-6-2	HumanIgA~N/A	22572	60	22512
B20R02C07	20-7-2	Buffer	219	60	159
B20R02C08	20-8-2	Buffer	108	52	56
B20R02C09	20-9-2	BSA~N/A	10500	51	10449
B20R02C10	20-10-2	BSA~N/A	10872	55	10817
B20R02C11	20-11-2	Hs~MGC:BC020107.1~uORF:IOH11079	425	108	317
B20R02C12	20-12-2	Hs~MGC:BC020107.1~uORF:IOH11079	361	88	273
B20R02C13	20-13-2	Hs~Ref:NM_144563.1~uORF:IOH11053	61	71	-10
B20R02C14	20-14-2	Hs~Ref:NM_144563.1~uORF:IOH11053	286	66	220
B20R02C15	20-15-2	Hs~MGC:NM_152261.1~uORF:IOH10854	356	333	23
B20R02C16	20-16-2	Hs~MGC:NM_152261.1~uORF:IOH10854	377	63	314
B20R02C17	20-17-2	Hs~MGC:BC013162.1~uORF:IOH10924	693	264	429
B20R02C18	20-18-2	Hs~MGC:BC013162.1~uORF:IOH10924	520	55	465
B20R02C19	20-19-2	Hs~Ref:NM_024299.2~uORF:IOH4080	2600	58	2542
B20R02C20	20-20-2	Hs~Ref:NM_024299.2~uORF:IOH4080	2849	62	2787
B20R02C21	20-21-2	Hs~Ref:NM_012247.3~uORF:IOH3018	938	174	764
B20R02C22	20-22-2	Hs~Ref:NM_012247.3~uORF:IOH3018	818	57	761
B20R03C01	20-1-3	Hs~MGC:BC009819.1~uORF:IOH12608	630	49	581
B20R03C02	20-2-3	Hs~MGC:BC009819.1~uORF:IOH12608	479	58	421
B20R03C03	20-3-3	Hs~Ref:NM_001674.1~uORF:IOH6465	705	77	628
B20R03C04	20-4-3	Hs~Ref:NM_001674.1~uORF:IOH6465	521	75	446
B20R03C05	20-5-3	Hs~Ref:NM_003182.1~uORF:IOH44355	146	56	90
B20R03C06	20-6-3	Hs~Ref:NM_003182.1~uORF:IOH44355	67	57	10
B20R03C07	20-7-3	Hs~Ref:NM_001006605.1~uORF:IOH45941	194	47	147
B20R03C08	20-8-3	Hs~Ref:NM_001006605.1~uORF:IOH45941	199	48	151
B20R03C09	20-9-3	Hs~Ref:NM_172244.2~uORF:IOH44356	147	55	92
B20R03C10	20-10-3	Hs~Ref:NM_172244.2~uORF:IOH44356	40	47	-7
B20R03C11	20-11-3	Hs~Ref:NM_004724.2~uORF:IOH42575	430	202	228
B20R03C12	20-12-3	Hs~Ref:NM_004724.2~uORF:IOH42575	278	71	207
B20R03C13	20-13-3	Hs~Ref:NM_199124.1~uORF:IOH43439	3210	69	3141
B20R03C14	20-14-3	Hs~Ref:NM_199124.1~uORF:IOH43439	3115	56	3059
B20R03C15	20-15-3	Hs~Ref:NM_001017980.1~uORF:IOH43503	272	59	213
B20R03C16	20-16-3	Hs~Ref:NM_001017980.1~uORF:IOH43503	276	61	215
B20R03C17	20-17-3	Hs~Ref:NM_018584.4~uORF:IOH42130	410	280	130
B20R03C18	20-18-3	Hs~Ref:NM_018584.4~uORF:IOH42130	381	129	252
B20R03C19	20-19-3	Hs~Ref:NM_007333.1~uORF:IOH43048	1111	247	864
B20R03C20	20-20-3	Hs~Ref:NM_007333.1~uORF:IOH43048	1218	52	1166
B20R03C21	20-21-3	Hs~MGC:BC010959.1~uORF:IOH13742	311	63	248
B20R03C22	20-22-3	Hs~MGC:BC010959.1~uORF:IOH13742	593	55	538
B20R04C01	20-1-4	Hs~MGC:BC007312.1~uORF:IOH6926	325	52	273
B20R04C02	20-2-4	Hs~MGC:BC007312.1~uORF:IOH6926	299	128	171
B20R04C03	20-3-4	Hs~Ref:NM_006007.1~uORF:IOH14289	703	509	194
B20R04C04	20-4-4	Hs~Ref:NM_006007.1~uORF:IOH14289	612	59	553
B20R04C05	20-5-4	Hs~MGC:BC017101.1~uORF:IOH14448	1166	50	1116
B20R04C06	20-6-4	Hs~MGC:BC017101.1~uORF:IOH14448	1324	49	1275
B20R04C07	20-7-4	Hs~MGC:BC015886.1~uORF:IOH10052	207	50	157
B20R04C08	20-8-4	Hs~MGC:BC015886.1~uORF:IOH10052	437	44	393
B20R04C09	20-9-4	Hs~MGC:BC005858.1~uORF:IOH5967	299	54	245
B20R04C10	20-10-4	Hs~MGC:BC005858.1~uORF:IOH5967	268	57	211
B20R04C11	20-11-4	Hs~MGC:BC013073.1~uORF:IOH10173	938	49	889
B20R04C12	20-12-4	Hs~MGC:BC013073.1~uORF:IOH10173	1233	48	1185
B20R04C13	20-13-4	Hs~MGC:NM_170679.1~uORF:IOH13678	132	47	85
B20R04C14	20-14-4	Hs~MGC:NM_170679.1~uORF:IOH13678	125	52	73
B20R04C15	20-15-4	Hs~Ref:NM_003006.2~uORF:IOH22638	233	55	178
B20R04C16	20-16-4	Hs~Ref:NM_003006.2~uORF:IOH22638	241	58	183
B20R04C17	20-17-4	Hs~MGC:BC004925.1~uORF:IOH5520	52	70	-18
B20R04C18	20-18-4	Hs~MGC:BC004925.1~uORF:IOH5520	115	61	54
B20R04C19	20-19-4	Hs~Ref:NM_000282.1~uORF:IOH2968	1054	55	999
B20R04C20	20-20-4	Hs~Ref:NM_000282.1~uORF:IOH2968	1057	48	1009
B20R04C21	20-21-4	Hs~MGC:BC022429.1~uORF:IOH23036	418	47	371
B20R04C22	20-22-4	Hs~MGC:BC022429.1~uORF:IOH23036	65	50	15
B20R05C01	20-1-5	Hs~Ref:NM_080911.1~uORF:IOH43486	8154	46	8108
B20R05C02	20-2-5	Hs~Ref:NM_080911.1~uORF:IOH43486	8542	50	8492
B20R05C03	20-3-5	Hs~Ref:NM_205848.1~uORF:IOH43389	2523	45	2478
B20R05C04	20-4-5	Hs~Ref:NM_205848.1~uORF:IOH43389	2004	46	1958
B20R05C05	20-5-5	Hs~Ref:XM_378300.2~uORF:IOH43210	360	46	314
B20R05C06	20-6-5	Hs~Ref:XM_378300.2~uORF:IOH43210	264	49	215
B20R05C07	20-7-5	Hs~MGC:NM_174972.1~uORF:IOH43392	1149	45	1104
B20R05C08	20-8-5	Hs~MGC:NM_174972.1~uORF:IOH43392	1297	46	1251
B20R05C09	20-9-5	Hs~Ref:NM_001711.3~uORF:IOH5449	47	50	-3
B20R05C10	20-10-5	Hs~Ref:NM_001711.3~uORF:IOH5449	70	48	22
B20R05C11	20-11-5	Hs~Ref:NM_053005.2~uORF:IOH40119	2843	46	2797
B20R05C12	20-12-5	Hs~Ref:NM_053005.2~uORF:IOH40119	3017	46	2971
B20R05C13	20-13-5	Hs~Ref:NM_006607.1~uORF:IOH40244	909	47	862
B20R05C14	20-14-5	Hs~Ref:NM_006607.1~uORF:IOH40244	918	48	870
B20R05C15	20-15-5	Hs~Ref:NM_148912.2~uORF:IOH40097	2905	54	2851
B20R05C16	20-16-5	Hs~Ref:NM_148912.2~uORF:IOH40097	3019	53	2966
B20R05C17	20-17-5	Hs~Ref:NM_057176.2~uORF:IOH35514	225	49	176
B20R05C18	20-18-5	Hs~Ref:NM_057176.2~uORF:IOH35514	215	47	168
B20R05C19	20-19-5	Hs~Ref:NM_080873.1~uORF:IOH35526	51	51	0
B20R05C20	20-20-5	Hs~Ref:NM_080873.1~uORF:IOH35526	107	47	60
B20R05C21	20-21-5	Hs~MGC:BC001861.2~uORF:IOH40580	344	46	298
B20R05C22	20-22-5	Hs~MGC:BC001861.2~uORF:IOH40580	343	45	298
B20R06C01	20-1-6	Hs~Ref:NM_000304.2~uORF:IOH40638	191	45	146
B20R06C02	20-2-6	Hs~Ref:NM_000304.2~uORF:IOH40638	181	46	135
B20R06C03	20-3-6	Hs~MGC:BC003586.1~uORF:IOH4499	125	44	81
B20R06C04	20-4-6	Hs~MGC:BC003586.1~uORF:IOH4499	128	44	84
B20R06C05	20-5-6	Hs~Ref:NM_018132.1~uORF:IOH10019	108	49	59
B20R06C06	20-6-6	Hs~Ref:NM_018132.1~uORF:IOH10019	102	50	52
B20R06C07	20-7-6	Hs~MGC:BC077077.1~uORF:IOH62554	113	44	69
B20R06C08	20-8-6	Hs~MGC:BC077077.1~uORF:IOH62554	113	77	36
B20R06C09	20-9-6	Hs~Ref:NM_138443.1~uORF:IOH14717	79	43	36
B20R06C10	20-10-6	Hs~Ref:NM_138443.1~uORF:IOH14717	75	44	31
B20R06C11	20-11-6	Hs~Ref:NM_007370.2~uORF:IOH4957	452	44	408
B20R06C12	20-12-6	Hs~Ref:NM_007370.2~uORF:IOH4957	435	43	392
B20R06C13	20-13-6	Hs~Ref:NM_002363.1~uORF:IOH10928	5394	47	5347
B20R06C14	20-14-6	Hs~Ref:NM_002363.1~uORF:IOH10928	5494	48	5446
B20R06C15	20-15-6	Hs~Ref:NM_004582.2~uORF:IOH14064	387	49	338
B20R06C16	20-16-6	Hs~Ref:NM_004582.2~uORF:IOH14064	234	47	187
B20R06C17	20-17-6	Hs~MGC:BC006091.1~uORF:IOH6616	1009	47	962
B20R06C18	20-18-6	Hs~MGC:BC006091.1~uORF:IOH6616	909	46	863
B20R06C19	20-19-6	Hs~MGC:BC096276.1~uORF:IOH63223	47	58	-11
B20R06C20	20-20-6	Hs~MGC:BC096276.1~uORF:IOH63223	347	61	286
B20R06C21	20-21-6	Hs~Ref:NM_003695.2~uORF:IOH53843	295	45	250
B20R06C22	20-22-6	Hs~Ref:NM_003695.2~uORF:IOH53843	237	43	194
B20R07C01	20-1-7	Hs~MGC:BC095404.1~uORF:IOH62648	898	43	855
B20R07C02	20-2-7	Hs~MGC:BC095404.1~uORF:IOH62648	864	45	819
B20R07C03	20-3-7	Hs~MGC:BC095403.1~uORF:IOH62678	378	45	333
B20R07C04	20-4-7	Hs~MGC:BC095403.1~uORF:IOH62678	358	45	313
B20R07C05	20-5-7	Hs~Ref:NM_012325.1~uORF:IOH41294	4085	51	4034
B20R07C06	20-6-7	Hs~Ref:NM_012325.1~uORF:IOH41294	4508	50	4458
B20R07C07	20-7-7	Hs~Ref:NM_184237.1~uORF:IOH41717	543	43	500
B20R07C08	20-8-7	Hs~Ref:NM_184237.1~uORF:IOH41717	528	43	485
B20R07C09	20-9-7	Hs~Ref:NM_003289.3~uORF:IOH41299	836	43	793
B20R07C10	20-10-7	Hs~Ref:NM_003289.3~uORF:IOH41299	844	43	801
B20R07C11	20-11-7	Hs~Ref:NM_014343.1~uORF:IOH42459	83	44	39
B20R07C12	20-12-7	Hs~Ref:NM_014343.1~uORF:IOH42459	85	54	31
B20R07C13	20-13-7	Hs~Ref:NM_002793.2~uORF:IOH27925	282	71	211
B20R07C14	20-14-7	Hs~Ref:NM_002793.2~uORF:IOH27925	80	44	36
B20R07C15	20-15-7	Hs~Ref:NM_005157.2~N/A	280	56	224
B20R07C16	20-16-7	Hs~Ref:NM_005157.2~N/A	239	56	183
B20R07C17	20-17-7	Hs~Ref:NM_025195.1~N/A	186	48	138
B20R07C18	20-18-7	Hs~Ref:NM_025195.1~N/A	172	47	125
B20R07C19	20-19-7	Hs~MGC:NM_175878.2~uORF:IOH26879	1485	47	1438
B20R07C20	20-20-7	Hs~MGC:NM_175878.2~uORF:IOH26879	1596	45	1551
B20R07C21	20-21-7	Hs~MGC:BC071784.1~uORF:IOH62876	360	47	313
B20R07C22	20-22-7	Hs~MGC:BC071784.1~uORF:IOH62876	335	45	290
B20R08C01	20-1-8	Hs~MGC:BC071865.1~uORF:IOH63094	484	46	438
B20R08C02	20-2-8	Hs~MGC:BC071865.1~uORF:IOH63094	499	45	454
B20R08C03	20-3-8	Hs~MGC:BC068068.1~uORF:IOH63001	1049	43	1006
B20R08C04	20-4-8	Hs~MGC:BC068068.1~uORF:IOH63001	1084	43	1041
B20R08C05	20-5-8	Hs~MGC:BC062336.1~uORF:IOH62932	39487	44	39443
B20R08C06	20-6-8	Hs~MGC:BC062336.1~uORF:IOH62932	35343	43	35300
B20R08C07	20-7-8	Hs~MGC:BC014237.1~uORF:IOH22994	550	42	508
B20R08C08	20-8-8	Hs~MGC:BC014237.1~uORF:IOH22994	583	42	541
B20R08C09	20-9-8	Hs~MGC:BC021701.1~uORF:IOH23015	363	41	322
B20R08C10	20-10-8	Hs~MGC:BC021701.1~uORF:IOH23015	411	42	369
B20R08C11	20-11-8	Hs~Ref:NM_021158.1~uORF:IOH14340	903	44	859
B20R08C12	20-12-8	Hs~Ref:NM_021158.1~uORF:IOH14340	924	43	881
B20R08C13	20-13-8	Hs~MGC:BC029167.1~uORF:IOH22650	416	45	371
B20R08C14	20-14-8	Hs~MGC:BC029167.1~uORF:IOH22650	457	43	414
B20R08C15	20-15-8	Hs~MGC:BC012493.1~uORF:IOH11147	484	44	440
B20R08C16	20-16-8	Hs~MGC:BC012493.1~uORF:IOH11147	444	45	399
B20R08C17	20-17-8	Hs~MGC:BC010426.1~uORF:IOH12487	215	52	163
B20R08C18	20-18-8	Hs~MGC:BC010426.1~uORF:IOH12487	147	52	95
B20R08C19	20-19-8	Hs~Ref:NM_005239.2~uORF:IOH10422	588	47	541
B20R08C20	20-20-8	Hs~Ref:NM_005239.2~uORF:IOH10422	563	45	518
B20R08C21	20-21-8	Hs~Ref:NM_012473.2~uORF:IOH11093	668	45	623
B20R08C22	20-22-8	Hs~Ref:NM_012473.2~uORF:IOH11093	657	43	614
B20R09C01	20-1-9	Hs~Ref:NM_012191.2~uORF:IOH40594	676	70	606
B20R09C02	20-2-9	Hs~Ref:NM_012191.2~uORF:IOH40594	692	69	623
B20R09C03	20-3-9	Hs~Ref:NM_033201.1~uORF:IOH40574	385	46	339
B20R09C04	20-4-9	Hs~Ref:NM_033201.1~uORF:IOH40574	366	43	323
B20R09C05	20-5-9	Hs~Ref:NM_016606.2~uORF:IOH40596	352	43	309
B20R09C06	20-6-9	Hs~Ref:NM_016606.2~uORF:IOH40596	372	42	330
B20R09C07	20-7-9	Hs~Ref:NM_019005.2~uORF:IOH40538	278	45	233
B20R09C08	20-8-9	Hs~Ref:NM_019005.2~uORF:IOH40538	299	46	253
B20R09C09	20-9-9	Hs~MGC:NM_177424.1~uORF:IOH26548	359	42	317
B20R09C10	20-10-9	Hs~MGC:NM_177424.1~uORF:IOH26548	410	42	368
B20R09C11	20-11-9	Hs~Ref:NM_005207.1~uORF:IOH26401	677	40	637
B20R09C12	20-12-9	Hs~Ref:NM_005207.1~uORF:IOH26401	705	40	665
B20R09C13	20-13-9	Hs~MGC:BC050688.1~uORF:IOH27002	447	43	404
B20R09C14	20-14-9	Hs~MGC:BC050688.1~uORF:IOH27002	422	45	377
B20R09C15	20-15-9	Hs~Ref:NM_014012.2~uORF:IOH26198	535	43	492
B20R09C16	20-16-9	Hs~Ref:NM_014012.2~uORF:IOH26198	526	41	485
B20R09C17	20-17-9	Hs~Ref:NM_013375.2~uORF:IOH1920	1324	43	1281
B20R09C18	20-18-9	Hs~Ref:NM_013375.2~uORF:IOH1920	1214	45	1169
B20R09C19	20-19-9	Hs~Ref:NM_005086.3~uORF:IOH1877	838	45	793
B20R09C20	20-20-9	Hs~Ref:NM_005086.3~uORF:IOH1877	934	45	889
B20R09C21	20-21-9	Hs~Ref:NM_001975.2~uORF:IOH2253	631	45	586
B20R09C22	20-22-9	Hs~Ref:NM_001975.2~uORF:IOH2253	575	44	531
B20R10C01	20-1-10	Hs~MGC:BC013393.2~uORF:IOH13082	1122	51	1071
B20R10C02	20-2-10	Hs~MGC:BC013393.2~uORF:IOH13082	1086	63	1023
B20R10C03	20-3-10	Hs~MGC:BC059358.1~uORF:IOH29286	415	46	369
B20R10C04	20-4-10	Hs~MGC:BC059358.1~uORF:IOH29286	371	43	328
B20R10C05	20-5-10	Hs~MGC:BC041787.1~uORF:IOH27976	315	42	273
B20R10C06	20-6-10	Hs~MGC:BC041787.1~uORF:IOH27976	337	43	294
B20R10C07	20-7-10	Hs~MGC:BC058886.1~uORF:IOH29125	348	47	301
B20R10C08	20-8-10	Hs~MGC:BC058886.1~uORF:IOH29125	336	53	283
B20R10C09	20-9-10	Hs~MGC:BC057838.1~uORF:IOH29209	506	45	461
B20R10C10	20-10-10	Hs~MGC:BC057838.1~uORF:IOH29209	484	42	442
B20R10C11	20-11-10	GST1	45	40	5
B20R10C12	20-12-10	GST1	45	40	5
B20R10C13	20-13-10	GST2	47	42	5
B20R10C14	20-14-10	GST2	46	43	3
B20R10C15	20-15-10	GST3	212	44	168
B20R10C16	20-16-10	GST3	49	42	7
B20R10C17	20-17-10	GST4	63	41	22
B20R10C18	20-18-10	GST4	56	41	15
B20R10C19	20-19-10	Anti-HumanIgA1~N/A	5771	44	5727
B20R10C20	20-20-10	Anti-HumanIgA1~N/A	7063	46	7017
B20R10C21	20-21-10	Anti-HumanIgA2~N/A	13871	46	13825
B20R10C22	20-22-10	Anti-HumanIgA2~N/A	14176	45	14131
B20R11C01	20-1-11	AlexaAntiMouseAb~N/A	22242	45	22197
B20R11C02	20-2-11	AlexaAntiMouseAb~N/A	24909	45	24864
B20R11C03	20-3-11	MAPKAP~N/A	88	42	46
B20R11C04	20-4-11	MAPKAP~N/A	87	58	29
B20R11C05	20-5-11	Buffer	222	42	180
B20R11C06	20-6-11	Buffer	241	44	197
B20R11C07	20-7-11	BSA~N/A	7252	42	7210
B20R11C08	20-8-11	BSA~N/A	7670	43	7627
B20R11C09	20-9-11	Anti-HumanIgG1~N/A	1255	42	1213
B20R11C10	20-10-11	Anti-HumanIgG1~N/A	1467	43	1424
B20R11C11	20-11-11	Anti-HumanIgG2~N/A	2669	41	2628
B20R11C12	20-12-11	Anti-HumanIgG2~N/A	2999	41	2958
B20R11C13	20-13-11	Anti-HumanIgG3~N/A	4231	43	4188
B20R11C14	20-14-11	Anti-HumanIgG3~N/A	5087	44	5043
B20R11C15	20-15-11	Anti-HumanIgG4~N/A	9316	44	9272
B20R11C16	20-16-11	Anti-HumanIgG4~N/A	9883	44	9839
B20R11C17	20-17-11	AntiBiotinAb~N/A	11029	46	10983
B20R11C18	20-18-11	AntiBiotinAb~N/A	10855	44	10811
B20R11C19	20-19-11	Buffer	53	44	9
B20R11C20	20-20-11	Buffer	56	43	13
B20R11C21	20-21-11	Hs~MGC:BC011952.1~uORF:IOH10475	184	46	138
B20R11C22	20-22-11	Hs~MGC:BC011952.1~uORF:IOH10475	366	56	310
B20R12C01	20-1-12	Hs~MGC:BC018137.1~uORF:IOH10369	1026	43	983
B20R12C02	20-2-12	Hs~MGC:BC018137.1~uORF:IOH10369	1107	45	1062
B20R12C03	20-3-12	Hs~MGC:BC000877.1~uORF:IOH3268	562	46	516
B20R12C04	20-4-12	Hs~MGC:BC000877.1~uORF:IOH3268	499	47	452
B20R12C05	20-5-12	Hs~MGC:BC001259.1~uORF:IOH3096	388	42	346
B20R12C06	20-6-12	Hs~MGC:BC001259.1~uORF:IOH3096	420	41	379
B20R12C07	20-7-12	Hs~MGC:BC047455.1~uORF:IOH26531	575	42	533
B20R12C08	20-8-12	Hs~MGC:BC047455.1~uORF:IOH26531	563	42	521
B20R12C09	20-9-12	Hs~MGC:BC035256.1~uORF:IOH27660	436	44	392
B20R12C10	20-10-12	Hs~MGC:BC035256.1~uORF:IOH27660	420	43	377
B20R12C11	20-11-12	Hs~MGC:BC035040.1~uORF:IOH27116	660	43	617
B20R12C12	20-12-12	Hs~MGC:BC035040.1~uORF:IOH27116	710	44	666
B20R12C13	20-13-12	Hs~Ref:NM_153687.1~uORF:IOH29079	718	45	673
B20R12C14	20-14-12	Hs~Ref:NM_153687.1~uORF:IOH29079	710	44	666
B20R12C15	20-15-12	Hs~MGC:BC103864.1~uORF:IOH63430	136	43	93
B20R12C16	20-16-12	Hs~MGC:BC103864.1~uORF:IOH63430	137	44	93
B20R12C17	20-17-12	Hs~MGC:BC098269.1~uORF:IOH63293	201	124	77
B20R12C18	20-18-12	Hs~MGC:BC098269.1~uORF:IOH63293	131	49	82
B20R12C19	20-19-12	Hs~MGC:BC100926.1~uORF:IOH63370	324	46	278
B20R12C20	20-20-12	Hs~MGC:BC100926.1~uORF:IOH63370	414	46	368
B20R12C21	20-21-12	Hs~MGC:BC101938.1~uORF:IOH63321	378	56	322
B20R12C22	20-22-12	Hs~MGC:BC101938.1~uORF:IOH63321	326	58	268
B20R13C01	20-1-13	Hs~Ref:NM_198044.1~uORF:IOH23224	696	40	656
B20R13C02	20-2-13	Hs~Ref:NM_198044.1~uORF:IOH23224	738	40	698
B20R13C03	20-3-13	Hs~MGC:BC033159.1~uORF:IOH23223	2591	45	2546
B20R13C04	20-4-13	Hs~MGC:BC033159.1~uORF:IOH23223	2661	46	2615
B20R13C05	20-5-13	Hs~Ref:NM_021627.2~uORF:IOH26311	858	41	817
B20R13C06	20-6-13	Hs~Ref:NM_021627.2~uORF:IOH26311	873	43	830
B20R13C07	20-7-13	Hs~MGC:BC020719.1~uORF:IOH12903	258	48	210
B20R13C08	20-8-13	Hs~MGC:BC020719.1~uORF:IOH12903	185	46	139
B20R13C09	20-9-13	Hs~Ref:NM_020958.2~uORF:IOH44465	376	48	328
B20R13C10	20-10-13	Hs~Ref:NM_020958.2~uORF:IOH44465	330	46	284
B20R13C11	20-11-13	Hs~Ref:NM_018607.5~uORF:IOH40969	462	46	416
B20R13C12	20-12-13	Hs~Ref:NM_018607.5~uORF:IOH40969	471	48	423
B20R13C13	20-13-13	Hs~Ref:NM_138331.1~uORF:IOH35122	412	48	364
B20R13C14	20-14-13	Hs~Ref:NM_138331.1~uORF:IOH35122	370	47	323
B20R13C15	20-15-13	Hs~Ref:NM_004763.2~uORF:IOH40963	319	47	272
B20R13C16	20-16-13	Hs~Ref:NM_004763.2~uORF:IOH40963	264	46	218
B20R13C17	20-17-13	Hs~MGC:BC017085.1~uORF:IOH10382	443	47	396
B20R13C18	20-18-13	Hs~MGC:BC017085.1~uORF:IOH10382	406	46	360
B20R13C19	20-19-13	Hs~MGC:NM_152471.1~uORF:IOH10190	119	47	72
B20R13C20	20-20-13	Hs~MGC:NM_152471.1~uORF:IOH10190	282	65	217
B20R13C21	20-21-13	Hs~MGC:BC012131.1~uORF:IOH13142	2794	50	2744
B20R13C22	20-22-13	Hs~MGC:BC012131.1~uORF:IOH13142	2878	44	2834
B20R14C01	20-1-14	Hs~MGC:BC018206.1~uORF:IOH10533	305	42	263
B20R14C02	20-2-14	Hs~MGC:BC018206.1~uORF:IOH10533	354	42	312
B20R14C03	20-3-14	Hs~Ref:NM_005982.1~uORF:IOH54931	353	47	306
B20R14C04	20-4-14	Hs~Ref:NM_005982.1~uORF:IOH54931	366	48	318
B20R14C05	20-5-14	Hs~Ref:NM_172208.1~uORF:IOH59271	253	44	209
B20R14C06	20-6-14	Hs~Ref:NM_172208.1~uORF:IOH59271	252	43	209
B20R14C07	20-7-14	Hs~Ref:NM_007005.3~uORF:IOH52787	1151	43	1108
B20R14C08	20-8-14	Hs~Ref:NM_007005.3~uORF:IOH52787	1178	44	1134
B20R14C09	20-9-14	Hs~Ref:NM_002495.1~uORF:IOH54701	384	45	339
B20R14C10	20-10-14	Hs~Ref:NM_002495.1~uORF:IOH54701	380	45	335
B20R14C11	20-11-14	Hs~MGC:BC009458.1~uORF:IOH13468	2638	46	2592
B20R14C12	20-12-14	Hs~MGC:BC009458.1~uORF:IOH13468	2516	45	2471
B20R14C13	20-13-14	Hs~Ref:NM_014370.2~uORF:IOH60262	660	43	617
B20R14C14	20-14-14	Hs~Ref:NM_014370.2~uORF:IOH60262	677	43	634
B20R14C15	20-15-14	Hs~MGC:BC104469.1~uORF:IOH63631	1644	44	1600
B20R14C16	20-16-14	Hs~MGC:BC104469.1~uORF:IOH63631	1715	45	1670
B20R14C17	20-17-14	Hs~Ref:NM_030754.2~uORF:IOH12636	269	49	220
B20R14C18	20-18-14	Hs~Ref:NM_030754.2~uORF:IOH12636	223	102	121
B20R14C19	20-19-14	Hs~Ref:NM_004162.2~uORF:IOH10188	600	45	555
B20R14C20	20-20-14	Hs~Ref:NM_004162.2~uORF:IOH10188	600	45	555
B20R14C21	20-21-14	Hs~Ref:NM_001031849.1~uORF:IOH60848	499	43	456
B20R14C22	20-22-14	Hs~Ref:NM_001031849.1~uORF:IOH60848	472	41	431
B20R15C01	20-1-15	Hs~Ref:NM_001004480.1~uORF:IOH60798	933	40	893
B20R15C02	20-2-15	Hs~Ref:NM_001004480.1~uORF:IOH60798	961	43	918
B20R15C03	20-3-15	Hs~Ref:NM_000545.3~uORF:IOH44420	2284	44	2240
B20R15C04	20-4-15	Hs~Ref:NM_000545.3~uORF:IOH44420	2291	45	2246
B20R15C05	20-5-15	Hs~Ref:NM_000566.1~uORF:IOH21921	581	45	536
B20R15C06	20-6-15	Hs~Ref:NM_000566.1~uORF:IOH21921	567	44	523
B20R15C07	20-7-15	Hs~MGC:BC032838.2~uORF:IOH26853	393	45	348
B20R15C08	20-8-15	Hs~MGC:BC032838.2~uORF:IOH26853	397	47	350
B20R15C09	20-9-15	Hs~MGC:BC043193.2~uORF:IOH25850	364	64	300
B20R15C10	20-10-15	Hs~MGC:BC043193.2~uORF:IOH25850	364	73	291
B20R15C11	20-11-15	Hs~MGC:NM_153208.1~uORF:IOH22871	406	48	358
B20R15C12	20-12-15	Hs~MGC:NM_153208.1~uORF:IOH22871	368	44	324
B20R15C13	20-13-15	Hs~Ref:NM_001006665.1~CAT:PV3680	477	51	426
B20R15C14	20-14-15	Hs~Ref:NM_001006665.1~CAT:PV3680	465	55	410
B20R15C15	20-15-15	Hs~Ref:NM_003161.1~CAT:PV3815	260	53	207
B20R15C16	20-16-15	Hs~Ref:NM_003161.1~CAT:PV3815	200	108	92
B20R15C17	20-17-15	Hs~Ref:NM_031417.1~CAT:PV3851	2719	44	2675
B20R15C18	20-18-15	Hs~Ref:NM_031417.1~CAT:PV3851	2677	44	2633
B20R15C19	20-19-15	Hs~Ref:NM_002741.1~CAT:PV3790	361	43	318
B20R15C20	20-20-15	Hs~Ref:NM_002741.1~CAT:PV3790	370	43	327
B20R15C21	20-21-15	Hs~Ref:NM_014370.1~CAT:PV3880	427	43	384
B20R15C22	20-22-15	Hs~Ref:NM_014370.1~CAT:PV3880	426	42	384
B20R16C01	20-1-16	Hs~Ref:NM_000600.1~CAT_PHC0066	80	41	39
B20R16C02	20-2-16	Hs~Ref:NM_000600.1~CAT_PHC0066	101	46	55
B20R16C03	20-3-16	Hs~IVGN:NM_002190~CAT_PHC0174~N/A	38	40	-2
B20R16C04	20-4-16	Hs~IVGN:NM_002190~CAT_PHC0174~N/A	39	40	-1
B20R16C05	20-5-16	Hs~Ref:NM_022740.2~CAT:PV5275	286	45	241
B20R16C06	20-6-16	Hs~Ref:NM_022740.2~CAT:PV5275	268	43	225
B20R16C07	20-7-16	Hs~Ref:NM_001002755.1~uORF:IOH59825	407	45	362
B20R16C08	20-8-16	Hs~Ref:NM_001002755.1~uORF:IOH59825	397	49	348
B20R16C09	20-9-16	Hs~Ref:NM_175072.1~uORF:IOH59828	2249	53	2196
B20R16C10	20-10-16	Hs~Ref:NM_175072.1~uORF:IOH59828	2325	57	2268
B20R16C11	20-11-16	Hs~Ref:NM_145322.1~uORF:IOH53553	547	46	501
B20R16C12	20-12-16	Hs~Ref:NM_145322.1~uORF:IOH53553	526	45	481
B20R16C13	20-13-16	Hs~Ref:NM_006254.3~uORF:IOH26352	811	55	756
B20R16C14	20-14-16	Hs~Ref:NM_006254.3~uORF:IOH26352	833	56	777
B20R16C15	20-15-16	Hs~Ref:NM_005896.2~uORF:IOH11942	42	43	-1
B20R16C16	20-16-16	Hs~Ref:NM_005896.2~uORF:IOH11942	37	40	-3
B20R16C17	20-17-16	Hs~Ref:NM_017425.2~uORF:IOH21671	339	44	295
B20R16C18	20-18-16	Hs~Ref:NM_017425.2~uORF:IOH21671	347	48	299
B20R16C19	20-19-16	Hs~Ref:NM_019846.3~uORF:IOH40714	412	68	344
B20R16C20	20-20-16	Hs~Ref:NM_019846.3~uORF:IOH40714	311	52	259
B20R16C21	20-21-16	Hs~Ref:NM_013392.2~uORF:IOH4821	373	49	324
B20R16C22	20-22-16	Hs~Ref:NM_013392.2~uORF:IOH4821	345	45	300
B20R17C01	20-1-17	Hs~Ref:NM_033547.1~uORF:IOH14845	205	43	162
B20R17C02	20-2-17	Hs~Ref:NM_033547.1~uORF:IOH14845	265	63	202
B20R17C03	20-3-17	Hs~Ref:NM_001924.2~uORF:IOH13873	42	41	1
B20R17C04	20-4-17	Hs~Ref:NM_001924.2~uORF:IOH13873	117	79	38
B20R17C05	20-5-17	Hs~Ref:NM_002916.1~uORF:IOH13786	645	43	602
B20R17C06	20-6-17	Hs~Ref:NM_002916.1~uORF:IOH13786	674	42	632
B20R17C07	20-7-17	Hs~Ref:NM_001450.2~uORF:IOH14447	277	43	234
B20R17C08	20-8-17	Hs~Ref:NM_001450.2~uORF:IOH14447	250	105	145
B20R17C09	20-9-17	Hs~Ref:NM_138403.3~uORF:IOH40584	347	44	303
B20R17C10	20-10-17	Hs~Ref:NM_138403.3~uORF:IOH40584	344	45	299
B20R17C11	20-11-17	Hs~Ref:NM_015698.2~uORF:IOH3563	696	44	652
B20R17C12	20-12-17	Hs~Ref:NM_015698.2~uORF:IOH3563	640	46	594
B20R17C13	20-13-17	Hs~MGC:BC021090.1~uORF:IOH13218	290	141	149
B20R17C14	20-14-17	Hs~MGC:BC021090.1~uORF:IOH13218	188	47	141
B20R17C15	20-15-17	Hs~MGC:BC024590.1~uORF:IOH11674	86	42	44
B20R17C16	20-16-17	Hs~MGC:BC024590.1~uORF:IOH11674	123	52	71
B20R17C17	20-17-17	Hs~Ref:NM_138717.1~uORF:IOH42435	392	47	345
B20R17C18	20-18-17	Hs~Ref:NM_138717.1~uORF:IOH42435	474	64	410
B20R17C19	20-19-17	Hs~Ref:NM_005513.1~uORF:IOH41075	1392	48	1344
B20R17C20	20-20-17	Hs~Ref:NM_005513.1~uORF:IOH41075	1412	47	1365
B20R17C21	20-21-17	Hs~Ref:NM_145202.3~uORF:IOH42472	369	45	324
B20R17C22	20-22-17	Hs~Ref:NM_145202.3~uORF:IOH42472	383	42	341
B20R18C01	20-1-18	Hs~Ref:XM_371901.1~uORF:IOH41658	357	40	317
B20R18C02	20-2-18	Hs~Ref:XM_371901.1~uORF:IOH41658	381	43	338
B20R18C03	20-3-18	Hs~Ref:NM_004580.2~uORF:IOH29589	223	127	96
B20R18C04	20-4-18	Hs~Ref:NM_004580.2~uORF:IOH29589	137	46	91
B20R18C05	20-5-18	Hs~MGC:BC063629.1~uORF:IOH61519	221	51	170
B20R18C06	20-6-18	Hs~MGC:BC063629.1~uORF:IOH61519	263	41	222
B20R18C07	20-7-18	Hs~MGC:BC091489.1~uORF:IOH62570	356	42	314
B20R18C08	20-8-18	Hs~MGC:BC091489.1~uORF:IOH62570	326	44	282
B20R18C09	20-9-18	Hs~MGC:BC096259.1~uORF:IOH63283	200	43	157
B20R18C10	20-10-18	Hs~MGC:BC096259.1~uORF:IOH63283	241	46	195
B20R18C11	20-11-18	Hs~MGC:BC071659.1~uORF:IOH61780	372	44	328
B20R18C12	20-12-18	Hs~MGC:BC071659.1~uORF:IOH61780	367	46	321
B20R18C13	20-13-18	Hs~MGC:BC015505.1~uORF:IOH9981	4791	51	4740
B20R18C14	20-14-18	Hs~MGC:BC015505.1~uORF:IOH9981	4922	48	4874
B20R18C15	20-15-18	Hs~Ref:NM_020944.2~uORF:IOH9687	479	43	436
B20R18C16	20-16-18	Hs~Ref:NM_020944.2~uORF:IOH9687	476	43	433
B20R18C17	20-17-18	Hs~Ref:NM_020854.2~uORF:IOH9686	699	43	656
B20R18C18	20-18-18	Hs~Ref:NM_020854.2~uORF:IOH9686	683	45	638
B20R18C19	20-19-18	Hs~MGC:BC040521.1~uORF:IOH27477	438	46	392
B20R18C20	20-20-18	Hs~MGC:BC040521.1~uORF:IOH27477	435	45	390
B20R18C21	20-21-18	Hs~Ref:NM_017836.2~uORF:IOH26055	391	44	347
B20R18C22	20-22-18	Hs~Ref:NM_017836.2~uORF:IOH26055	385	44	341
B20R19C01	20-1-19	Hs~MGC:BC039856.1~uORF:IOH26187	522	40	482
B20R19C02	20-2-19	Hs~MGC:BC039856.1~uORF:IOH26187	490	42	448
B20R19C03	20-3-19	Hs~MGC:BC009250.1~uORF:IOH27775	970	44	926
B20R19C04	20-4-19	Hs~MGC:BC009250.1~uORF:IOH27775	1119	44	1075
B20R19C05	20-5-19	Hs~MGC:BC017167.2~uORF:IOH61499	277	54	223
B20R19C06	20-6-19	Hs~MGC:BC017167.2~uORF:IOH61499	212	45	167
B20R19C07	20-7-19	Hs~MGC:BC010875.2~uORF:IOH61497	179	58	121
B20R19C08	20-8-19	Hs~MGC:BC010875.2~uORF:IOH61497	348	53	295
B20R19C09	20-9-19	Hs~MGC:BC063001.1~uORF:IOH61528	47	43	4
B20R19C10	20-10-19	Hs~MGC:BC063001.1~uORF:IOH61528	59	41	18
B20R19C11	20-11-19	Hs~MGC:BC028919.1~uORF:IOH61721	257	43	214
B20R19C12	20-12-19	Hs~MGC:BC028919.1~uORF:IOH61721	248	104	144
B20R19C13	20-13-19	Hs~MGC:BC035350.1~uORF:IOH27327	454	69	385
B20R19C14	20-14-19	Hs~MGC:BC035350.1~uORF:IOH27327	387	104	283
B20R19C15	20-15-19	Hs~Ref:NM_152453.2~uORF:IOH40202	511	45	466
B20R19C16	20-16-19	Hs~Ref:NM_152453.2~uORF:IOH40202	464	42	422
B20R19C17	20-17-19	Hs~MGC:BC066938.1~uORF:IOH40083	4624	41	4583
B20R19C18	20-18-19	Hs~MGC:BC066938.1~uORF:IOH40083	4790	42	4748
B20R19C19	20-19-19	Hs~Ref:NM_000331.2~uORF:IOH58953	339	46	293
B20R19C20	20-20-19	Hs~Ref:NM_000331.2~uORF:IOH58953	310	51	259
B20R19C21	20-21-19	Hs~Ref:NM_024055.2~uORF:IOH3071	348	49	299
B20R19C22	20-22-19	Hs~Ref:NM_024055.2~uORF:IOH3071	53	45	8
B20R20C01	20-1-20	Hs~MGC:BC000535.1~uORF:IOH4145	421	45	376
B20R20C02	20-2-20	Hs~MGC:BC000535.1~uORF:IOH4145	454	47	407
B20R20C03	20-3-20	Hs~MGC:BC001001.2~uORF:IOH2958	390	76	314
B20R20C04	20-4-20	Hs~MGC:BC001001.2~uORF:IOH2958	415	71	344
B20R20C05	20-5-20	Hs~Ref:NM_017668.1~uORF:IOH4081	802	47	755
B20R20C06	20-6-20	Hs~Ref:NM_017668.1~uORF:IOH4081	830	42	788
B20R20C07	20-7-20	Hs~Ref:NM_144736.3~uORF:IOH40597	1670	44	1626
B20R20C08	20-8-20	Hs~Ref:NM_144736.3~uORF:IOH40597	1721	45	1676
B20R20C09	20-9-20	Hs~Ref:NM_012474.3~uORF:IOH40599	41	42	-1
B20R20C10	20-10-20	Hs~Ref:NM_012474.3~uORF:IOH40599	38	39	-1
B20R20C11	20-11-20	Hs~Ref:NM_000075.2~uORF:IOH5192	377	40	337
B20R20C12	20-12-20	Hs~Ref:NM_000075.2~uORF:IOH5192	379	44	335
B20R20C13	20-13-20	Hs~Ref:NM_001028.2~uORF:IOH5471	360	46	314
B20R20C14	20-14-20	Hs~Ref:NM_001028.2~uORF:IOH5471	330	45	285
B20R20C15	20-15-20	Hs~Ref:NM_017436.2~uORF:IOH11211	897	42	855
B20R20C16	20-16-20	Hs~Ref:NM_017436.2~uORF:IOH11211	835	41	794
B20R20C17	20-17-20	Hs~Ref:ENST00000369398~uORF:IOH43799	1003	39	964
B20R20C18	20-18-20	Hs~Ref:ENST00000369398~uORF:IOH43799	1109	42	1067
B20R20C19	20-19-20	Hs~MGC:BC027322.1~uORF:IOH10880	1229	49	1180
B20R20C20	20-20-20	Hs~MGC:BC027322.1~uORF:IOH10880	1287	47	1240
B20R20C21	20-21-20	Hs~MGC:NM_153716.1~uORF:IOH25867	1123	42	1081
B20R20C22	20-22-20	Hs~MGC:NM_153716.1~uORF:IOH25867	1168	44	1124
B20R21C01	20-1-21	Hs~Ref:NM_138625.2~uORF:IOH50124	1432	41	1391
B20R21C02	20-2-21	Hs~Ref:NM_138625.2~uORF:IOH50124	1402	45	1357
B20R21C03	20-3-21	Hs~Ref:ENST00000372301~uORF:IOH50182	426	51	375
B20R21C04	20-4-21	Hs~Ref:ENST00000372301~uORF:IOH50182	396	67	329
B20R21C05	20-5-21	Hs~Ref:NM_207284.1~uORF:IOH50099	670	44	626
B20R21C06	20-6-21	Hs~Ref:NM_207284.1~uORF:IOH50099	653	41	612
B20R21C07	20-7-21	Hs~Ref:O43262~uORF:IOH50147	938	41	897
B20R21C08	20-8-21	Hs~Ref:O43262~uORF:IOH50147	918	41	877
B20R21C09	20-9-21	Hs~Ref:NP_001020083.1~CAT_10822-H08H-25	39	40	-1
B20R21C10	20-10-21	Hs~Ref:NP_001020083.1~CAT_10822-H08H-25	42	39	3
B20R21C11	20-11-21	Internal_1007209	67	40	27
B20R21C12	20-12-21	Internal_1007209	58	40	18
B20R21C13	20-13-21	Hs~Ref:NP_002176.2~CAT_10975-H08H-25	48	41	7
B20R21C14	20-14-21	Hs~Ref:NP_002176.2~CAT_10975-H08H-25	47	40	7
B20R21C15	20-15-21	Internal_1007209	410	45	365
B20R21C16	20-16-21	Internal_1007209	427	40	387
B20R21C17	20-17-21	Hs~Ref:NP_001954.2~CAT_10605-HNAE-25	41	39	2
B20R21C18	20-18-21	Hs~Ref:NP_001954.2~CAT_10605-HNAE-25	39	40	-1
B20R21C19	20-19-21	Internal_1007209	488	48	440
B20R21C20	20-20-21	Internal_1007209	44	43	1
B20R21C21	20-21-21	Internal_1007209	108	41	67
B20R21C22	20-22-21	Internal_1007209	657	56	601
B20R22C01	20-1-22	ERa~N/A	2652	38	2614
B20R22C02	20-2-22	ERa~N/A	2780	40	2740
B20R22C03	20-3-22	PKCeta~N/A	313	47	266
B20R22C04	20-4-22	PKCeta~N/A	237	42	195
B20R22C05	20-5-22	Calmodulin~N/A	59	40	19
B20R22C06	20-6-22	Calmodulin~N/A	71	47	24
B20R22C07	20-7-22	V5control5~N/A	322	44	278
B20R22C08	20-8-22	V5control5~N/A	383	43	340
B20R22C09	20-9-22	V5control4~N/A	95	40	55
B20R22C10	20-10-22	V5control4~N/A	83	46	37
B20R22C11	20-11-22	V5control3~N/A	80	42	38
B20R22C12	20-12-22	V5control3~N/A	66	41	25
B20R22C13	20-13-22	V5control2~N/A	52	41	11
B20R22C14	20-14-22	V5control2~N/A	40	42	-2
B20R22C15	20-15-22	V5control1~N/A	49	40	9
B20R22C16	20-16-22	V5control1~N/A	50	39	11
B20R22C17	20-17-22	CMK2A~N/A	606	39	567
B20R22C18	20-18-22	CMK2A~N/A	619	40	579
B20R22C19	20-19-22	ERa~N/A	1856	41	1815
B20R22C20	20-20-22	ERa~N/A	1994	42	1952
B20R22C21	20-21-22	AlexaAntiMouseAb~N/A	7872	42	7830
B20R22C22	20-22-22	AlexaAntiMouseAb~N/A	9097	49	9048
B21R01C01	21-1-1	AlexaAntiMouseAb~N/A	29889	37	29852
B21R01C02	21-2-1	AlexaAntiMouseAb~N/A	32272	36	32236
B21R01C03	21-3-1	ERa~N/A	1449	34	1415
B21R01C04	21-4-1	ERa~N/A	1318	34	1284
B21R01C05	21-5-1	HumanIgG1~N/A	982	34	948
B21R01C06	21-6-1	HumanIgG1~N/A	903	35	868
B21R01C07	21-7-1	HumanIgG2~N/A	2340	34	2306
B21R01C08	21-8-1	HumanIgG2~N/A	2424	35	2389
B21R01C09	21-9-1	HumanIgG3~N/A	12571	35	12536
B21R01C10	21-10-1	HumanIgG3~N/A	13084	37	13047
B21R01C11	21-11-1	HumanIgG4~N/A	34645	41	34604
B21R01C12	21-12-1	HumanIgG4~N/A	35540	40	35500
B21R01C13	21-13-1	BiotinAb~N/A	312	36	276
B21R01C14	21-14-1	BiotinAb~N/A	402	38	364
B21R01C15	21-15-1	RanBP2deltaFG~N/A	313	48	265
B21R01C16	21-16-1	RanBP2deltaFG~N/A	303	48	255
B21R01C17	21-17-1	hMDM2~N/A	675	38	637
B21R01C18	21-18-1	hMDM2~N/A	654	38	616
B21R01C19	21-19-1	PKCeta~N/A	265	36	229
B21R01C20	21-20-1	PKCeta~N/A	289	37	252
B21R01C21	21-21-1	AlexaAntiMouseAb~N/A	31132	38	31094
B21R01C22	21-22-1	AlexaAntiMouseAb~N/A	34491	38	34453
B21R02C01	21-1-2	PKCeta~N/A	1361	37	1324
B21R02C02	21-2-2	PKCeta~N/A	1459	37	1422
B21R02C03	21-3-2	Buffer	299	46	253
B21R02C04	21-4-2	Buffer	247	42	205
B21R02C05	21-5-2	HumanIgA~N/A	16186	35	16151
B21R02C06	21-6-2	HumanIgA~N/A	16577	35	16542
B21R02C07	21-7-2	Buffer	53	35	18
B21R02C08	21-8-2	Buffer	55	34	21
B21R02C09	21-9-2	BSA~N/A	10115	35	10080
B21R02C10	21-10-2	BSA~N/A	10500	36	10464
B21R02C11	21-11-2	Hs~Ref:NM_001006634.1~uORF:IOH44197	1966	42	1924
B21R02C12	21-12-2	Hs~Ref:NM_001006634.1~uORF:IOH44197	1883	41	1842
B21R02C13	21-13-2	Hs~MGC:NM_153236.2~uORF:IOH11863	328	39	289
B21R02C14	21-14-2	Hs~MGC:NM_153236.2~uORF:IOH11863	295	44	251
B21R02C15	21-15-2	Hs~Ref:NM_145010.1~uORF:IOH10871	7063	76	6987
B21R02C16	21-16-2	Hs~Ref:NM_145010.1~uORF:IOH10871	7007	55	6952
B21R02C17	21-17-2	Hs~MGC:BC011603.1~uORF:IOH13717	435	42	393
B21R02C18	21-18-2	Hs~MGC:BC011603.1~uORF:IOH13717	417	38	379
B21R02C19	21-19-2	Hs~Ref:NM_182480.1~uORF:IOH41665	247	37	210
B21R02C20	21-20-2	Hs~Ref:NM_182480.1~uORF:IOH41665	257	37	220
B21R02C21	21-21-2	Hs~Ref:XM_088679.2~uORF:IOH43003	602	37	565
B21R02C22	21-22-2	Hs~Ref:XM_088679.2~uORF:IOH43003	592	37	555
B21R03C01	21-1-3	Hs~Ref:NM_182492.1~uORF:IOH43816	88	36	52
B21R03C02	21-2-3	Hs~Ref:NM_182492.1~uORF:IOH43816	163	50	113
B21R03C03	21-3-3	Hs~MGC:NM_198157.1~uORF:IOH42269	293	152	141
B21R03C04	21-4-3	Hs~MGC:NM_198157.1~uORF:IOH42269	121	39	82
B21R03C05	21-5-3	Hs~Ref:NM_003221.1~uORF:IOH25803	442	35	407
B21R03C06	21-6-3	Hs~Ref:NM_003221.1~uORF:IOH25803	429	35	394
B21R03C07	21-7-3	Hs~MGC:NM_198276.1~uORF:IOH26511	196	43	153
B21R03C08	21-8-3	Hs~MGC:NM_198276.1~uORF:IOH26511	213	42	171
B21R03C09	21-9-3	Hs~Ref:NM_018990.1~uORF:IOH27033	529	36	493
B21R03C10	21-10-3	Hs~Ref:NM_018990.1~uORF:IOH27033	507	35	472
B21R03C11	21-11-3	Hs~MGC:BC014029.1~uORF:IOH14050	162	40	122
B21R03C12	21-12-3	Hs~MGC:BC014029.1~uORF:IOH14050	245	46	199
B21R03C13	21-13-3	Hs~Ref:NM_015610.1~uORF:IOH5656	306	36	270
B21R03C14	21-14-3	Hs~Ref:NM_015610.1~uORF:IOH5656	270	37	233
B21R03C15	21-15-3	Hs~Ref:NM_016058.1~uORF:IOH10494	244	60	184
B21R03C16	21-16-3	Hs~Ref:NM_016058.1~uORF:IOH10494	130	46	84
B21R03C17	21-17-3	Hs~Ref:NM_024061.1~uORF:IOH5510	380	38	342
B21R03C18	21-18-3	Hs~Ref:NM_024061.1~uORF:IOH5510	366	36	330
B21R03C19	21-19-3	Hs~MGC:BC011928.2~uORF:IOH14723	296	39	257
B21R03C20	21-20-3	Hs~MGC:BC011928.2~uORF:IOH14723	279	37	242
B21R03C21	21-21-3	Hs~Ref:NM_138785.1~uORF:IOH12456	265	36	229
B21R03C22	21-22-3	Hs~Ref:NM_138785.1~uORF:IOH12456	276	37	239
B21R04C01	21-1-4	Hs~MGC:BC030702.1~uORF:IOH22356	745	84	661
B21R04C02	21-2-4	Hs~MGC:BC030702.1~uORF:IOH22356	611	37	574
B21R04C03	21-3-4	Hs~MGC:BC022988.1~uORF:IOH22366	843	44	799
B21R04C04	21-4-4	Hs~MGC:BC022988.1~uORF:IOH22366	870	38	832
B21R04C05	21-5-4	Hs~MGC:BC022957.1~uORF:IOH22373	405	34	371
B21R04C06	21-6-4	Hs~MGC:BC022957.1~uORF:IOH22373	407	39	368
B21R04C07	21-7-4	Hs~Ref:NM_144697.1~uORF:IOH11412	505	51	454
B21R04C08	21-8-4	Hs~Ref:NM_144697.1~uORF:IOH11412	517	42	475
B21R04C09	21-9-4	Hs~MGC:BC005373.1~uORF:IOH7181	467	35	432
B21R04C10	21-10-4	Hs~MGC:BC005373.1~uORF:IOH7181	481	35	446
B21R04C11	21-11-4	Hs~Ref:NM_032930.1~uORF:IOH6595	197	36	161
B21R04C12	21-12-4	Hs~Ref:NM_032930.1~uORF:IOH6595	225	43	182
B21R04C13	21-13-4	Hs~Ref:NM_020661.1~uORF:IOH6382	787	46	741
B21R04C14	21-14-4	Hs~Ref:NM_020661.1~uORF:IOH6382	737	42	695
B21R04C15	21-15-4	Hs~MGC:BC017789.1~uORF:IOH13662	454	36	418
B21R04C16	21-16-4	Hs~MGC:BC017789.1~uORF:IOH13662	458	35	423
B21R04C17	21-17-4	Hs~MGC:BC064700.1~uORF:IOH39815	638	35	603
B21R04C18	21-18-4	Hs~MGC:BC064700.1~uORF:IOH39815	621	36	585
B21R04C19	21-19-4	Hs~Ref:NM_199133.1~uORF:IOH39868	272	49	223
B21R04C20	21-20-4	Hs~Ref:NM_199133.1~uORF:IOH39868	233	39	194
B21R04C21	21-21-4	Hs~Ref:NM_032517.3~uORF:IOH10985	211	41	170
B21R04C22	21-22-4	Hs~Ref:NM_032517.3~uORF:IOH10985	209	36	173
B21R05C01	21-1-5	Hs~MGC:BC010907.1~uORF:IOH12088	1052	36	1016
B21R05C02	21-2-5	Hs~MGC:BC010907.1~uORF:IOH12088	932	34	898
B21R05C03	21-3-5	Hs~MGC:BC010935.1~uORF:IOH12932	738	34	704
B21R05C04	21-4-5	Hs~MGC:BC010935.1~uORF:IOH12932	762	35	727
B21R05C05	21-5-5	Hs~MGC:BC014539.1~uORF:IOH12145	4417	35	4382
B21R05C06	21-6-5	Hs~MGC:BC014539.1~uORF:IOH12145	4193	41	4152
B21R05C07	21-7-5	Hs~Ref:NM_016940.1~uORF:IOH12821	1094	56	1038
B21R05C08	21-8-5	Hs~Ref:NM_016940.1~uORF:IOH12821	1053	45	1008
B21R05C09	21-9-5	Hs~MGC:NM_178543.3~uORF:IOH26296	208	41	167
B21R05C10	21-10-5	Hs~MGC:NM_178543.3~uORF:IOH26296	152	59	93
B21R05C11	21-11-5	Hs~MGC:BC050723.1~uORF:IOH27003	1080	38	1042
B21R05C12	21-12-5	Hs~MGC:BC050723.1~uORF:IOH27003	1046	41	1005
B21R05C13	21-13-5	Hs~Ref:NM_012472.1~uORF:IOH26570	1834	60	1774
B21R05C14	21-14-5	Hs~Ref:NM_012472.1~uORF:IOH26570	1891	50	1841
B21R05C15	21-15-5	Hs~MGC:BC040141.1~uORF:IOH26192	211	68	143
B21R05C16	21-16-5	Hs~MGC:BC040141.1~uORF:IOH26192	230	43	187
B21R05C17	21-17-5	Hs~Ref:NM_024754.2~uORF:IOH12500	425	35	390
B21R05C18	21-18-5	Hs~Ref:NM_024754.2~uORF:IOH12500	484	36	448
B21R05C19	21-19-5	Hs~Ref:NM_030968.1~uORF:IOH13365	321	40	281
B21R05C20	21-20-5	Hs~Ref:NM_030968.1~uORF:IOH13365	354	40	314
B21R05C21	21-21-5	Hs~Ref:NM_031446.2~uORF:IOH12400	337	37	300
B21R05C22	21-22-5	Hs~Ref:NM_031446.2~uORF:IOH12400	334	36	298
B21R06C01	21-1-6	Hs~Ref:NM_012163.1~uORF:IOH12859	198	36	162
B21R06C02	21-2-6	Hs~Ref:NM_012163.1~uORF:IOH12859	188	35	153
B21R06C03	21-3-6	Hs~Ref:NM_182688.1~uORF:IOH45834	259	51	208
B21R06C04	21-4-6	Hs~Ref:NM_182688.1~uORF:IOH45834	205	49	156
B21R06C05	21-5-6	Hs~Ref:NM_145042.2~uORF:IOH45811	322	40	282
B21R06C06	21-6-6	Hs~Ref:NM_145042.2~uORF:IOH45811	271	42	229
B21R06C07	21-7-6	Hs~Ref:NM_005978.3~uORF:IOH45852	209	40	169
B21R06C08	21-8-6	Hs~Ref:NM_005978.3~uORF:IOH45852	193	39	154
B21R06C09	21-9-6	Hs~MGC:BC064940.1~uORF:IOH39946	463	36	427
B21R06C10	21-10-6	Hs~MGC:BC064940.1~uORF:IOH39946	444	36	408
B21R06C11	21-11-6	Hs~Ref:NM_213645.1~uORF:IOH45767	362	35	327
B21R06C12	21-12-6	Hs~Ref:NM_213645.1~uORF:IOH45767	348	36	312
B21R06C13	21-13-6	Hs~Ref:NM_033128.1~uORF:IOH45789	288	110	178
B21R06C14	21-14-6	Hs~Ref:NM_033128.1~uORF:IOH45789	203	125	78
B21R06C15	21-15-6	Hs~Ref:NM_032955.1~uORF:IOH45766	209	60	149
B21R06C16	21-16-6	Hs~Ref:NM_032955.1~uORF:IOH45766	134	42	92
B21R06C17	21-17-6	Hs~Ref:NM_006306.2~uORF:IOH44953	869	35	834
B21R06C18	21-18-6	Hs~Ref:NM_006306.2~uORF:IOH44953	825	36	789
B21R06C19	21-19-6	Hs~Ref:NM_006340.1~uORF:IOH52178	1099	40	1059
B21R06C20	21-20-6	Hs~Ref:NM_006340.1~uORF:IOH52178	1114	42	1072
B21R06C21	21-21-6	Hs~Ref:NM_006736.4~uORF:IOH57131	291	116	175
B21R06C22	21-22-6	Hs~Ref:NM_006736.4~uORF:IOH57131	283	41	242
B21R07C01	21-1-7	Hs~MGC:BC027591.1~uORF:IOH56061	150	36	114
B21R07C02	21-2-7	Hs~MGC:BC027591.1~uORF:IOH56061	137	38	99
B21R07C03	21-3-7	Hs~Ref:NM_032907.3~uORF:IOH56973	112	37	75
B21R07C04	21-4-7	Hs~Ref:NM_032907.3~uORF:IOH56973	83	39	44
B21R07C05	21-5-7	Hs~Ref:NM_003831.1~uORF:IOH20968	317	35	282
B21R07C06	21-6-7	Hs~Ref:NM_003831.1~uORF:IOH20968	324	35	289
B21R07C07	21-7-7	Hs~Ref:NM_001800.2~uORF:IOH5163	392	36	356
B21R07C08	21-8-7	Hs~Ref:NM_001800.2~uORF:IOH5163	332	36	296
B21R07C09	21-9-7	Hs~Ref:NM_006504.2~uORF:IOH20996	316	37	279
B21R07C10	21-10-7	Hs~Ref:NM_006504.2~uORF:IOH20996	333	36	297
B21R07C11	21-11-7	Hs~Ref:NM_004090.1~uORF:IOH5237	473	35	438
B21R07C12	21-12-7	Hs~Ref:NM_004090.1~uORF:IOH5237	479	35	444
B21R07C13	21-13-7	Hs~Ref:NM_018273.2~uORF:IOH11850	300	36	264
B21R07C14	21-14-7	Hs~Ref:NM_018273.2~uORF:IOH11850	347	48	299
B21R07C15	21-15-7	Hs~Ref:NM_005299.1~uORF:IOH39404	361	42	319
B21R07C16	21-16-7	Hs~Ref:NM_005299.1~uORF:IOH39404	328	43	285
B21R07C17	21-17-7	Hs~Ref:NM_001094.4~uORF:IOH39422	366	36	330
B21R07C18	21-18-7	Hs~Ref:NM_001094.4~uORF:IOH39422	358	36	322
B21R07C19	21-19-7	Hs~MGC:BC024746.1~uORF:IOH11988	399	37	362
B21R07C20	21-20-7	Hs~MGC:BC024746.1~uORF:IOH11988	400	41	359
B21R07C21	21-21-7	Hs~Ref:NM_005157.2~N/A	321	62	259
B21R07C22	21-22-7	Hs~Ref:NM_005157.2~N/A	349	45	304
B21R08C01	21-1-8	Hs~Ref:NM_001211.3~N/A	319	37	282
B21R08C02	21-2-8	Hs~Ref:NM_001211.3~N/A	338	39	299
B21R08C03	21-3-8	Hs~Ref:NM_005990.1~N/A	355	38	317
B21R08C04	21-4-8	Hs~Ref:NM_005990.1~N/A	463	38	425
B21R08C05	21-5-8	Hs~Ref:NM_013233.1~N/A	636	36	600
B21R08C06	21-6-8	Hs~Ref:NM_013233.1~N/A	664	37	627
B21R08C07	21-7-8	Hs~MGC:BC019300.1~uORF:IOH22880	410	40	370
B21R08C08	21-8-8	Hs~MGC:BC019300.1~uORF:IOH22880	379	39	340
B21R08C09	21-9-8	Hs~Ref:NM_021019.2~uORF:IOH22891	242	138	104
B21R08C10	21-10-8	Hs~Ref:NM_021019.2~uORF:IOH22891	303	47	256
B21R08C11	21-11-8	Hs~Ref:NM_032892.1~uORF:IOH22926	348	38	310
B21R08C12	21-12-8	Hs~Ref:NM_032892.1~uORF:IOH22926	351	38	313
B21R08C13	21-13-8	Hs~MGC:NM_152362.1~uORF:IOH10838	380	37	343
B21R08C14	21-14-8	Hs~MGC:NM_152362.1~uORF:IOH10838	392	40	352
B21R08C15	21-15-8	Hs~Ref:NM_145012.3~uORF:IOH36789	594	43	551
B21R08C16	21-16-8	Hs~Ref:NM_145012.3~uORF:IOH36789	598	39	559
B21R08C17	21-17-8	Hs~Ref:NM_001783.1~uORF:IOH44544	540	36	504
B21R08C18	21-18-8	Hs~Ref:NM_001783.1~uORF:IOH44544	527	36	491
B21R08C19	21-19-8	Hs~Ref:NM_005016.3~uORF:IOH44672	436	36	400
B21R08C20	21-20-8	Hs~Ref:NM_005016.3~uORF:IOH44672	443	37	406
B21R08C21	21-21-8	Hs~Ref:NM_198195.1~uORF:IOH44596	425	46	379
B21R08C22	21-22-8	Hs~Ref:NM_198195.1~uORF:IOH44596	423	42	381
B21R09C01	21-1-9	Hs~Ref:NM_016338.3~uORF:IOH21768	146	37	109
B21R09C02	21-2-9	Hs~Ref:NM_016338.3~uORF:IOH21768	102	38	64
B21R09C03	21-3-9	Hs~Ref:NM_017491.3~uORF:IOH3975	513	38	475
B21R09C04	21-4-9	Hs~Ref:NM_017491.3~uORF:IOH3975	494	39	455
B21R09C05	21-5-9	Hs~MGC:BC003610.2~uORF:IOH3899	325	41	284
B21R09C06	21-6-9	Hs~MGC:BC003610.2~uORF:IOH3899	313	39	274
B21R09C07	21-7-9	Hs~Ref:NM_023935.1~uORF:IOH4217	376	40	336
B21R09C08	21-8-9	Hs~Ref:NM_023935.1~uORF:IOH4217	383	38	345
B21R09C09	21-9-9	Hs~Ref:NM_170676.2~uORF:IOH26710	2510	42	2468
B21R09C10	21-10-9	Hs~Ref:NM_170676.2~uORF:IOH26710	2375	40	2335
B21R09C11	21-11-9	Hs~MGC:BC014413.1~uORF:IOH13994	281	39	242
B21R09C12	21-12-9	Hs~MGC:BC014413.1~uORF:IOH13994	305	38	267
B21R09C13	21-13-9	Hs~Ref:NM_021073.2~uORF:IOH27302	345	42	303
B21R09C14	21-14-9	Hs~Ref:NM_021073.2~uORF:IOH27302	290	38	252
B21R09C15	21-15-9	Hs~MGC:BC056253.1~uORF:IOH29437	318	38	280
B21R09C16	21-16-9	Hs~MGC:BC056253.1~uORF:IOH29437	296	37	259
B21R09C17	21-17-9	Hs~Ref:NM_032496.1~uORF:IOH6543	1951	36	1915
B21R09C18	21-18-9	Hs~Ref:NM_032496.1~uORF:IOH6543	2027	36	1991
B21R09C19	21-19-9	Hs~MGC:BC004564.2~uORF:IOH46115	331	37	294
B21R09C20	21-20-9	Hs~MGC:BC004564.2~uORF:IOH46115	315	37	278
B21R09C21	21-21-9	Hs~MGC:BC005840.2~uORF:IOH46093	539	38	501
B21R09C22	21-22-9	Hs~MGC:BC005840.2~uORF:IOH46093	570	38	532
B21R10C01	21-1-10	Hs~Ref:NM_020170.3~uORF:IOH46155	48	41	7
B21R10C02	21-2-10	Hs~Ref:NM_020170.3~uORF:IOH46155	81	49	32
B21R10C03	21-3-10	Hs~MGC:BC065370.1~uORF:IOH40687	328	40	288
B21R10C04	21-4-10	Hs~MGC:BC065370.1~uORF:IOH40687	304	41	263
B21R10C05	21-5-10	Hs~MGC:BC065738.1~uORF:IOH40732	182	110	72
B21R10C06	21-6-10	Hs~MGC:BC065738.1~uORF:IOH40732	228	119	109
B21R10C07	21-7-10	Hs~Ref:NM_052935.2~uORF:IOH40639	341	36	305
B21R10C08	21-8-10	Hs~Ref:NM_052935.2~uORF:IOH40639	340	36	304
B21R10C09	21-9-10	Hs~Ref:NM_080574.2~uORF:IOH40713	672	36	636
B21R10C10	21-10-10	Hs~Ref:NM_080574.2~uORF:IOH40713	606	36	570
B21R10C11	21-11-10	GST1	39	35	4
B21R10C12	21-12-10	GST1	38	35	3
B21R10C13	21-13-10	GST2	40	37	3
B21R10C14	21-14-10	GST2	42	36	6
B21R10C15	21-15-10	GST3	49	36	13
B21R10C16	21-16-10	GST3	42	36	6
B21R10C17	21-17-10	GST4	62	35	27
B21R10C18	21-18-10	GST4	57	36	21
B21R10C19	21-19-10	Anti-HumanIgA1~N/A	8830	36	8794
B21R10C20	21-20-10	Anti-HumanIgA1~N/A	8464	38	8426
B21R10C21	21-21-10	Anti-HumanIgA2~N/A	14368	42	14326
B21R10C22	21-22-10	Anti-HumanIgA2~N/A	14358	41	14317
B21R11C01	21-1-11	AlexaAntiMouseAb~N/A	20639	37	20602
B21R11C02	21-2-11	AlexaAntiMouseAb~N/A	18984	37	18947
B21R11C03	21-3-11	MAPKAP~N/A	62	35	27
B21R11C04	21-4-11	MAPKAP~N/A	60	37	23
B21R11C05	21-5-11	Buffer	312	40	272
B21R11C06	21-6-11	Buffer	350	57	293
B21R11C07	21-7-11	BSA~N/A	7154	35	7119
B21R11C08	21-8-11	BSA~N/A	7161	35	7126
B21R11C09	21-9-11	Anti-HumanIgG1~N/A	1570	35	1535
B21R11C10	21-10-11	Anti-HumanIgG1~N/A	1508	36	1472
B21R11C11	21-11-11	Anti-HumanIgG2~N/A	2886	35	2851
B21R11C12	21-12-11	Anti-HumanIgG2~N/A	3107	36	3071
B21R11C13	21-13-11	Anti-HumanIgG3~N/A	5460	38	5422
B21R11C14	21-14-11	Anti-HumanIgG3~N/A	5527	38	5489
B21R11C15	21-15-11	Anti-HumanIgG4~N/A	10139	39	10100
B21R11C16	21-16-11	Anti-HumanIgG4~N/A	9848	38	9810
B21R11C17	21-17-11	AntiBiotinAb~N/A	10717	36	10681
B21R11C18	21-18-11	AntiBiotinAb~N/A	10645	36	10609
B21R11C19	21-19-11	Buffer	57	35	22
B21R11C20	21-20-11	Buffer	53	35	18
B21R11C21	21-21-11	Hs~MGC:BC020803.1~uORF:IOH14817	1119	39	1080
B21R11C22	21-22-11	Hs~MGC:BC020803.1~uORF:IOH14817	1143	41	1102
B21R12C01	21-1-12	Hs~Ref:NM_016946.3~uORF:IOH12781	71	39	32
B21R12C02	21-2-12	Hs~Ref:NM_016946.3~uORF:IOH12781	127	37	90
B21R12C03	21-3-12	Hs~MGC:BC056673.1~uORF:IOH29479	432	37	395
B21R12C04	21-4-12	Hs~MGC:BC056673.1~uORF:IOH29479	437	39	398
B21R12C05	21-5-12	Hs~MGC:BC002921.2~uORF:IOH6311	6633	43	6590
B21R12C06	21-6-12	Hs~MGC:BC002921.2~uORF:IOH6311	6628	42	6586
B21R12C07	21-7-12	Hs~MGC:BC000091.1~uORF:IOH4587	355	36	319
B21R12C08	21-8-12	Hs~MGC:BC000091.1~uORF:IOH4587	312	36	276
B21R12C09	21-9-12	Hs~MGC:BC013171.1~uORF:IOH22121	554	36	518
B21R12C10	21-10-12	Hs~MGC:BC013171.1~uORF:IOH22121	545	36	509
B21R12C11	21-11-12	Hs~MGC:BC027465.1~uORF:IOH22829	907	35	872
B21R12C12	21-12-12	Hs~MGC:BC027465.1~uORF:IOH22829	877	38	839
B21R12C13	21-13-12	Hs~Ref:NM_020185.2~uORF:IOH21099	359	42	317
B21R12C14	21-14-12	Hs~Ref:NM_020185.2~uORF:IOH21099	369	45	324
B21R12C15	21-15-12	Hs~Ref:NM_014240.1~uORF:IOH41830	549	38	511
B21R12C16	21-16-12	Hs~Ref:NM_014240.1~uORF:IOH41830	541	36	505
B21R12C17	21-17-12	Hs~Ref:NM_001571.2~uORF:IOH45678	930	35	895
B21R12C18	21-18-12	Hs~Ref:NM_001571.2~uORF:IOH45678	883	36	847
B21R12C19	21-19-12	Hs~Ref:NM_001182.2~uORF:IOH45681	1864	35	1829
B21R12C20	21-20-12	Hs~Ref:NM_001182.2~uORF:IOH45681	1917	35	1882
B21R12C21	21-21-12	Hs~Ref:NM_024948.2~uORF:IOH45694	554	35	519
B21R12C22	21-22-12	Hs~Ref:NM_024948.2~uORF:IOH45694	557	36	521
B21R13C01	21-1-13	Hs~Ref:NM_001504.1~uORF:IOH22806	101	36	65
B21R13C02	21-2-13	Hs~Ref:NM_001504.1~uORF:IOH22806	131	47	84
B21R13C03	21-3-13	Hs~Ref:NM_000800.2~uORF:IOH21917	418	35	383
B21R13C04	21-4-13	Hs~Ref:NM_000800.2~uORF:IOH21917	407	36	371
B21R13C05	21-5-13	Hs~MGC:NM_007189.1~uORF:IOH3871	237	36	201
B21R13C06	21-6-13	Hs~MGC:NM_007189.1~uORF:IOH3871	259	67	192
B21R13C07	21-7-13	Hs~Ref:NM_138432.1~uORF:IOH12304	70	35	35
B21R13C08	21-8-13	Hs~Ref:NM_138432.1~uORF:IOH12304	66	35	31
B21R13C09	21-9-13	Hs~Ref:NM_014404.1~uORF:IOH35437	327	35	292
B21R13C10	21-10-13	Hs~Ref:NM_014404.1~uORF:IOH35437	319	35	284
B21R13C11	21-11-13	Hs~Ref:NM_016215.3~uORF:IOH54905	362	36	326
B21R13C12	21-12-13	Hs~Ref:NM_016215.3~uORF:IOH54905	343	37	306
B21R13C13	21-13-13	Hs~Ref:NM_005962.4~uORF:IOH59039	144	44	100
B21R13C14	21-14-13	Hs~Ref:NM_005962.4~uORF:IOH59039	143	88	55
B21R13C15	21-15-13	Hs~Ref:NM_014716.2~uORF:IOH60017	433	38	395
B21R13C16	21-16-13	Hs~Ref:NM_014716.2~uORF:IOH60017	404	36	368
B21R13C17	21-17-13	Hs~Ref:NM_001125.2~uORF:IOH40024	291	36	255
B21R13C18	21-18-13	Hs~Ref:NM_001125.2~uORF:IOH40024	305	37	268
B21R13C19	21-19-13	Hs~MGC:BC064145.1~uORF:IOH40031	521	36	485
B21R13C20	21-20-13	Hs~MGC:BC064145.1~uORF:IOH40031	538	36	502
B21R13C21	21-21-13	Hs~MGC:BC067299.1~uORF:IOH40040	590	36	554
B21R13C22	21-22-13	Hs~MGC:BC067299.1~uORF:IOH40040	633	36	597
B21R14C01	21-1-14	Hs~MGC:BC062471.1~uORF:IOH40049	785	37	748
B21R14C02	21-2-14	Hs~MGC:BC062471.1~uORF:IOH40049	785	36	749
B21R14C03	21-3-14	Hs~Ref:NM_002423.3~uORF:IOH53878	330	35	295
B21R14C04	21-4-14	Hs~Ref:NM_002423.3~uORF:IOH53878	389	36	353
B21R14C05	21-5-14	Hs~Ref:NM_001488.3~uORF:IOH53996	267	36	231
B21R14C06	21-6-14	Hs~Ref:NM_001488.3~uORF:IOH53996	260	41	219
B21R14C07	21-7-14	Hs~Ref:NM_005711.3~uORF:IOH54017	240	39	201
B21R14C08	21-8-14	Hs~Ref:NM_005711.3~uORF:IOH54017	247	51	196
B21R14C09	21-9-14	Hs~MGC:BC040376.1~uORF:IOH28629	223	36	187
B21R14C10	21-10-14	Hs~MGC:BC040376.1~uORF:IOH28629	187	36	151
B21R14C11	21-11-14	Hs~Ref:NM_004869.2~uORF:IOH2268	297	36	261
B21R14C12	21-12-14	Hs~Ref:NM_004869.2~uORF:IOH2268	312	37	275
B21R14C13	21-13-14	Hs~Ref:NM_005500.1~uORF:IOH3882	314	45	269
B21R14C14	21-14-14	Hs~Ref:NM_005500.1~uORF:IOH3882	310	128	182
B21R14C15	21-15-14	Hs~Ref:NM_004804.1~uORF:IOH3935	298	38	260
B21R14C16	21-16-14	Hs~Ref:NM_004804.1~uORF:IOH3935	303	37	266
B21R14C17	21-17-14	Hs~Ref:NM_000454.1~uORF:IOH4089	252	36	216
B21R14C18	21-18-14	Hs~Ref:NM_000454.1~uORF:IOH4089	257	37	220
B21R14C19	21-19-14	Hs~MGC:BC047051.1~uORF:IOH62401	295	41	254
B21R14C20	21-20-14	Hs~MGC:BC047051.1~uORF:IOH62401	247	43	204
B21R14C21	21-21-14	Hs~MGC:BC063432.1~uORF:IOH61535	252	40	212
B21R14C22	21-22-14	Hs~MGC:BC063432.1~uORF:IOH61535	235	37	198
B21R15C01	21-1-15	Hs~MGC:BC051731.1~uORF:IOH62375	307	41	266
B21R15C02	21-2-15	Hs~MGC:BC051731.1~uORF:IOH62375	238	38	200
B21R15C03	21-3-15	Hs~MGC:BC095490.1~uORF:IOH63172	4579	42	4537
B21R15C04	21-4-15	Hs~MGC:BC095490.1~uORF:IOH63172	4365	38	4327
B21R15C05	21-5-15	Hs~MGC:BC017357.1~uORF:IOH29348	296	35	261
B21R15C06	21-6-15	Hs~MGC:BC017357.1~uORF:IOH29348	304	36	268
B21R15C07	21-7-15	Hs~MGC:BC055096.1~uORF:IOH29497	270	64	206
B21R15C08	21-8-15	Hs~MGC:BC055096.1~uORF:IOH29497	91	39	52
B21R15C09	21-9-15	Hs~MGC:BC056508.1~uORF:IOH29456	396	36	360
B21R15C10	21-10-15	Hs~MGC:BC056508.1~uORF:IOH29456	390	36	354
B21R15C11	21-11-15	Hs~MGC:BC054021.1~uORF:IOH29457	124	37	87
B21R15C12	21-12-15	Hs~MGC:BC054021.1~uORF:IOH29457	119	37	82
B21R15C13	21-13-15	Hs~Ref:NM133775~CAT_PHC9315	708	36	672
B21R15C14	21-14-15	Hs~Ref:NM133775~CAT_PHC9315	730	36	694
B21R15C15	21-15-15	Hs~Ref:NM_001042599.1~CAT:PV3626	193	97	96
B21R15C16	21-16-15	Hs~Ref:NM_001042599.1~CAT:PV3626	204	88	116
B21R15C17	21-17-15	Hs~Ref:NM_004441.3~CAT:PV3786	385	35	350
B21R15C18	21-18-15	Hs~Ref:NM_004441.3~CAT:PV3786	370	35	335
B21R15C19	21-19-15	Hs~Ref:NM_002738.5~CAT:P2251	548	36	512
B21R15C20	21-20-15	Hs~Ref:NM_002738.5~CAT:P2251	527	36	491
B21R15C21	21-21-15	Hs~Ref:NM_001007071.1~CAT:PV3831	3999	36	3963
B21R15C22	21-22-15	Hs~Ref:NM_001007071.1~CAT:PV3831	4090	36	4054
B21R16C01	21-1-16	Hs~Ref:NM_005308.2~CAT:PV3824	341	33	308
B21R16C02	21-2-16	Hs~Ref:NM_005308.2~CAT:PV3824	351	33	318
B21R16C03	21-3-16	Hs~Ref:NM_000176.1~CAT:PV4690	282	45	237
B21R16C04	21-4-16	Hs~Ref:NM_000176.1~CAT:PV4690	280	40	240
B21R16C05	21-5-16	Hs~MGC:NM_199334.2~CAT:PV4762	282	34	248
B21R16C06	21-6-16	Hs~MGC:NM_199334.2~CAT:PV4762	298	38	260
B21R16C07	21-7-16	Hs~MGC:BC088364.1~uORF:IOH62598	370	40	330
B21R16C08	21-8-16	Hs~MGC:BC088364.1~uORF:IOH62598	348	39	309
B21R16C09	21-9-16	Hs~MGC:BC067823.1~uORF:IOH61674	879	38	841
B21R16C10	21-10-16	Hs~MGC:BC067823.1~uORF:IOH61674	915	38	877
B21R16C11	21-11-16	Hs~MGC:BC072419.1~uORF:IOH62555	28172	36	28136
B21R16C12	21-12-16	Hs~MGC:BC072419.1~uORF:IOH62555	28358	38	28320
B21R16C13	21-13-16	Hs~MGC:BC091500.1~uORF:IOH62588	875	38	837
B21R16C14	21-14-16	Hs~MGC:BC091500.1~uORF:IOH62588	798	37	761
B21R16C15	21-15-16	Hs~MGC:BC006155.1~uORF:IOH6598	348	37	311
B21R16C16	21-16-16	Hs~MGC:BC006155.1~uORF:IOH6598	353	36	317
B21R16C17	21-17-16	Hs~Ref:NM_002619.1~uORF:IOH29560	318	35	283
B21R16C18	21-18-16	Hs~Ref:NM_002619.1~uORF:IOH29560	321	35	286
B21R16C19	21-19-16	Hs~Ref:NM_002983.1~uORF:IOH29648	261	35	226
B21R16C20	21-20-16	Hs~Ref:NM_002983.1~uORF:IOH29648	270	38	232
B21R16C21	21-21-16	Hs~MGC:BC060852.1~uORF:IOH29264	349	40	309
B21R16C22	21-22-16	Hs~MGC:BC060852.1~uORF:IOH29264	350	38	312
B21R17C01	21-1-17	Hs~MGC:BC020691.1~uORF:IOH12187	559	32	527
B21R17C02	21-2-17	Hs~MGC:BC020691.1~uORF:IOH12187	623	33	590
B21R17C03	21-3-17	Hs~MGC:BC022248.1~uORF:IOH12822	827	33	794
B21R17C04	21-4-17	Hs~MGC:BC022248.1~uORF:IOH12822	804	33	771
B21R17C05	21-5-17	Hs~Ref:NM_138326.1~uORF:IOH12970	602	34	568
B21R17C06	21-6-17	Hs~Ref:NM_138326.1~uORF:IOH12970	594	35	559
B21R17C07	21-7-17	Hs~MGC:BC009764.1~uORF:IOH12737	619	35	584
B21R17C08	21-8-17	Hs~MGC:BC009764.1~uORF:IOH12737	630	35	595
B21R17C09	21-9-17	Hs~Ref:NM_024585.2~uORF:IOH12995	213	131	82
B21R17C10	21-10-17	Hs~Ref:NM_024585.2~uORF:IOH12995	231	40	191
B21R17C11	21-11-17	Hs~Ref:NM_032413.1~uORF:IOH11314	424	35	389
B21R17C12	21-12-17	Hs~Ref:NM_032413.1~uORF:IOH11314	422	36	386
B21R17C13	21-13-17	Hs~MGC:BC029375.1~uORF:IOH23125	354	40	314
B21R17C14	21-14-17	Hs~MGC:BC029375.1~uORF:IOH23125	318	40	278
B21R17C15	21-15-17	Hs~MGC:BC078140.1~uORF:IOH61802	246	38	208
B21R17C16	21-16-17	Hs~MGC:BC078140.1~uORF:IOH61802	234	39	195
B21R17C17	21-17-17	Hs~MGC:BC013158.1~uORF:IOH9772	315	35	280
B21R17C18	21-18-17	Hs~MGC:BC013158.1~uORF:IOH9772	327	34	293
B21R17C19	21-19-17	Hs~Ref:NM_018439.1~uORF:IOH23069	254	34	220
B21R17C20	21-20-17	Hs~Ref:NM_018439.1~uORF:IOH23069	294	37	257
B21R17C21	21-21-17	Hs~Ref:NM_033003.1~uORF:IOH5665	347	42	305
B21R17C22	21-22-17	Hs~Ref:NM_033003.1~uORF:IOH5665	334	43	291
B21R18C01	21-1-18	Hs~Ref:NM_031361.1~uORF:IOH4674	379	34	345
B21R18C02	21-2-18	Hs~Ref:NM_031361.1~uORF:IOH4674	376	34	342
B21R18C03	21-3-18	Hs~MGC:BC001394.1~uORF:IOH3978	34	34	0
B21R18C04	21-4-18	Hs~MGC:BC001394.1~uORF:IOH3978	34	34	0
B21R18C05	21-5-18	Hs~Ref:NM_052933.1~uORF:IOH27379	488	34	454
B21R18C06	21-6-18	Hs~Ref:NM_052933.1~uORF:IOH27379	481	35	446
B21R18C07	21-7-18	Hs~MGC:BC041366.2~uORF:IOH27747	1354	36	1318
B21R18C08	21-8-18	Hs~MGC:BC041366.2~uORF:IOH27747	1413	37	1376
B21R18C09	21-9-18	Hs~Ref:NM_004549.2~uORF:IOH5873	418	36	382
B21R18C10	21-10-18	Hs~Ref:NM_004549.2~uORF:IOH5873	419	37	382
B21R18C11	21-11-18	Hs~Ref:NM_005658.3~uORF:IOH57217	276	37	239
B21R18C12	21-12-18	Hs~Ref:NM_005658.3~uORF:IOH57217	268	39	229
B21R18C13	21-13-18	Hs~MGC:BC051733.1~uORF:IOH56370	873	38	835
B21R18C14	21-14-18	Hs~MGC:BC051733.1~uORF:IOH56370	822	39	783
B21R18C15	21-15-18	Hs~Ref:NM_177963.2~uORF:IOH56303	257	53	204
B21R18C16	21-16-18	Hs~Ref:NM_177963.2~uORF:IOH56303	87	42	45
B21R18C17	21-17-18	Hs~Ref:NM_005672.3~uORF:IOH57253	218	72	146
B21R18C18	21-18-18	Hs~Ref:NM_005672.3~uORF:IOH57253	176	82	94
B21R18C19	21-19-18	Hs~Ref:NM_002350.1~N/A	332	37	295
B21R18C20	21-20-18	Hs~Ref:NM_002350.1~N/A	345	37	308
B21R18C21	21-21-18	Hs~Ref:NM_000075.2~N/A	357	39	318
B21R18C22	21-22-18	Hs~Ref:NM_000075.2~N/A	357	40	317
B21R19C01	21-1-19	Hs~Ref:NM_002350.1~N/A	305	36	269
B21R19C02	21-2-19	Hs~Ref:NM_002350.1~N/A	301	38	263
B21R19C03	21-3-19	Hs~Ref:NM_000245.1~N/A	289	37	252
B21R19C04	21-4-19	Hs~Ref:NM_000245.1~N/A	267	36	231
B21R19C05	21-5-19	Hs~Ref:NM_001004708.1~uORF:IOH28245	286	36	250
B21R19C06	21-6-19	Hs~Ref:NM_001004708.1~uORF:IOH28245	326	36	290
B21R19C07	21-7-19	Hs~MGC:BC041414.1~uORF:IOH25837	292	37	255
B21R19C08	21-8-19	Hs~MGC:BC041414.1~uORF:IOH25837	295	39	256
B21R19C09	21-9-19	Hs~MGC:BC050622.1~uORF:IOH27083	254	41	213
B21R19C10	21-10-19	Hs~MGC:BC050622.1~uORF:IOH27083	299	134	165
B21R19C11	21-11-19	Hs~Ref:NM_080416.1~uORF:IOH10603	326	39	287
B21R19C12	21-12-19	Hs~Ref:NM_080416.1~uORF:IOH10603	308	40	268
B21R19C13	21-13-19	Hs~MGC:NM_183247.1~uORF:IOH44636	444	52	392
B21R19C14	21-14-19	Hs~MGC:NM_183247.1~uORF:IOH44636	363	92	271
B21R19C15	21-15-19	Hs~Ref:NM_144767.3~uORF:IOH44040	1759	38	1721
B21R19C16	21-16-19	Hs~Ref:NM_144767.3~uORF:IOH44040	1728	43	1685
B21R19C17	21-17-19	Hs~Ref:NM_006674.2~uORF:IOH42052	338	45	293
B21R19C18	21-18-19	Hs~Ref:NM_006674.2~uORF:IOH42052	216	42	174
B21R19C19	21-19-19	Hs~Ref:NM_198309.2~uORF:IOH42038	353	38	315
B21R19C20	21-20-19	Hs~Ref:NM_198309.2~uORF:IOH42038	326	36	290
B21R19C21	21-21-19	Hs~MGC:BC013069.1~uORF:IOH10251	562	36	526
B21R19C22	21-22-19	Hs~MGC:BC013069.1~uORF:IOH10251	603	36	567
B21R20C01	21-1-20	Hs~Ref:NM_003358.1~uORF:IOH27248	403	34	369
B21R20C02	21-2-20	Hs~Ref:NM_003358.1~uORF:IOH27248	384	34	350
B21R20C03	21-3-20	Hs~Ref:NM_003692.1~uORF:IOH27690	417	36	381
B21R20C04	21-4-20	Hs~Ref:NM_003692.1~uORF:IOH27690	433	35	398
B21R20C05	21-5-20	Hs~Ref:NM_015488.1~uORF:IOH22386	532	35	497
B21R20C06	21-6-20	Hs~Ref:NM_015488.1~uORF:IOH22386	529	35	494
B21R20C07	21-7-20	Hs~Ref:NM_030935.1~uORF:IOH3133	283	35	248
B21R20C08	21-8-20	Hs~Ref:NM_030935.1~uORF:IOH3133	261	37	224
B21R20C09	21-9-20	Hs~MGC:NM_020801.1~uORF:IOH10036	378	44	334
B21R20C10	21-10-20	Hs~MGC:NM_020801.1~uORF:IOH10036	391	40	351
B21R20C11	21-11-20	Hs~Ref:NM_006791.1~uORF:IOH3901	1072	36	1036
B21R20C12	21-12-20	Hs~Ref:NM_006791.1~uORF:IOH3901	1010	36	974
B21R20C13	21-13-20	Hs~Ref:NM_018326.1~uORF:IOH14251	3429	37	3392
B21R20C14	21-14-20	Hs~Ref:NM_018326.1~uORF:IOH14251	3427	35	3392
B21R20C15	21-15-20	Hs~Ref:NM_016504.1~uORF:IOH3742	378	36	342
B21R20C16	21-16-20	Hs~Ref:NM_016504.1~uORF:IOH3742	345	39	306
B21R20C17	21-17-20	Hs~MGC:AB065927.1~uORF:IOH28205	260	49	211
B21R20C18	21-18-20	Hs~MGC:AB065927.1~uORF:IOH28205	279	57	222
B21R20C19	21-19-20	Hs~MGC:BC043388.1~uORF:IOH26413	49	45	4
B21R20C20	21-20-20	Hs~MGC:BC043388.1~uORF:IOH26413	321	104	217
B21R20C21	21-21-20	Hs~MGC:XM_071151.2~uORF:IOH28267	461	37	424
B21R20C22	21-22-20	Hs~MGC:XM_071151.2~uORF:IOH28267	425	36	389
B21R21C01	21-1-21	Hs~Ref:NM_013352.1~uORF:IOH27207	87	33	54
B21R21C02	21-2-21	Hs~Ref:NM_013352.1~uORF:IOH27207	87	33	54
B21R21C03	21-3-21	Hs~MGC:BC035621.1~uORF:IOH27568	324	34	290
B21R21C04	21-4-21	Hs~MGC:BC035621.1~uORF:IOH27568	300	35	265
B21R21C05	21-5-21	Hs~MGC:BC034621.1~uORF:IOH27673	256	37	219
B21R21C06	21-6-21	Hs~MGC:BC034621.1~uORF:IOH27673	254	37	217
B21R21C07	21-7-21	Hs~Ref:NM_022903.2~uORF:IOH27307	249	56	193
B21R21C08	21-8-21	Hs~Ref:NM_022903.2~uORF:IOH27307	228	43	185
B21R21C09	21-9-21	Hs~Ref:NP_003833.3~CAT_10465-H03H-25	4049	39	4010
B21R21C10	21-10-21	Hs~Ref:NP_003833.3~CAT_10465-H03H-25	3962	36	3926
B21R21C11	21-11-21	Internal_1007209	76	34	42
B21R21C12	21-12-21	Internal_1007209	73	34	39
B21R21C13	21-13-21	Hs~Ref:P20273-1~CAT_11958-H08H-25	51	34	17
B21R21C14	21-14-21	Hs~Ref:P20273-1~CAT_11958-H08H-25	54	34	20
B21R21C15	21-15-21	Internal_1007209	63	38	25
B21R21C16	21-16-21	Internal_1007209	46	34	12
B21R21C17	21-17-21	Hs~Ref:NP_068576.1~CAT_10108-H02H-25	7163	36	7127
B21R21C18	21-18-21	Hs~Ref:NP_068576.1~CAT_10108-H02H-25	8477	37	8440
B21R21C19	21-19-21	Internal_1007209	952	35	917
B21R21C20	21-20-21	Internal_1007209	1016	35	981
B21R21C21	21-21-21	Hs~Ref:NP_954701.1~CAT_PHC7041	4710	35	4675
B21R21C22	21-22-21	Hs~Ref:NP_954701.1~CAT_PHC7041	4745	35	4710
B21R22C01	21-1-22	ERa~N/A	1684	33	1651
B21R22C02	21-2-22	ERa~N/A	1891	33	1858
B21R22C03	21-3-22	PKCeta~N/A	180	83	97
B21R22C04	21-4-22	PKCeta~N/A	200	35	165
B21R22C05	21-5-22	Calmodulin~N/A	82	37	45
B21R22C06	21-6-22	Calmodulin~N/A	51	34	17
B21R22C07	21-7-22	V5control5~N/A	1190	34	1156
B21R22C08	21-8-22	V5control5~N/A	1146	34	1112
B21R22C09	21-9-22	V5control4~N/A	123	59	64
B21R22C10	21-10-22	V5control4~N/A	112	50	62
B21R22C11	21-11-22	V5control3~N/A	60	34	26
B21R22C12	21-12-22	V5control3~N/A	79	46	33
B21R22C13	21-13-22	V5control2~N/A	71	41	30
B21R22C14	21-14-22	V5control2~N/A	60	42	18
B21R22C15	21-15-22	V5control1~N/A	35	34	1
B21R22C16	21-16-22	V5control1~N/A	37	34	3
B21R22C17	21-17-22	CMK2A~N/A	590	34	556
B21R22C18	21-18-22	CMK2A~N/A	610	35	575
B21R22C19	21-19-22	ERa~N/A	1794	35	1759
B21R22C20	21-20-22	ERa~N/A	1603	35	1568
B21R22C21	21-21-22	AlexaAntiMouseAb~N/A	8838	36	8802
B21R22C22	21-22-22	AlexaAntiMouseAb~N/A	8287	36	8251
B22R01C01	22-1-1	AlexaAntiMouseAb~N/A	33554	38	33516
B22R01C02	22-2-1	AlexaAntiMouseAb~N/A	32709	37	32672
B22R01C03	22-3-1	ERa~N/A	1363	37	1326
B22R01C04	22-4-1	ERa~N/A	1302	40	1262
B22R01C05	22-5-1	HumanIgG1~N/A	1277	40	1237
B22R01C06	22-6-1	HumanIgG1~N/A	1106	40	1066
B22R01C07	22-7-1	HumanIgG2~N/A	3738	44	3694
B22R01C08	22-8-1	HumanIgG2~N/A	2969	73	2896
B22R01C09	22-9-1	HumanIgG3~N/A	16636	75	16561
B22R01C10	22-10-1	HumanIgG3~N/A	14727	57	14670
B22R01C11	22-11-1	HumanIgG4~N/A	47214	51	47163
B22R01C12	22-12-1	HumanIgG4~N/A	42447	49	42398
B22R01C13	22-13-1	BiotinAb~N/A	392	48	344
B22R01C14	22-14-1	BiotinAb~N/A	460	51	409
B22R01C15	22-15-1	RanBP2deltaFG~N/A	312	80	232
B22R01C16	22-16-1	RanBP2deltaFG~N/A	294	42	252
B22R01C17	22-17-1	hMDM2~N/A	767	42	725
B22R01C18	22-18-1	hMDM2~N/A	682	42	640
B22R01C19	22-19-1	PKCeta~N/A	366	44	322
B22R01C20	22-20-1	PKCeta~N/A	350	45	305
B22R01C21	22-21-1	AlexaAntiMouseAb~N/A	42368	42	42326
B22R01C22	22-22-1	AlexaAntiMouseAb~N/A	34154	42	34112
B22R02C01	22-1-2	PKCeta~N/A	786	37	749
B22R02C02	22-2-2	PKCeta~N/A	749	37	712
B22R02C03	22-3-2	Buffer	221	39	182
B22R02C04	22-4-2	Buffer	202	42	160
B22R02C05	22-5-2	HumanIgA~N/A	21099	41	21058
B22R02C06	22-6-2	HumanIgA~N/A	29635	46	29589
B22R02C07	22-7-2	Buffer	172	58	114
B22R02C08	22-8-2	Buffer	88	75	13
B22R02C09	22-9-2	BSA~N/A	14305	78	14227
B22R02C10	22-10-2	BSA~N/A	13535	58	13477
B22R02C11	22-11-2	Hs~MGC:BC005944.1~uORF:IOH7504	668	49	619
B22R02C12	22-12-2	Hs~MGC:BC005944.1~uORF:IOH7504	690	48	642
B22R02C13	22-13-2	Hs~Ref:NM_018047.1~uORF:IOH3012	949	55	894
B22R02C14	22-14-2	Hs~Ref:NM_018047.1~uORF:IOH3012	937	60	877
B22R02C15	22-15-2	Hs~MGC:BC013116.1~uORF:IOH28618	1859	52	1807
B22R02C16	22-16-2	Hs~MGC:BC013116.1~uORF:IOH28618	1704	47	1657
B22R02C17	22-17-2	Hs~Ref:NM_012316.2~uORF:IOH10787	1619	43	1576
B22R02C18	22-18-2	Hs~Ref:NM_012316.2~uORF:IOH10787	1598	42	1556
B22R02C19	22-19-2	Hs~MGC:BC012341.1~uORF:IOH12496	256	44	212
B22R02C20	22-20-2	Hs~MGC:BC012341.1~uORF:IOH12496	292	46	246
B22R02C21	22-21-2	Hs~Ref:NM_014876.1~uORF:IOH10136	834	45	789
B22R02C22	22-22-2	Hs~Ref:NM_014876.1~uORF:IOH10136	754	44	710
B22R03C01	22-1-3	Hs~MGC:BC025383.2~uORF:IOH11203	755	35	720
B22R03C02	22-2-3	Hs~MGC:BC025383.2~uORF:IOH11203	770	36	734
B22R03C03	22-3-3	Hs~Ref:NM_025193.2~uORF:IOH5538	664	39	625
B22R03C04	22-4-3	Hs~Ref:NM_025193.2~uORF:IOH5538	794	42	752
B22R03C05	22-5-3	Hs~MGC:BC067521.1~uORF:IOH40152	279	40	239
B22R03C06	22-6-3	Hs~MGC:BC067521.1~uORF:IOH40152	285	52	233
B22R03C07	22-7-3	Hs~Ref:NM_018697.3~uORF:IOH37734	508	79	429
B22R03C08	22-8-3	Hs~Ref:NM_018697.3~uORF:IOH37734	562	98	464
B22R03C09	22-9-3	Hs~Ref:NM_000412.2~uORF:IOH40314	175	81	94
B22R03C10	22-10-3	Hs~Ref:NM_000412.2~uORF:IOH40314	159	61	98
B22R03C11	22-11-3	Hs~Ref:NM_198151.1~uORF:IOH37735	284	49	235
B22R03C12	22-12-3	Hs~Ref:NM_198151.1~uORF:IOH37735	338	56	282
B22R03C13	22-13-3	Hs~Ref:NM_130844.1~uORF:IOH41300	411	57	354
B22R03C14	22-14-3	Hs~Ref:NM_130844.1~uORF:IOH41300	592	59	533
B22R03C15	22-15-3	Hs~Ref:NM_002624.2~uORF:IOH45929	3802	56	3746
B22R03C16	22-16-3	Hs~Ref:NM_002624.2~uORF:IOH45929	3838	45	3793
B22R03C17	22-17-3	Hs~Ref:NM_178850.1~uORF:IOH35720	322	40	282
B22R03C18	22-18-3	Hs~Ref:NM_178850.1~uORF:IOH35720	353	40	313
B22R03C19	22-19-3	Hs~Ref:NM_153752.1~uORF:IOH34931	297	44	253
B22R03C20	22-20-3	Hs~Ref:NM_153752.1~uORF:IOH34931	359	72	287
B22R03C21	22-21-3	Hs~Ref:NM_012419.3~uORF:IOH11052	251	49	202
B22R03C22	22-22-3	Hs~Ref:NM_012419.3~uORF:IOH11052	311	179	132
B22R04C01	22-1-4	Hs~MGC:BC015667.2~uORF:IOH14654	416	36	380
B22R04C02	22-2-4	Hs~MGC:BC015667.2~uORF:IOH14654	396	39	357
B22R04C03	22-3-4	Hs~Ref:NM_002963.2~uORF:IOH22174	286	53	233
B22R04C04	22-4-4	Hs~Ref:NM_002963.2~uORF:IOH22174	288	60	228
B22R04C05	22-5-4	Hs~MGC:NM_182615.1~uORF:IOH21533	294	40	254
B22R04C06	22-6-4	Hs~MGC:NM_182615.1~uORF:IOH21533	433	55	378
B22R04C07	22-7-4	Hs~Ref:NM_016305.1~uORF:IOH12915	234	87	147
B22R04C08	22-8-4	Hs~Ref:NM_016305.1~uORF:IOH12915	414	162	252
B22R04C09	22-9-4	Hs~Ref:NM_002194.2~uORF:IOH10347	200	90	110
B22R04C10	22-10-4	Hs~Ref:NM_002194.2~uORF:IOH10347	187	68	119
B22R04C11	22-11-4	Hs~MGC:BC001964.1~uORF:IOH3201	584	52	532
B22R04C12	22-12-4	Hs~MGC:BC001964.1~uORF:IOH3201	477	55	422
B22R04C13	22-13-4	Hs~MGC:BC016614.1~uORF:IOH9750	494	49	445
B22R04C14	22-14-4	Hs~MGC:BC016614.1~uORF:IOH9750	553	51	502
B22R04C15	22-15-4	Hs~MGC:BC036123.1~uORF:IOH27289	931	43	888
B22R04C16	22-16-4	Hs~MGC:BC036123.1~uORF:IOH27289	898	42	856
B22R04C17	22-17-4	Hs~Ref:NM_014011.4~uORF:IOH37917	474	42	432
B22R04C18	22-18-4	Hs~Ref:NM_014011.4~uORF:IOH37917	451	41	410
B22R04C19	22-19-4	Hs~Ref:NM_052910.1~uORF:IOH38183	326	43	283
B22R04C20	22-20-4	Hs~Ref:NM_052910.1~uORF:IOH38183	398	56	342
B22R04C21	22-21-4	Hs~Ref:NM_174912.2~uORF:IOH37910	252	48	204
B22R04C22	22-22-4	Hs~Ref:NM_174912.2~uORF:IOH37910	420	55	365
B22R05C01	22-1-5	Hs~MGC:BC017786.1~uORF:IOH12194	429	36	393
B22R05C02	22-2-5	Hs~MGC:BC017786.1~uORF:IOH12194	476	41	435
B22R05C03	22-3-5	Hs~MGC:BC017780.1~uORF:IOH12140	249	82	167
B22R05C04	22-4-5	Hs~MGC:BC017780.1~uORF:IOH12140	328	61	267
B22R05C05	22-5-5	Hs~MGC:BC020630.1~uORF:IOH12113	371	43	328
B22R05C06	22-6-5	Hs~MGC:BC020630.1~uORF:IOH12113	427	59	368
B22R05C07	22-7-5	Hs~MGC:BC022405.1~uORF:IOH13019	365	84	281
B22R05C08	22-8-5	Hs~MGC:BC022405.1~uORF:IOH13019	528	105	423
B22R05C09	22-9-5	Hs~Ref:NM_004721.2~N/A	349	83	266
B22R05C10	22-10-5	Hs~Ref:NM_004721.2~N/A	493	100	393
B22R05C11	22-11-5	Hs~Ref:NM_006852.1~N/A	556	54	502
B22R05C12	22-12-5	Hs~Ref:NM_006852.1~N/A	577	51	526
B22R05C13	22-13-5	Hs~Ref:NM_006035.2~N/A	430	52	378
B22R05C14	22-14-5	Hs~Ref:NM_006035.2~N/A	480	118	362
B22R05C15	22-15-5	Hs~Ref:NM_003821.2~N/A	386	46	340
B22R05C16	22-16-5	Hs~Ref:NM_003821.2~N/A	396	45	351
B22R05C17	22-17-5	Hs~Ref:NM_207330.1~uORF:IOH40144	630	46	584
B22R05C18	22-18-5	Hs~Ref:NM_207330.1~uORF:IOH40144	621	44	577
B22R05C19	22-19-5	Hs~Ref:NM_002288.3~uORF:IOH40239	340	46	294
B22R05C20	22-20-5	Hs~Ref:NM_002288.3~uORF:IOH40239	343	56	287
B22R05C21	22-21-5	Hs~Ref:NM_004040.2~uORF:IOH40092	357	230	127
B22R05C22	22-22-5	Hs~Ref:NM_004040.2~uORF:IOH40092	311	56	255
B22R06C01	22-1-6	Hs~MGC:NM_152596.2~uORF:IOH40199	1090	37	1053
B22R06C02	22-2-6	Hs~MGC:NM_152596.2~uORF:IOH40199	1130	39	1091
B22R06C03	22-3-6	Hs~MGC:BC017344.1~uORF:IOH13180	1223	48	1175
B22R06C04	22-4-6	Hs~MGC:BC017344.1~uORF:IOH13180	1157	46	1111
B22R06C05	22-5-6	Hs~MGC:BC029424.1~uORF:IOH23140	1369	42	1327
B22R06C06	22-6-6	Hs~MGC:BC029424.1~uORF:IOH23140	1545	55	1490
B22R06C07	22-7-6	Hs~Ref:NM_019067.1~uORF:IOH13693	1521	97	1424
B22R06C08	22-8-6	Hs~Ref:NM_019067.1~uORF:IOH13693	1722	112	1610
B22R06C09	22-9-6	Hs~MGC:BC006104.1~uORF:IOH6588	894	90	804
B22R06C10	22-10-6	Hs~MGC:BC006104.1~uORF:IOH6588	841	77	764
B22R06C11	22-11-6	Hs~Ref:NM_003179.2~uORF:IOH54998	459	56	403
B22R06C12	22-12-6	Hs~Ref:NM_003179.2~uORF:IOH54998	406	54	352
B22R06C13	22-13-6	Hs~MGC:BC035582.1~uORF:IOH27620	756	52	704
B22R06C14	22-14-6	Hs~MGC:BC035582.1~uORF:IOH27620	738	53	685
B22R06C15	22-15-6	Hs~Ref:NM_001009922.1~uORF:IOH54862	455	59	396
B22R06C16	22-16-6	Hs~Ref:NM_001009922.1~uORF:IOH54862	414	46	368
B22R06C17	22-17-6	Hs~Ref:NM_138960.3~uORF:IOH59763	567	46	521
B22R06C18	22-18-6	Hs~Ref:NM_138960.3~uORF:IOH59763	533	45	488
B22R06C19	22-19-6	Hs~Ref:NM_024638.2~uORF:IOH22191	473	45	428
B22R06C20	22-20-6	Hs~Ref:NM_024638.2~uORF:IOH22191	453	44	409
B22R06C21	22-21-6	Hs~MGC:BC007767.2~uORF:IOH6486	416	59	357
B22R06C22	22-22-6	Hs~MGC:BC007767.2~uORF:IOH6486	461	235	226
B22R07C01	22-1-7	Hs~Ref:NM_173487.1~uORF:IOH21933	399	37	362
B22R07C02	22-2-7	Hs~Ref:NM_173487.1~uORF:IOH21933	410	38	372
B22R07C03	22-3-7	Hs~Ref:NM_004001.3~uORF:IOH22175	469	39	430
B22R07C04	22-4-7	Hs~Ref:NM_004001.3~uORF:IOH22175	382	40	342
B22R07C05	22-5-7	Hs~MGC:BC005932.1~uORF:IOH7557	1072	39	1033
B22R07C06	22-6-7	Hs~MGC:BC005932.1~uORF:IOH7557	1087	47	1040
B22R07C07	22-7-7	Hs~Ref:NM_015922.1~uORF:IOH4468	901	107	794
B22R07C08	22-8-7	Hs~Ref:NM_015922.1~uORF:IOH4468	609	560	49
B22R07C09	22-9-7	Hs~MGC:BC000682.1~uORF:IOH4327	371	104	267
B22R07C10	22-10-7	Hs~MGC:BC000682.1~uORF:IOH4327	334	103	231
B22R07C11	22-11-7	Hs~Ref:NM_003893.2~uORF:IOH3707	499	56	443
B22R07C12	22-12-7	Hs~Ref:NM_003893.2~uORF:IOH3707	511	50	461
B22R07C13	22-13-7	Hs~Ref:NM_025106.2~uORF:IOH10100	763	48	715
B22R07C14	22-14-7	Hs~Ref:NM_025106.2~uORF:IOH10100	745	47	698
B22R07C15	22-15-7	Hs~MGC:BC015467.1~uORF:IOH10437	631	46	585
B22R07C16	22-16-7	Hs~MGC:BC015467.1~uORF:IOH10437	615	44	571
B22R07C17	22-17-7	Hs~Ref:NM_005727.2~uORF:IOH6907	359	45	314
B22R07C18	22-18-7	Hs~Ref:NM_005727.2~uORF:IOH6907	426	45	381
B22R07C19	22-19-7	Hs~MGC:BC012377.1~uORF:IOH10489	536	41	495
B22R07C20	22-20-7	Hs~MGC:BC012377.1~uORF:IOH10489	424	43	381
B22R07C21	22-21-7	Hs~MGC:BC035687.1~uORF:IOH26040	279	54	225
B22R07C22	22-22-7	Hs~MGC:BC035687.1~uORF:IOH26040	339	142	197
B22R08C01	22-1-8	Hs~Ref:NM_025126.2~uORF:IOH6675	230	42	188
B22R08C02	22-2-8	Hs~Ref:NM_025126.2~uORF:IOH6675	241	105	136
B22R08C03	22-3-8	Hs~MGC:BC000879.1~uORF:IOH3208	375	44	331
B22R08C04	22-4-8	Hs~MGC:BC000879.1~uORF:IOH3208	302	45	257
B22R08C05	22-5-8	Hs~Ref:NM_000198.2~uORF:IOH27459	252	41	211
B22R08C06	22-6-8	Hs~Ref:NM_000198.2~uORF:IOH27459	220	40	180
B22R08C07	22-7-8	Hs~Ref:NM_014790.3~uORF:IOH14698	1800	62	1738
B22R08C08	22-8-8	Hs~Ref:NM_014790.3~uORF:IOH14698	1762	91	1671
B22R08C09	22-9-8	Hs~MGC:BC017180.2~uORF:IOH12250	778	85	693
B22R08C10	22-10-8	Hs~MGC:BC017180.2~uORF:IOH12250	738	72	666
B22R08C11	22-11-8	Hs~Ref:NM_012138.2~uORF:IOH4275	417	56	361
B22R08C12	22-12-8	Hs~Ref:NM_012138.2~uORF:IOH4275	244	49	195
B22R08C13	22-13-8	Hs~Ref:NM_003334.2~uORF:IOH22897	441	51	390
B22R08C14	22-14-8	Hs~Ref:NM_003334.2~uORF:IOH22897	354	55	299
B22R08C15	22-15-8	Hs~Ref:NM_181531.1~uORF:IOH44638	734	48	686
B22R08C16	22-16-8	Hs~Ref:NM_181531.1~uORF:IOH44638	692	47	645
B22R08C17	22-17-8	Hs~Ref:NM_144664.3~uORF:IOH45592	2221	45	2176
B22R08C18	22-18-8	Hs~Ref:NM_144664.3~uORF:IOH45592	2142	43	2099
B22R08C19	22-19-8	Hs~Ref:NM_014249.2~uORF:IOH34779	741	42	699
B22R08C20	22-20-8	Hs~Ref:NM_014249.2~uORF:IOH34779	733	42	691
B22R08C21	22-21-8	Hs~Ref:NM_152392.1~uORF:IOH42004	619	43	576
B22R08C22	22-22-8	Hs~Ref:NM_152392.1~uORF:IOH42004	663	42	621
B22R09C01	22-1-9	Hs~Ref:NM_006949.1~uORF:IOH52408	457	43	414
B22R09C02	22-2-9	Hs~Ref:NM_006949.1~uORF:IOH52408	430	47	383
B22R09C03	22-3-9	Hs~Ref:NM_002628.3~uORF:IOH58968	2464	47	2417
B22R09C04	22-4-9	Hs~Ref:NM_002628.3~uORF:IOH58968	2577	44	2533
B22R09C05	22-5-9	Hs~Ref:NM_033516.4~uORF:IOH59879	258	40	218
B22R09C06	22-6-9	Hs~Ref:NM_033516.4~uORF:IOH59879	278	44	234
B22R09C07	22-7-9	Hs~Ref:NM_001003701.1~uORF:IOH58645	274	54	220
B22R09C08	22-8-9	Hs~Ref:NM_001003701.1~uORF:IOH58645	254	91	163
B22R09C09	22-9-9	Hs~Ref:NM_005277.3~uORF:IOH55974	303	158	145
B22R09C10	22-10-9	Hs~Ref:NM_005277.3~uORF:IOH55974	499	80	419
B22R09C11	22-11-9	Hs~Ref:NM_001003683.1~uORF:IOH52231	994	52	942
B22R09C12	22-12-9	Hs~Ref:NM_001003683.1~uORF:IOH52231	1043	48	995
B22R09C13	22-13-9	Hs~Ref:NM_005431.1~uORF:IOH57264	213	48	165
B22R09C14	22-14-9	Hs~Ref:NM_005431.1~uORF:IOH57264	207	49	158
B22R09C15	22-15-9	Hs~Ref:NM_015599.1~uORF:IOH55441	488	47	441
B22R09C16	22-16-9	Hs~Ref:NM_015599.1~uORF:IOH55441	514	48	466
B22R09C17	22-17-9	Hs~MGC:BC009009.1~uORF:IOH3263	282	46	236
B22R09C18	22-18-9	Hs~MGC:BC009009.1~uORF:IOH3263	301	45	256
B22R09C19	22-19-9	Hs~MGC:BC009025.1~uORF:IOH3311	333	48	285
B22R09C20	22-20-9	Hs~MGC:BC009025.1~uORF:IOH3311	242	48	194
B22R09C21	22-21-9	Hs~Ref:NM_015449.1~uORF:IOH3953	175	49	126
B22R09C22	22-22-9	Hs~Ref:NM_015449.1~uORF:IOH3953	239	53	186
B22R10C01	22-1-10	Hs~Ref:NM_001757.1~uORF:IOH3944	406	42	364
B22R10C02	22-2-10	Hs~Ref:NM_001757.1~uORF:IOH3944	417	42	375
B22R10C03	22-3-10	Hs~Ref:NM_022157.2~uORF:IOH11175	1021	41	980
B22R10C04	22-4-10	Hs~Ref:NM_022157.2~uORF:IOH11175	967	39	928
B22R10C05	22-5-10	Hs~MGC:BC032400.1~uORF:IOH21693	487	41	446
B22R10C06	22-6-10	Hs~MGC:BC032400.1~uORF:IOH21693	518	43	475
B22R10C07	22-7-10	Hs~MGC:BC033731.1~uORF:IOH21804	398	56	342
B22R10C08	22-8-10	Hs~MGC:BC033731.1~uORF:IOH21804	510	402	108
B22R10C09	22-9-10	Hs~Ref:NM_133375.2~uORF:IOH13442	766	91	675
B22R10C10	22-10-10	Hs~Ref:NM_133375.2~uORF:IOH13442	657	70	587
B22R10C11	22-11-10	GST1	51	48	3
B22R10C12	22-12-10	GST1	63	44	19
B22R10C13	22-13-10	GST2	49	44	5
B22R10C14	22-14-10	GST2	49	44	5
B22R10C15	22-15-10	GST3	51	46	5
B22R10C16	22-16-10	GST3	47	43	4
B22R10C17	22-17-10	GST4	58	42	16
B22R10C18	22-18-10	GST4	113	53	60
B22R10C19	22-19-10	Anti-HumanIgA1~N/A	10172	43	10129
B22R10C20	22-20-10	Anti-HumanIgA1~N/A	9130	44	9086
B22R10C21	22-21-10	Anti-HumanIgA2~N/A	17411	45	17366
B22R10C22	22-22-10	Anti-HumanIgA2~N/A	15911	42	15869
B22R11C01	22-1-11	AlexaAntiMouseAb~N/A	21185	48	21137
B22R11C02	22-2-11	AlexaAntiMouseAb~N/A	23891	50	23841
B22R11C03	22-3-11	MAPKAP~N/A	82	37	45
B22R11C04	22-4-11	MAPKAP~N/A	73	38	35
B22R11C05	22-5-11	Buffer	106	39	67
B22R11C06	22-6-11	Buffer	109	38	71
B22R11C07	22-7-11	BSA~N/A	11114	47	11067
B22R11C08	22-8-11	BSA~N/A	10608	80	10528
B22R11C09	22-9-11	Anti-HumanIgG1~N/A	2566	84	2482
B22R11C10	22-10-11	Anti-HumanIgG1~N/A	2063	65	1998
B22R11C11	22-11-11	Anti-HumanIgG2~N/A	4408	48	4360
B22R11C12	22-12-11	Anti-HumanIgG2~N/A	4019	43	3976
B22R11C13	22-13-11	Anti-HumanIgG3~N/A	7039	43	6996
B22R11C14	22-14-11	Anti-HumanIgG3~N/A	6638	43	6595
B22R11C15	22-15-11	Anti-HumanIgG4~N/A	11999	43	11956
B22R11C16	22-16-11	Anti-HumanIgG4~N/A	11562	42	11520
B22R11C17	22-17-11	AntiBiotinAb~N/A	13914	40	13874
B22R11C18	22-18-11	AntiBiotinAb~N/A	14581	39	14542
B22R11C19	22-19-11	Buffer	58	40	18
B22R11C20	22-20-11	Buffer	87	46	41
B22R11C21	22-21-11	Hs~Ref:NM_006827.2~uORF:IOH5148	497	41	456
B22R11C22	22-22-11	Hs~Ref:NM_006827.2~uORF:IOH5148	555	41	514
B22R12C01	22-1-12	Hs~Ref:NM_015640.1~uORF:IOH22934	7728	47	7681
B22R12C02	22-2-12	Hs~Ref:NM_015640.1~uORF:IOH22934	7089	67	7022
B22R12C03	22-3-12	Hs~MGC:NM_152238.1~uORF:IOH10394	575	57	518
B22R12C04	22-4-12	Hs~MGC:NM_152238.1~uORF:IOH10394	580	53	527
B22R12C05	22-5-12	Hs~Ref:NM_031311.2~uORF:IOH10663	684	43	641
B22R12C06	22-6-12	Hs~Ref:NM_031311.2~uORF:IOH10663	681	43	638
B22R12C07	22-7-12	Hs~Ref:NM_005792.1~uORF:IOH7199	879	51	828
B22R12C08	22-8-12	Hs~Ref:NM_005792.1~uORF:IOH7199	1020	89	931
B22R12C09	22-9-12	Hs~MGC:BC014146.2~uORF:IOH12774	644	101	543
B22R12C10	22-10-12	Hs~MGC:BC014146.2~uORF:IOH12774	609	82	527
B22R12C11	22-11-12	Hs~MGC:BC007003.1~uORF:IOH7198	689	55	634
B22R12C12	22-12-12	Hs~MGC:BC007003.1~uORF:IOH7198	690	47	643
B22R12C13	22-13-12	Hs~Ref:NM_020375.1~uORF:IOH13360	585	47	538
B22R12C14	22-14-12	Hs~Ref:NM_020375.1~uORF:IOH13360	630	46	584
B22R12C15	22-15-12	Hs~Ref:NM_032407.1~uORF:IOH36224	1138	41	1097
B22R12C16	22-16-12	Hs~Ref:NM_032407.1~uORF:IOH36224	1042	42	1000
B22R12C17	22-17-12	Hs~Ref:NM_024587.2~uORF:IOH39908	90	41	49
B22R12C18	22-18-12	Hs~Ref:NM_024587.2~uORF:IOH39908	95	40	55
B22R12C19	22-19-12	Hs~Ref:NM_080870.2~uORF:IOH40303	224	47	177
B22R12C20	22-20-12	Hs~Ref:NM_080870.2~uORF:IOH40303	194	45	149
B22R12C21	22-21-12	Hs~Ref:NM_017873.2~uORF:IOH39877	110	44	66
B22R12C22	22-22-12	Hs~Ref:NM_017873.2~uORF:IOH39877	184	72	112
B22R13C01	22-1-13	Hs~Ref:NM_030572.1~uORF:IOH5547	387	37	350
B22R13C02	22-2-13	Hs~Ref:NM_030572.1~uORF:IOH5547	421	41	380
B22R13C03	22-3-13	Hs~MGC:BC021189.2~uORF:IOH22437	839	54	785
B22R13C04	22-4-13	Hs~MGC:BC021189.2~uORF:IOH22437	835	56	779
B22R13C05	22-5-13	Hs~Ref:NM_021974.2~uORF:IOH4971	195	54	141
B22R13C06	22-6-13	Hs~Ref:NM_021974.2~uORF:IOH4971	208	83	125
B22R13C07	22-7-13	Hs~MGC:BC011680.1~uORF:IOH14815	372	119	253
B22R13C08	22-8-13	Hs~MGC:BC011680.1~uORF:IOH14815	322	122	200
B22R13C09	22-9-13	Hs~MGC:BC033792.1~uORF:IOH21794	8124	100	8024
B22R13C10	22-10-13	Hs~MGC:BC033792.1~uORF:IOH21794	7907	79	7828
B22R13C11	22-11-13	Hs~MGC:BC008819.1~uORF:IOH6323	562	61	501
B22R13C12	22-12-13	Hs~MGC:BC008819.1~uORF:IOH6323	540	54	486
B22R13C13	22-13-13	Hs~Ref:NM_004794.1~uORF:IOH4780	345	60	285
B22R13C14	22-14-13	Hs~Ref:NM_004794.1~uORF:IOH4780	324	53	271
B22R13C15	22-15-13	Hs~Ref:NM_001136.2~uORF:IOH12890	411	45	366
B22R13C16	22-16-13	Hs~Ref:NM_001136.2~uORF:IOH12890	519	313	206
B22R13C17	22-17-13	Hs~MGC:BC041769.1~uORF:IOH28631	634	45	589
B22R13C18	22-18-13	Hs~MGC:BC041769.1~uORF:IOH28631	591	45	546
B22R13C19	22-19-13	Hs~Ref:NM_004732.1~uORF:IOH29581	253	74	179
B22R13C20	22-20-13	Hs~Ref:NM_004732.1~uORF:IOH29581	242	63	179
B22R13C21	22-21-13	Hs~Ref:NM_002753.2~uORF:IOH29657	188	47	141
B22R13C22	22-22-13	Hs~Ref:NM_002753.2~uORF:IOH29657	295	49	246
B22R14C01	22-1-14	Hs~MGC:BC053320.1~uORF:IOH29401	277	38	239
B22R14C02	22-2-14	Hs~MGC:BC053320.1~uORF:IOH29401	260	56	204
B22R14C03	22-3-14	Hs~Ref:NM_006601.4~uORF:IOH5048	505	40	465
B22R14C04	22-4-14	Hs~Ref:NM_006601.4~uORF:IOH5048	569	42	527
B22R14C05	22-5-14	Hs~Ref:NM_018357.2~uORF:IOH6558	926	48	878
B22R14C06	22-6-14	Hs~Ref:NM_018357.2~uORF:IOH6558	824	55	769
B22R14C07	22-7-14	Hs~Ref:NM_018297.2~uORF:IOH6809	1569	121	1448
B22R14C08	22-8-14	Hs~Ref:NM_018297.2~uORF:IOH6809	1895	111	1784
B22R14C09	22-9-14	Hs~Ref:NM_031429.1~uORF:IOH6550	784	85	699
B22R14C10	22-10-14	Hs~Ref:NM_031429.1~uORF:IOH6550	766	74	692
B22R14C11	22-11-14	Hs~Ref:NM_002623.2~uORF:IOH12205	175	64	111
B22R14C12	22-12-14	Hs~Ref:NM_002623.2~uORF:IOH12205	261	59	202
B22R14C13	22-13-14	Hs~Ref:NM_017838.2~uORF:IOH4642	773	57	716
B22R14C14	22-14-14	Hs~Ref:NM_017838.2~uORF:IOH4642	805	48	757
B22R14C15	22-15-14	Hs~Ref:NM_006319.2~uORF:IOH4047	212	45	167
B22R14C16	22-16-14	Hs~Ref:NM_006319.2~uORF:IOH4047	325	177	148
B22R14C17	22-17-14	Hs~MGC:BC030280.1~uORF:IOH21522	274	58	216
B22R14C18	22-18-14	Hs~MGC:BC030280.1~uORF:IOH21522	313	44	269
B22R14C19	22-19-14	Hs~MGC:BC053840.1~uORF:IOH29362	404	50	354
B22R14C20	22-20-14	Hs~MGC:BC053840.1~uORF:IOH29362	488	68	420
B22R14C21	22-21-14	Hs~Ref:NM_005536.2~uORF:IOH21098	364	52	312
B22R14C22	22-22-14	Hs~Ref:NM_005536.2~uORF:IOH21098	392	44	348
B22R15C01	22-1-15	Hs~MGC:BC010358.1~uORF:IOH14272	311	38	273
B22R15C02	22-2-15	Hs~MGC:BC010358.1~uORF:IOH14272	278	40	238
B22R15C03	22-3-15	Hs~MGC:BC025703.1~uORF:IOH11991	374	39	335
B22R15C04	22-4-15	Hs~MGC:BC025703.1~uORF:IOH11991	434	41	393
B22R15C05	22-5-15	Hs~Ref:NM_004571.3~uORF:IOH6384	2661	42	2619
B22R15C06	22-6-15	Hs~Ref:NM_004571.3~uORF:IOH6384	2869	42	2827
B22R15C07	22-7-15	Hs~Ref:NM_030768.2~uORF:IOH12865	1100	50	1050
B22R15C08	22-8-15	Hs~Ref:NM_030768.2~uORF:IOH12865	1180	68	1112
B22R15C09	22-9-15	Hs~Ref:NM_004064.2~uORF:IOH1795	409	88	321
B22R15C10	22-10-15	Hs~Ref:NM_004064.2~uORF:IOH1795	453	119	334
B22R15C11	22-11-15	Hs~MGC:BC016057.1~uORF:IOH12761	586	76	510
B22R15C12	22-12-15	Hs~MGC:BC016057.1~uORF:IOH12761	538	54	484
B22R15C13	22-13-15	Hs~IVGN:PM_2127~Ext:CTL2127~N/A	86	54	32
B22R15C14	22-14-15	Hs~IVGN:PM_2127~Ext:CTL2127~N/A	168	49	119
B22R15C15	22-15-15	Hs~Ref:NM_003668.2~CAT:PV3301	190	45	145
B22R15C16	22-16-15	Hs~Ref:NM_003668.2~CAT:PV3301	305	185	120
B22R15C17	22-17-15	Hs~Ref:NM_002740.1~CAT:PV3186	130	61	69
B22R15C18	22-18-15	Hs~Ref:NM_002740.1~CAT:PV3186	187	43	144
B22R15C19	22-19-15	Hs~Ref:NM_016231.2~CAT:PV4309	318	94	224
B22R15C20	22-20-15	Hs~Ref:NM_016231.2~CAT:PV4309	194	45	149
B22R15C21	22-21-15	Hs~N/A:NM_006206.3~CAT:PV3847	202	44	158
B22R15C22	22-22-15	Hs~N/A:NM_006206.3~CAT:PV3847	331	43	288
B22R16C01	22-1-16	Hs~Ref:NM_030662.2~CAT:PV3615	288	36	252
B22R16C02	22-2-16	Hs~Ref:NM_030662.2~CAT:PV3615	297	37	260
B22R16C03	22-3-16	Hs~Ref:NM_032960.2~CAT:PV3317	264	38	226
B22R16C04	22-4-16	Hs~Ref:NM_032960.2~CAT:PV3317	336	136	200
B22R16C05	22-5-16	Hs~Ref:NM_006119.2~CAT_PHG0276	497	43	454
B22R16C06	22-6-16	Hs~Ref:NM_006119.2~CAT_PHG0276	432	39	393
B22R16C07	22-7-16	Hs~MGC:BC062732.1~uORF:IOH62856	65535	44	65491
B22R16C08	22-8-16	Hs~MGC:BC062732.1~uORF:IOH62856	65535	57	65478
B22R16C09	22-9-16	Hs~MGC:BC073782.1~uORF:IOH63084	65535	76	65459
B22R16C10	22-10-16	Hs~MGC:BC073782.1~uORF:IOH63084	65535	89	65446
B22R16C11	22-11-16	Hs~MGC:BC002867.1~uORF:IOH62905	306	67	239
B22R16C12	22-12-16	Hs~MGC:BC002867.1~uORF:IOH62905	331	52	279
B22R16C13	22-13-16	Hs~MGC:BC071758.1~uORF:IOH63034	430	224	206
B22R16C14	22-14-16	Hs~MGC:BC071758.1~uORF:IOH63034	294	47	247
B22R16C15	22-15-16	Hs~Ref:NM_021630.4~uORF:IOH57204	731	44	687
B22R16C16	22-16-16	Hs~Ref:NM_021630.4~uORF:IOH57204	726	45	681
B22R16C17	22-17-16	Hs~Ref:NM_006917.3~uORF:IOH57197	608	45	563
B22R16C18	22-18-16	Hs~Ref:NM_006917.3~uORF:IOH57197	567	44	523
B22R16C19	22-19-16	Hs~MGC:BC100982.2~uORF:IOH63388	222	47	175
B22R16C20	22-20-16	Hs~MGC:BC100982.2~uORF:IOH63388	296	94	202
B22R16C21	22-21-16	Hs~Ref:NM_004044.4~uORF:IOH57030	248	49	199
B22R16C22	22-22-16	Hs~Ref:NM_004044.4~uORF:IOH57030	367	66	301
B22R17C01	22-1-17	Hs~MGC:BC033014.1~uORF:IOH62066	206	37	169
B22R17C02	22-2-17	Hs~MGC:BC033014.1~uORF:IOH62066	237	49	188
B22R17C03	22-3-17	Hs~MGC:BC093978.1~uORF:IOH62016	244	100	144
B22R17C04	22-4-17	Hs~MGC:BC093978.1~uORF:IOH62016	136	37	99
B22R17C05	22-5-17	Hs~MGC:BC037845.1~uORF:IOH62213	415	112	303
B22R17C06	22-6-17	Hs~MGC:BC037845.1~uORF:IOH62213	408	42	366
B22R17C07	22-7-17	Hs~Ref:NM_001004419.1~uORF:IOH59666	317	43	274
B22R17C08	22-8-17	Hs~Ref:NM_001004419.1~uORF:IOH59666	345	51	294
B22R17C09	22-9-17	Hs~MGC:BC005876.1~uORF:IOH6081	326	74	252
B22R17C10	22-10-17	Hs~MGC:BC005876.1~uORF:IOH6081	339	83	256
B22R17C11	22-11-17	Hs~MGC:BC006793.1~uORF:IOH3184	527	79	448
B22R17C12	22-12-17	Hs~MGC:BC006793.1~uORF:IOH3184	477	58	419
B22R17C13	22-13-17	Hs~MGC:BC014307.1~uORF:IOH12074	568	56	512
B22R17C14	22-14-17	Hs~MGC:BC014307.1~uORF:IOH12074	510	46	464
B22R17C15	22-15-17	Hs~Ref:NM_145254.1~uORF:IOH10884	376	45	331
B22R17C16	22-16-17	Hs~Ref:NM_145254.1~uORF:IOH10884	425	87	338
B22R17C17	22-17-17	Hs~Ref:NM_022046.3~uORF:IOH35361	356	43	313
B22R17C18	22-18-17	Hs~Ref:NM_022046.3~uORF:IOH35361	369	41	328
B22R17C19	22-19-17	Hs~Ref:NM_177524.1~uORF:IOH45900	1052	41	1011
B22R17C20	22-20-17	Hs~Ref:NM_177524.1~uORF:IOH45900	1085	43	1042
B22R17C21	22-21-17	Hs~Ref:NM_013264.2~uORF:IOH45462	567	44	523
B22R17C22	22-22-17	Hs~Ref:NM_013264.2~uORF:IOH45462	488	42	446
B22R18C01	22-1-18	Hs~Ref:NM_182503.1~uORF:IOH45446	513	36	477
B22R18C02	22-2-18	Hs~Ref:NM_182503.1~uORF:IOH45446	540	38	502
B22R18C03	22-3-18	Hs~Ref:NM_005408.2~uORF:IOH3315	432	38	394
B22R18C04	22-4-18	Hs~Ref:NM_005408.2~uORF:IOH3315	429	38	391
B22R18C05	22-5-18	Hs~Ref:NM_006644.2~uORF:IOH27526	1103	40	1063
B22R18C06	22-6-18	Hs~Ref:NM_006644.2~uORF:IOH27526	1245	41	1204
B22R18C07	22-7-18	Hs~MGC:BC050329.1~uORF:IOH26431	245	46	199
B22R18C08	22-8-18	Hs~MGC:BC050329.1~uORF:IOH26431	212	85	127
B22R18C09	22-9-18	Hs~Ref:NM_033397.2~uORF:IOH27489	110	79	31
B22R18C10	22-10-18	Hs~Ref:NM_033397.2~uORF:IOH27489	439	122	317
B22R18C11	22-11-18	Hs~MGC:BC037773.1~uORF:IOH25827	521	72	449
B22R18C12	22-12-18	Hs~MGC:BC037773.1~uORF:IOH25827	508	59	449
B22R18C13	22-13-18	Hs~Ref:NM_002744.2~N/A	675	194	481
B22R18C14	22-14-18	Hs~Ref:NM_002744.2~N/A	214	48	166
B22R18C15	22-15-18	Hs~MGC:BC037322.1~uORF:IOH28715	191	46	145
B22R18C16	22-16-18	Hs~MGC:BC037322.1~uORF:IOH28715	182	46	136
B22R18C17	22-17-18	Hs~MGC:BC053872.1~uORF:IOH28961	268	47	221
B22R18C18	22-18-18	Hs~MGC:BC053872.1~uORF:IOH28961	272	47	225
B22R18C19	22-19-18	Hs~Ref:NM_033506.1~uORF:IOH40035	425	49	376
B22R18C20	22-20-18	Hs~Ref:NM_033506.1~uORF:IOH40035	413	220	193
B22R18C21	22-21-18	Hs~Ref:NM_024569.3~uORF:IOH43374	515	50	465
B22R18C22	22-22-18	Hs~Ref:NM_024569.3~uORF:IOH43374	417	42	375
B22R19C01	22-1-19	Hs~Ref:NM_033421.2~uORF:IOH43365	372	36	336
B22R19C02	22-2-19	Hs~Ref:NM_033421.2~uORF:IOH43365	377	37	340
B22R19C03	22-3-19	Hs~Ref:XM_378661.1~uORF:IOH41602	441	39	402
B22R19C04	22-4-19	Hs~Ref:XM_378661.1~uORF:IOH41602	421	41	380
B22R19C05	22-5-19	Hs~Ref:NM_006875.1~N/A	327	70	257
B22R19C06	22-6-19	Hs~Ref:NM_006875.1~N/A	344	47	297
B22R19C07	22-7-19	Hs~MGC:BC016652.1~N/A	544	47	497
B22R19C08	22-8-19	Hs~MGC:BC016652.1~N/A	572	69	503
B22R19C09	22-9-19	Hs~MGC:BC003178.1~uORF:IOH5124	99	69	30
B22R19C10	22-10-19	Hs~MGC:BC003178.1~uORF:IOH5124	913	91	822
B22R19C11	22-11-19	Hs~Ref:NM_003878.1~uORF:IOH25778	519	78	441
B22R19C12	22-12-19	Hs~Ref:NM_003878.1~uORF:IOH25778	534	62	472
B22R19C13	22-13-19	Hs~MGC:BC066958.1~uORF:IOH61486	1554	55	1499
B22R19C14	22-14-19	Hs~MGC:BC066958.1~uORF:IOH61486	1447	49	1398
B22R19C15	22-15-19	Hs~Ref:NM_007102.1~uORF:IOH40405	410	57	353
B22R19C16	22-16-19	Hs~Ref:NM_007102.1~uORF:IOH40405	252	51	201
B22R19C17	22-17-19	Hs~Ref:NM_002357.1~uORF:IOH40302	814	77	737
B22R19C18	22-18-19	Hs~Ref:NM_002357.1~uORF:IOH40302	694	62	632
B22R19C19	22-19-19	Hs~Ref:NM_173622.2~uORF:IOH40872	414	85	329
B22R19C20	22-20-19	Hs~Ref:NM_173622.2~uORF:IOH40872	303	48	255
B22R19C21	22-21-19	Hs~Ref:NM_139164.1~uORF:IOH59717	38	42	-4
B22R19C22	22-22-19	Hs~Ref:NM_139164.1~uORF:IOH59717	39	40	-1
B22R20C01	22-1-20	Hs~Ref:NM_000607.1~uORF:IOH54759	34	35	-1
B22R20C02	22-2-20	Hs~Ref:NM_000607.1~uORF:IOH54759	35	35	0
B22R20C03	22-3-20	Hs~MGC:BC001899.1~uORF:IOH4819	299	42	257
B22R20C04	22-4-20	Hs~MGC:BC001899.1~uORF:IOH4819	362	44	318
B22R20C05	22-5-20	Hs~Ref:NM_078473.1~uORF:IOH1833	219	113	106
B22R20C06	22-6-20	Hs~Ref:NM_078473.1~uORF:IOH1833	259	74	185
B22R20C07	22-7-20	Hs~Ref:NM_004729.3~uORF:IOH55626	749	57	692
B22R20C08	22-8-20	Hs~Ref:NM_004729.3~uORF:IOH55626	342	112	230
B22R20C09	22-9-20	Hs~Ref:NM_005760.2~uORF:IOH22256	117	81	36
B22R20C10	22-10-20	Hs~Ref:NM_005760.2~uORF:IOH22256	447	99	348
B22R20C11	22-11-20	Hs~Ref:NM_032370.1~uORF:IOH6927	227	168	59
B22R20C12	22-12-20	Hs~Ref:NM_032370.1~uORF:IOH6927	311	165	146
B22R20C13	22-13-20	Hs~MGC:BC012172.1~uORF:IOH13314	130	47	83
B22R20C14	22-14-20	Hs~MGC:BC012172.1~uORF:IOH13314	141	55	86
B22R20C15	22-15-20	Hs~Ref:NM_033211.2~uORF:IOH13156	904	46	858
B22R20C16	22-16-20	Hs~Ref:NM_033211.2~uORF:IOH13156	1076	45	1031
B22R20C17	22-17-20	Hs~Ref:NM_199247.1~uORF:IOH43177	3411	53	3358
B22R20C18	22-18-20	Hs~Ref:NM_199247.1~uORF:IOH43177	3467	46	3421
B22R20C19	22-19-20	Hs~Ref:ENST00000376764~uORF:IOH57361	194	44	150
B22R20C20	22-20-20	Hs~Ref:ENST00000376764~uORF:IOH57361	356	134	222
B22R20C21	22-21-20	Hs~Ref:NM_153259.2~uORF:IOH37987	50	53	-3
B22R20C22	22-22-20	Hs~Ref:NM_153259.2~uORF:IOH37987	284	50	234
B22R21C01	22-1-21	Hs~Ref:NM_198719.1~uORF:IOH42375	258	36	222
B22R21C02	22-2-21	Hs~Ref:NM_198719.1~uORF:IOH42375	284	37	247
B22R21C03	22-3-21	Hs~Ref:NM_138300.3~uORF:IOH22981	2494	40	2454
B22R21C04	22-4-21	Hs~Ref:NM_138300.3~uORF:IOH22981	2432	40	2392
B22R21C05	22-5-21	Hs~Ref:NM_001323.2~uORF:IOH23279	277	46	231
B22R21C06	22-6-21	Hs~Ref:NM_001323.2~uORF:IOH23279	231	49	182
B22R21C07	22-7-21	Hs~Ref:NM_015609.1~uORF:IOH23006	2132	48	2084
B22R21C08	22-8-21	Hs~Ref:NM_015609.1~uORF:IOH23006	2075	66	2009
B22R21C09	22-9-21	Hs~Ref:NP_002323.2~CAT_11665-HCCH-25	1103	119	984
B22R21C10	22-10-21	Hs~Ref:NP_002323.2~CAT_11665-HCCH-25	165	73	92
B22R21C11	22-11-21	Internal_1007209	113	70	43
B22R21C12	22-12-21	Internal_1007209	84	58	26
B22R21C13	22-13-21	Hs~Ref:NP_062550.2~CAT_11975-H08H-25	60	44	16
B22R21C14	22-14-21	Hs~Ref:NP_062550.2~CAT_11975-H08H-25	55	43	12
B22R21C15	22-15-21	Internal_1007209	91	48	43
B22R21C16	22-16-21	Internal_1007209	54	41	13
B22R21C17	22-17-21	Hs~Ref:AAI43394.1~CAT_11218-H08H-25	38	38	0
B22R21C18	22-18-21	Hs~Ref:AAI43394.1~CAT_11218-H08H-25	37	37	0
B22R21C19	22-19-21	Internal_1007209	46	38	8
B22R21C20	22-20-21	Internal_1007209	43	40	3
B22R21C21	22-21-21	Internal_1007209	57	40	17
B22R21C22	22-22-21	Internal_1007209	56	40	16
B22R22C01	22-1-22	ERa~N/A	2276	35	2241
B22R22C02	22-2-22	ERa~N/A	2405	35	2370
B22R22C03	22-3-22	PKCeta~N/A	290	36	254
B22R22C04	22-4-22	PKCeta~N/A	274	36	238
B22R22C05	22-5-22	Calmodulin~N/A	68	42	26
B22R22C06	22-6-22	Calmodulin~N/A	60	39	21
B22R22C07	22-7-22	V5control5~N/A	346	37	309
B22R22C08	22-8-22	V5control5~N/A	417	42	375
B22R22C09	22-9-22	V5control4~N/A	199	83	116
B22R22C10	22-10-22	V5control4~N/A	3450	103	3347
B22R22C11	22-11-22	V5control3~N/A	86	77	9
B22R22C12	22-12-22	V5control3~N/A	201	72	129
B22R22C13	22-13-22	V5control2~N/A	82	55	27
B22R22C14	22-14-22	V5control2~N/A	81	45	36
B22R22C15	22-15-22	V5control1~N/A	77	48	29
B22R22C16	22-16-22	V5control1~N/A	54	42	12
B22R22C17	22-17-22	CMK2A~N/A	563	39	524
B22R22C18	22-18-22	CMK2A~N/A	570	38	532
B22R22C19	22-19-22	ERa~N/A	1815	38	1777
B22R22C20	22-20-22	ERa~N/A	1691	39	1652
B22R22C21	22-21-22	AlexaAntiMouseAb~N/A	10869	41	10828
B22R22C22	22-22-22	AlexaAntiMouseAb~N/A	11354	41	11313
B23R01C01	23-1-1	AlexaAntiMouseAb~N/A	38691	41	38650
B23R01C02	23-2-1	AlexaAntiMouseAb~N/A	39669	43	39626
B23R01C03	23-3-1	ERa~N/A	1658	44	1614
B23R01C04	23-4-1	ERa~N/A	1928	43	1885
B23R01C05	23-5-1	HumanIgG1~N/A	954	42	912
B23R01C06	23-6-1	HumanIgG1~N/A	1055	41	1014
B23R01C07	23-7-1	HumanIgG2~N/A	2548	40	2508
B23R01C08	23-8-1	HumanIgG2~N/A	3110	40	3070
B23R01C09	23-9-1	HumanIgG3~N/A	12966	41	12925
B23R01C10	23-10-1	HumanIgG3~N/A	14588	41	14547
B23R01C11	23-11-1	HumanIgG4~N/A	44133	42	44091
B23R01C12	23-12-1	HumanIgG4~N/A	44409	43	44366
B23R01C13	23-13-1	BiotinAb~N/A	362	40	322
B23R01C14	23-14-1	BiotinAb~N/A	317	39	278
B23R01C15	23-15-1	RanBP2deltaFG~N/A	280	42	238
B23R01C16	23-16-1	RanBP2deltaFG~N/A	265	44	221
B23R01C17	23-17-1	hMDM2~N/A	807	42	765
B23R01C18	23-18-1	hMDM2~N/A	820	43	777
B23R01C19	23-19-1	PKCeta~N/A	286	42	244
B23R01C20	23-20-1	PKCeta~N/A	289	42	247
B23R01C21	23-21-1	AlexaAntiMouseAb~N/A	36949	42	36907
B23R01C22	23-22-1	AlexaAntiMouseAb~N/A	38424	43	38381
B23R02C01	23-1-2	PKCeta~N/A	1160	41	1119
B23R02C02	23-2-2	PKCeta~N/A	1093	46	1047
B23R02C03	23-3-2	Buffer	270	51	219
B23R02C04	23-4-2	Buffer	83	43	40
B23R02C05	23-5-2	HumanIgA~N/A	19528	43	19485
B23R02C06	23-6-2	HumanIgA~N/A	22020	42	21978
B23R02C07	23-7-2	Buffer	179	46	133
B23R02C08	23-8-2	Buffer	76	42	34
B23R02C09	23-9-2	BSA~N/A	12867	42	12825
B23R02C10	23-10-2	BSA~N/A	12816	42	12774
B23R02C11	23-11-2	Hs~MGC:BC062354.1~uORF:IOH40674	236	44	192
B23R02C12	23-12-2	Hs~MGC:BC062354.1~uORF:IOH40674	232	66	166
B23R02C13	23-13-2	Hs~Ref:NM_138288.1~uORF:IOH13958	409	46	363
B23R02C14	23-14-2	Hs~Ref:NM_138288.1~uORF:IOH13958	433	45	388
B23R02C15	23-15-2	Hs~MGC:BC012602.1~uORF:IOH14457	381	71	310
B23R02C16	23-16-2	Hs~MGC:BC012602.1~uORF:IOH14457	403	104	299
B23R02C17	23-17-2	Hs~Ref:NM_144714.1~uORF:IOH11221	476	50	426
B23R02C18	23-18-2	Hs~Ref:NM_144714.1~uORF:IOH11221	465	47	418
B23R02C19	23-19-2	Hs~Ref:XM_373744.2~uORF:IOH42929	161	46	115
B23R02C20	23-20-2	Hs~Ref:XM_373744.2~uORF:IOH42929	366	50	316
B23R02C21	23-21-2	Hs~Ref:NM_205853.1~uORF:IOH43061	513	47	466
B23R02C22	23-22-2	Hs~Ref:NM_205853.1~uORF:IOH43061	497	44	453
B23R03C01	23-1-3	Hs~Ref:NM_032507.2~uORF:IOH43962	372	42	330
B23R03C02	23-2-3	Hs~Ref:NM_032507.2~uORF:IOH43962	297	45	252
B23R03C03	23-3-3	Hs~Ref:NM_054035.1~uORF:IOH43630	468	49	419
B23R03C04	23-4-3	Hs~Ref:NM_054035.1~uORF:IOH43630	395	47	348
B23R03C05	23-5-3	Hs~MGC:BC030792.1~uORF:IOH27135	447	47	400
B23R03C06	23-6-3	Hs~MGC:BC030792.1~uORF:IOH27135	438	53	385
B23R03C07	23-7-3	Hs~MGC:NM_183353.1~uORF:IOH14364	354	43	311
B23R03C08	23-8-3	Hs~MGC:NM_183353.1~uORF:IOH14364	384	50	334
B23R03C09	23-9-3	Hs~MGC:BC048292.1~uORF:IOH26585	127	45	82
B23R03C10	23-10-3	Hs~MGC:BC048292.1~uORF:IOH26585	122	43	79
B23R03C11	23-11-3	Hs~Ref:NM_032780.1~uORF:IOH27361	115	42	73
B23R03C12	23-12-3	Hs~Ref:NM_032780.1~uORF:IOH27361	170	49	121
B23R03C13	23-13-3	Hs~MGC:BC001907.1~uORF:IOH4806	277	53	224
B23R03C14	23-14-3	Hs~MGC:BC001907.1~uORF:IOH4806	181	56	125
B23R03C15	23-15-3	Hs~Ref:NM_001660.2~uORF:IOH5952	195	134	61
B23R03C16	23-16-3	Hs~Ref:NM_001660.2~uORF:IOH5952	175	132	43
B23R03C17	23-17-3	Hs~Ref:NM_006838.1~uORF:IOH11106	2117	56	2061
B23R03C18	23-18-3	Hs~Ref:NM_006838.1~uORF:IOH11106	2149	51	2098
B23R03C19	23-19-3	Hs~MGC:BC008037.2~uORF:IOH5889	444	45	399
B23R03C20	23-20-3	Hs~MGC:BC008037.2~uORF:IOH5889	450	45	405
B23R03C21	23-21-3	Hs~MGC:BC034497.2~uORF:IOH22342	505	44	461
B23R03C22	23-22-3	Hs~MGC:BC034497.2~uORF:IOH22342	516	43	473
B23R04C01	23-1-4	Hs~Ref:NM_005185.1~uORF:IOH22362	220	42	178
B23R04C02	23-2-4	Hs~Ref:NM_005185.1~uORF:IOH22362	208	58	150
B23R04C03	23-3-4	Hs~MGC:BC029662.1~uORF:IOH22367	458	59	399
B23R04C04	23-4-4	Hs~MGC:BC029662.1~uORF:IOH22367	396	81	315
B23R04C05	23-5-4	Hs~MGC:BC030027.1~uORF:IOH22381	346	47	299
B23R04C06	23-6-4	Hs~MGC:BC030027.1~uORF:IOH22381	317	44	273
B23R04C07	23-7-4	Hs~MGC:BC005332.1~uORF:IOH7177	15265	44	15221
B23R04C08	23-8-4	Hs~MGC:BC005332.1~uORF:IOH7177	15728	45	15683
B23R04C09	23-9-4	Hs~Ref:NM_005738.1~uORF:IOH5077	626	45	581
B23R04C10	23-10-4	Hs~Ref:NM_005738.1~uORF:IOH5077	587	45	542
B23R04C11	23-11-4	Hs~MGC:BC002951.1~uORF:IOH4779	165	49	116
B23R04C12	23-12-4	Hs~MGC:BC002951.1~uORF:IOH4779	97	49	48
B23R04C13	23-13-4	Hs~MGC:BC003690.1~uORF:IOH3064	182	99	83
B23R04C14	23-14-4	Hs~MGC:BC003690.1~uORF:IOH3064	243	112	131
B23R04C15	23-15-4	Hs~Ref:NM_017411.2~uORF:IOH10903	590	47	543
B23R04C16	23-16-4	Hs~Ref:NM_017411.2~uORF:IOH10903	628	47	581
B23R04C17	23-17-4	Hs~MGC:BC063666.1~uORF:IOH39829	217	53	164
B23R04C18	23-18-4	Hs~MGC:BC063666.1~uORF:IOH39829	400	174	226
B23R04C19	23-19-4	Hs~MGC:BC035137.1~uORF:IOH27698	537	48	489
B23R04C20	23-20-4	Hs~MGC:BC035137.1~uORF:IOH27698	548	43	505
B23R04C21	23-21-4	Hs~Ref:NM_022754.4~uORF:IOH39788	472	42	430
B23R04C22	23-22-4	Hs~Ref:NM_022754.4~uORF:IOH39788	454	41	413
B23R05C01	23-1-5	Hs~Ref:NM_013338.2~uORF:IOH12723	348	42	306
B23R05C02	23-2-5	Hs~Ref:NM_013338.2~uORF:IOH12723	435	46	389
B23R05C03	23-3-5	Hs~Ref:NM_006834.2~uORF:IOH12811	255	51	204
B23R05C04	23-4-5	Hs~Ref:NM_006834.2~uORF:IOH12811	302	87	215
B23R05C05	23-5-5	Hs~MGC:BC011011.1~uORF:IOH12897	482	50	432
B23R05C06	23-6-5	Hs~MGC:BC011011.1~uORF:IOH12897	603	47	556
B23R05C07	23-7-5	Hs~MGC:BC010929.1~uORF:IOH12868	783	44	739
B23R05C08	23-8-5	Hs~MGC:BC010929.1~uORF:IOH12868	699	43	656
B23R05C09	23-9-5	Hs~MGC:BC048104.1~uORF:IOH26746	277	47	230
B23R05C10	23-10-5	Hs~MGC:BC048104.1~uORF:IOH26746	208	86	122
B23R05C11	23-11-5	Hs~MGC:BC047583.1~uORF:IOH26438	62	48	14
B23R05C12	23-12-5	Hs~MGC:BC047583.1~uORF:IOH26438	275	99	176
B23R05C13	23-13-5	Hs~MGC:NM_178126.2~uORF:IOH26767	224	128	96
B23R05C14	23-14-5	Hs~MGC:NM_178126.2~uORF:IOH26767	178	98	80
B23R05C15	23-15-5	Hs~Ref:NM_019891.1~uORF:IOH26775	113	48	65
B23R05C16	23-16-5	Hs~Ref:NM_019891.1~uORF:IOH26775	223	66	157
B23R05C17	23-17-5	Hs~Ref:NM_022107.1~uORF:IOH12525	424	230	194
B23R05C18	23-18-5	Hs~Ref:NM_022107.1~uORF:IOH12525	283	64	219
B23R05C19	23-19-5	Hs~Ref:NM_015955.2~uORF:IOH12624	755	47	708
B23R05C20	23-20-5	Hs~Ref:NM_015955.2~uORF:IOH12624	763	43	720
B23R05C21	23-21-5	Hs~Ref:NM_015944.2~uORF:IOH12631	575	43	532
B23R05C22	23-22-5	Hs~Ref:NM_015944.2~uORF:IOH12631	549	42	507
B23R06C01	23-1-6	Hs~Ref:NM_144611.1~uORF:IOH12901	339	42	297
B23R06C02	23-2-6	Hs~Ref:NM_144611.1~uORF:IOH12901	287	44	243
B23R06C03	23-3-6	Hs~Ref:NM_020199.1~uORF:IOH45786	245	97	148
B23R06C04	23-4-6	Hs~Ref:NM_020199.1~uORF:IOH45786	152	47	105
B23R06C05	23-5-6	Hs~Ref:NM_002832.2~uORF:IOH45836	664	46	618
B23R06C06	23-6-6	Hs~Ref:NM_002832.2~uORF:IOH45836	1683	67	1616
B23R06C07	23-7-6	Hs~MGC:BC063479.1~uORF:IOH39883	1266	61	1205
B23R06C08	23-8-6	Hs~MGC:BC063479.1~uORF:IOH39883	156	43	113
B23R06C09	23-9-6	Hs~Ref:NM_207645.1~uORF:IOH40066	313	49	264
B23R06C10	23-10-6	Hs~Ref:NM_207645.1~uORF:IOH40066	245	49	196
B23R06C11	23-11-6	Hs~Ref:NM_197972.1~uORF:IOH45886	463	45	418
B23R06C12	23-12-6	Hs~Ref:NM_197972.1~uORF:IOH45886	466	45	421
B23R06C13	23-13-6	Hs~Ref:NM_183041.1~uORF:IOH45814	380	53	327
B23R06C14	23-14-6	Hs~Ref:NM_183041.1~uORF:IOH45814	403	56	347
B23R06C15	23-15-6	Hs~Ref:NM_006172.1~uORF:IOH45889	358	97	261
B23R06C16	23-16-6	Hs~Ref:NM_006172.1~uORF:IOH45889	176	67	109
B23R06C17	23-17-6	Hs~Ref:NM_198723.1~uORF:IOH45764	1538	53	1485
B23R06C18	23-18-6	Hs~Ref:NM_198723.1~uORF:IOH45764	1554	46	1508
B23R06C19	23-19-6	Hs~Ref:NM_005168.3~uORF:IOH55962	468	44	424
B23R06C20	23-20-6	Hs~Ref:NM_005168.3~uORF:IOH55962	477	44	433
B23R06C21	23-21-6	Hs~MGC:BC040261.1~uORF:IOH27390	273	58	215
B23R06C22	23-22-6	Hs~MGC:BC040261.1~uORF:IOH27390	169	46	123
B23R07C01	23-1-7	Hs~MGC:BC011617.2~uORF:IOH57154	286	102	184
B23R07C02	23-2-7	Hs~MGC:BC011617.2~uORF:IOH57154	238	66	172
B23R07C03	23-3-7	Hs~MGC:NM_152740.2~uORF:IOH21624	204	109	95
B23R07C04	23-4-7	Hs~MGC:NM_152740.2~uORF:IOH21624	120	45	75
B23R07C05	23-5-7	Hs~Ref:NM_005248.1~uORF:IOH21152	220	61	159
B23R07C06	23-6-7	Hs~Ref:NM_005248.1~uORF:IOH21152	892	103	789
B23R07C07	23-7-7	Hs~Ref:NM_001823.2~uORF:IOH5211	298	165	133
B23R07C08	23-8-7	Hs~Ref:NM_001823.2~uORF:IOH5211	424	48	376
B23R07C09	23-9-7	Hs~Ref:NM_024025.1~uORF:IOH21299	398	51	347
B23R07C10	23-10-7	Hs~Ref:NM_024025.1~uORF:IOH21299	405	55	350
B23R07C11	23-11-7	Hs~Ref:NM_005605.2~uORF:IOH5608	351	49	302
B23R07C12	23-12-7	Hs~Ref:NM_005605.2~uORF:IOH5608	436	49	387
B23R07C13	23-13-7	Hs~Ref:NM_016541.1~uORF:IOH39579	314	95	219
B23R07C14	23-14-7	Hs~Ref:NM_016541.1~uORF:IOH39579	418	249	169
B23R07C15	23-15-7	Hs~Ref:NM_016542.2~uORF:IOH39650	402	224	178
B23R07C16	23-16-7	Hs~Ref:NM_016542.2~uORF:IOH39650	360	257	103
B23R07C17	23-17-7	Hs~MGC:BC045535.1~uORF:IOH26895	555	45	510
B23R07C18	23-18-7	Hs~MGC:BC045535.1~uORF:IOH26895	563	41	522
B23R07C19	23-19-7	Hs~MGC:BC040351.1~uORF:IOH25766	429	74	355
B23R07C20	23-20-7	Hs~MGC:BC040351.1~uORF:IOH25766	450	57	393
B23R07C21	23-21-7	Hs~Ref:NM_003668.2~N/A	1406	46	1360
B23R07C22	23-22-7	Hs~Ref:NM_003668.2~N/A	1447	42	1405
B23R08C01	23-1-8	Hs~Ref:NM_000061.1~N/A	425	45	380
B23R08C02	23-2-8	Hs~Ref:NM_000061.1~N/A	429	47	382
B23R08C03	23-3-8	Hs~Ref:NM_017572.1~N/A	387	86	301
B23R08C04	23-4-8	Hs~Ref:NM_017572.1~N/A	490	47	443
B23R08C05	23-5-8	Hs~Ref:NM_017593.2~N/A	460	43	417
B23R08C06	23-6-8	Hs~Ref:NM_017593.2~N/A	427	46	381
B23R08C07	23-7-8	Hs~MGC:BC000583.1~uORF:IOH22887	1027	55	972
B23R08C08	23-8-8	Hs~MGC:BC000583.1~uORF:IOH22887	619	160	459
B23R08C09	23-9-8	Hs~MGC:BC015562.1~uORF:IOH22914	642	251	391
B23R08C10	23-10-8	Hs~MGC:BC015562.1~uORF:IOH22914	608	322	286
B23R08C11	23-11-8	Hs~Ref:NM_004699.1~uORF:IOH4655	858	55	803
B23R08C12	23-12-8	Hs~Ref:NM_004699.1~uORF:IOH4655	805	49	756
B23R08C13	23-13-8	Hs~MGC:BC014394.1~uORF:IOH22936	2606	52	2554
B23R08C14	23-14-8	Hs~MGC:BC014394.1~uORF:IOH22936	2643	57	2586
B23R08C15	23-15-8	Hs~Ref:NM_201259.1~uORF:IOH45586	2168	54	2114
B23R08C16	23-16-8	Hs~Ref:NM_201259.1~uORF:IOH45586	2233	53	2180
B23R08C17	23-17-8	Hs~Ref:NM_173522.1~uORF:IOH44595	732	45	687
B23R08C18	23-18-8	Hs~Ref:NM_173522.1~uORF:IOH44595	718	43	675
B23R08C19	23-19-8	Hs~Ref:NM_156036.1~uORF:IOH44550	1034	47	987
B23R08C20	23-20-8	Hs~Ref:NM_156036.1~uORF:IOH44550	1059	47	1012
B23R08C21	23-21-8	Hs~Ref:NM_003798.1~uORF:IOH44444	927	59	868
B23R08C22	23-22-8	Hs~Ref:NM_003798.1~uORF:IOH44444	793	50	743
B23R09C01	23-1-9	Hs~MGC:BC002508.2~uORF:IOH3971	311	68	243
B23R09C02	23-2-9	Hs~MGC:BC002508.2~uORF:IOH3971	225	65	160
B23R09C03	23-3-9	Hs~MGC:BC001371.2~uORF:IOH3977	192	46	146
B23R09C04	23-4-9	Hs~MGC:BC001371.2~uORF:IOH3977	266	52	214
B23R09C05	23-5-9	Hs~Ref:NM_001722.2~uORF:IOH4103	1754	43	1711
B23R09C06	23-6-9	Hs~Ref:NM_001722.2~uORF:IOH4103	1704	42	1662
B23R09C07	23-7-9	Hs~Ref:NM_004550.3~uORF:IOH4011	138	43	95
B23R09C08	23-8-9	Hs~Ref:NM_004550.3~uORF:IOH4011	1505	146	1359
B23R09C09	23-9-9	Hs~MGC:BC050551.1~uORF:IOH26948	3744	177	3567
B23R09C10	23-10-9	Hs~MGC:BC050551.1~uORF:IOH26948	1515	55	1460
B23R09C11	23-11-9	Hs~Ref:NM_197964.1~uORF:IOH7576	525	46	479
B23R09C12	23-12-9	Hs~Ref:NM_197964.1~uORF:IOH7576	581	46	535
B23R09C13	23-13-9	Hs~MGC:BC011250.1~uORF:IOH10217	145	49	96
B23R09C14	23-14-9	Hs~MGC:BC011250.1~uORF:IOH10217	150	139	11
B23R09C15	23-15-9	Hs~MGC:BC007015.1~uORF:IOH29312	569	43	526
B23R09C16	23-16-9	Hs~MGC:BC007015.1~uORF:IOH29312	596	41	555
B23R09C17	23-17-9	Hs~MGC:BC000419.2~uORF:IOH46092	268	45	223
B23R09C18	23-18-9	Hs~MGC:BC000419.2~uORF:IOH46092	284	49	235
B23R09C19	23-19-9	Hs~Ref:NM_152743.2~uORF:IOH46177	302	64	238
B23R09C20	23-20-9	Hs~Ref:NM_152743.2~uORF:IOH46177	316	45	271
B23R09C21	23-21-9	Hs~MGC:BC005830.2~uORF:IOH46117	1142	59	1083
B23R09C22	23-22-9	Hs~MGC:BC005830.2~uORF:IOH46117	1331	135	1196
B23R10C01	23-1-10	Hs~Ref:NM_005663.2~uORF:IOH46152	1153	47	1106
B23R10C02	23-2-10	Hs~Ref:NM_005663.2~uORF:IOH46152	1081	52	1029
B23R10C03	23-3-10	Hs~MGC:BC063107.1~uORF:IOH40711	376	110	266
B23R10C04	23-4-10	Hs~MGC:BC063107.1~uORF:IOH40711	347	43	304
B23R10C05	23-5-10	Hs~Ref:NM_152230.2~uORF:IOH40760	402	42	360
B23R10C06	23-6-10	Hs~Ref:NM_152230.2~uORF:IOH40760	405	41	364
B23R10C07	23-7-10	Hs~Ref:NM_007135.1~uORF:IOH40671	419	43	376
B23R10C08	23-8-10	Hs~Ref:NM_007135.1~uORF:IOH40671	3003	159	2844
B23R10C09	23-9-10	Hs~MGC:BC015665.2~uORF:IOH40642	2805	109	2696
B23R10C10	23-10-10	Hs~MGC:BC015665.2~uORF:IOH40642	2399	42	2357
B23R10C11	23-11-10	GST1	121	41	80
B23R10C12	23-12-10	GST1	49	42	7
B23R10C13	23-13-10	GST2	49	42	7
B23R10C14	23-14-10	GST2	47	42	5
B23R10C15	23-15-10	GST3	54	41	13
B23R10C16	23-16-10	GST3	54	41	13
B23R10C17	23-17-10	GST4	64	40	24
B23R10C18	23-18-10	GST4	64	41	23
B23R10C19	23-19-10	Anti-HumanIgA1~N/A	7927	42	7885
B23R10C20	23-20-10	Anti-HumanIgA1~N/A	7809	42	7767
B23R10C21	23-21-10	Anti-HumanIgA2~N/A	15276	45	15231
B23R10C22	23-22-10	Anti-HumanIgA2~N/A	16363	42	16321
B23R11C01	23-1-11	AlexaAntiMouseAb~N/A	26516	40	26476
B23R11C02	23-2-11	AlexaAntiMouseAb~N/A	28271	42	28229
B23R11C03	23-3-11	MAPKAP~N/A	75	44	31
B23R11C04	23-4-11	MAPKAP~N/A	55	45	10
B23R11C05	23-5-11	Buffer	221	41	180
B23R11C06	23-6-11	Buffer	217	67	150
B23R11C07	23-7-11	BSA~N/A	11364	44	11320
B23R11C08	23-8-11	BSA~N/A	10296	55	10241
B23R11C09	23-9-11	Anti-HumanIgG1~N/A	1341	52	1289
B23R11C10	23-10-11	Anti-HumanIgG1~N/A	1511	44	1467
B23R11C11	23-11-11	Anti-HumanIgG2~N/A	3075	48	3027
B23R11C12	23-12-11	Anti-HumanIgG2~N/A	3267	49	3218
B23R11C13	23-13-11	Anti-HumanIgG3~N/A	5394	47	5347
B23R11C14	23-14-11	Anti-HumanIgG3~N/A	5669	47	5622
B23R11C15	23-15-11	Anti-HumanIgG4~N/A	11423	45	11378
B23R11C16	23-16-11	Anti-HumanIgG4~N/A	11810	43	11767
B23R11C17	23-17-11	AntiBiotinAb~N/A	11836	40	11796
B23R11C18	23-18-11	AntiBiotinAb~N/A	12293	40	12253
B23R11C19	23-19-11	Buffer	107	41	66
B23R11C20	23-20-11	Buffer	77	42	35
B23R11C21	23-21-11	Hs~MGC:BC032008.1~uORF:IOH22169	219	95	124
B23R11C22	23-22-11	Hs~MGC:BC032008.1~uORF:IOH22169	111	45	66
B23R12C01	23-1-12	Hs~Ref:NM_152737.1~uORF:IOH22453	156	74	82
B23R12C02	23-2-12	Hs~Ref:NM_152737.1~uORF:IOH22453	362	77	285
B23R12C03	23-3-12	Hs~MGC:BC009194.2~uORF:IOH13702	726	47	679
B23R12C04	23-4-12	Hs~MGC:BC009194.2~uORF:IOH13702	727	42	685
B23R12C05	23-5-12	Hs~Ref:NM_005434.3~uORF:IOH5127	265	78	187
B23R12C06	23-6-12	Hs~Ref:NM_005434.3~uORF:IOH5127	266	43	223
B23R12C07	23-7-12	Hs~MGC:BC032347.1~uORF:IOH21704	11827	43	11784
B23R12C08	23-8-12	Hs~MGC:BC032347.1~uORF:IOH21704	14296	49	14247
B23R12C09	23-9-12	Hs~Ref:NM_032908.1~uORF:IOH6765	650	83	567
B23R12C10	23-10-12	Hs~Ref:NM_032908.1~uORF:IOH6765	485	61	424
B23R12C11	23-11-12	Hs~MGC:NM_178152.1~uORF:IOH20954	1655	59	1596
B23R12C12	23-12-12	Hs~MGC:NM_178152.1~uORF:IOH20954	1652	60	1592
B23R12C13	23-13-12	Hs~MGC:BC002769.1~uORF:IOH5310	467	116	351
B23R12C14	23-14-12	Hs~MGC:BC002769.1~uORF:IOH5310	420	68	352
B23R12C15	23-15-12	Hs~Ref:NM_001001683.1~uORF:IOH45938	533	50	483
B23R12C16	23-16-12	Hs~Ref:NM_001001683.1~uORF:IOH45938	507	45	462
B23R12C17	23-17-12	Hs~Ref:NM_030781.2~uORF:IOH41873	1159	42	1117
B23R12C18	23-18-12	Hs~Ref:NM_030781.2~uORF:IOH41873	1235	43	1192
B23R12C19	23-19-12	Hs~Ref:NM_014255.3~uORF:IOH45647	652	41	611
B23R12C20	23-20-12	Hs~Ref:NM_014255.3~uORF:IOH45647	711	40	671
B23R12C21	23-21-12	Hs~Ref:NM_007162.1~uORF:IOH21660	1092	44	1048
B23R12C22	23-22-12	Hs~Ref:NM_007162.1~uORF:IOH21660	1029	42	987
B23R13C01	23-1-13	Hs~MGC:BC042161.1~uORF:IOH28007	230	43	187
B23R13C02	23-2-13	Hs~MGC:BC042161.1~uORF:IOH28007	302	52	250
B23R13C03	23-3-13	Hs~Ref:NM_152663.2~uORF:IOH26530	133	45	88
B23R13C04	23-4-13	Hs~Ref:NM_152663.2~uORF:IOH26530	131	42	89
B23R13C05	23-5-13	Hs~Ref:NM_005180.1~uORF:IOH13688	219	59	160
B23R13C06	23-6-13	Hs~Ref:NM_005180.1~uORF:IOH13688	362	55	307
B23R13C07	23-7-13	Hs~Ref:NM_020139.1~uORF:IOH5065	53	41	12
B23R13C08	23-8-13	Hs~Ref:NM_020139.1~uORF:IOH5065	51	41	10
B23R13C09	23-9-13	Hs~Ref:NM_014719.1~uORF:IOH60025	402	43	359
B23R13C10	23-10-13	Hs~Ref:NM_014719.1~uORF:IOH60025	476	50	426
B23R13C11	23-11-13	Hs~Ref:NM_007196.2~uORF:IOH59050	268	69	199
B23R13C12	23-12-13	Hs~Ref:NM_007196.2~uORF:IOH59050	189	59	130
B23R13C13	23-13-13	Hs~Ref:NM_006412.3~uORF:IOH59059	444	232	212
B23R13C14	23-14-13	Hs~Ref:NM_006412.3~uORF:IOH59059	267	53	214
B23R13C15	23-15-13	Hs~Ref:NM_006883.2~uORF:IOH35312	709	52	657
B23R13C16	23-16-13	Hs~Ref:NM_006883.2~uORF:IOH35312	717	49	668
B23R13C17	23-17-13	Hs~MGC:BC062592.1~uORF:IOH39886	672	44	628
B23R13C18	23-18-13	Hs~MGC:BC062592.1~uORF:IOH39886	694	43	651
B23R13C19	23-19-13	Hs~MGC:BC064144.1~uORF:IOH40037	543	42	501
B23R13C20	23-20-13	Hs~MGC:BC064144.1~uORF:IOH40037	567	41	526
B23R13C21	23-21-13	Hs~Ref:NM_000939.1~uORF:IOH40048	952	41	911
B23R13C22	23-22-13	Hs~Ref:NM_000939.1~uORF:IOH40048	891	40	851
B23R14C01	23-1-14	Hs~MGC:BC067735.1~uORF:IOH40060	636	43	593
B23R14C02	23-2-14	Hs~MGC:BC067735.1~uORF:IOH40060	661	45	616
B23R14C03	23-3-14	Hs~Ref:NM_001099.2~uORF:IOH53960	397	146	251
B23R14C04	23-4-14	Hs~Ref:NM_001099.2~uORF:IOH53960	268	51	217
B23R14C05	23-5-14	Hs~Ref:NM_006224.2~uORF:IOH57274	234	147	87
B23R14C06	23-6-14	Hs~Ref:NM_006224.2~uORF:IOH57274	227	120	107
B23R14C07	23-7-14	Hs~MGC:BC060841.1~uORF:IOH29167	308	45	263
B23R14C08	23-8-14	Hs~MGC:BC060841.1~uORF:IOH29167	285	45	240
B23R14C09	23-9-14	Hs~Ref:NM_002444.1~uORF:IOH2457	437	44	393
B23R14C10	23-10-14	Hs~Ref:NM_002444.1~uORF:IOH2457	655	47	608
B23R14C11	23-11-14	Hs~Ref:NM_032726.1~uORF:IOH21106	660	53	607
B23R14C12	23-12-14	Hs~Ref:NM_032726.1~uORF:IOH21106	531	51	480
B23R14C13	23-13-14	Hs~MGC:BC011707.1~uORF:IOH13976	920	49	871
B23R14C14	23-14-14	Hs~MGC:BC011707.1~uORF:IOH13976	862	45	817
B23R14C15	23-15-14	Hs~MGC:BC001396.1~uORF:IOH3939	363	46	317
B23R14C16	23-16-14	Hs~MGC:BC001396.1~uORF:IOH3939	367	47	320
B23R14C17	23-17-14	Hs~MGC:BC004190.1~uORF:IOH3910	332	45	287
B23R14C18	23-18-14	Hs~MGC:BC004190.1~uORF:IOH3910	364	45	319
B23R14C19	23-19-14	Hs~MGC:BC073866.1~uORF:IOH61756	367	46	321
B23R14C20	23-20-14	Hs~MGC:BC073866.1~uORF:IOH61756	335	45	290
B23R14C21	23-21-14	Hs~MGC:BC069428.1~uORF:IOH61864	316	44	272
B23R14C22	23-22-14	Hs~MGC:BC069428.1~uORF:IOH61864	305	42	263
B23R15C01	23-1-15	Hs~MGC:BC067760.1~uORF:IOH61701	245	59	186
B23R15C02	23-2-15	Hs~MGC:BC067760.1~uORF:IOH61701	143	45	98
B23R15C03	23-3-15	Hs~MGC:BC032540.1~uORF:IOH61730	276	58	218
B23R15C04	23-4-15	Hs~MGC:BC032540.1~uORF:IOH61730	244	44	200
B23R15C05	23-5-15	Hs~MGC:BC060319.1~uORF:IOH29295	373	43	330
B23R15C06	23-6-15	Hs~MGC:BC060319.1~uORF:IOH29295	368	45	323
B23R15C07	23-7-15	Hs~MGC:BC054022.1~uORF:IOH29469	205	84	121
B23R15C08	23-8-15	Hs~MGC:BC054022.1~uORF:IOH29469	298	150	148
B23R15C09	23-9-15	Hs~MGC:BC040177.2~uORF:IOH28709	335	45	290
B23R15C10	23-10-15	Hs~MGC:BC040177.2~uORF:IOH28709	396	45	351
B23R15C11	23-11-15	Hs~MGC:BC059950.1~uORF:IOH29294	2139	57	2082
B23R15C12	23-12-15	Hs~MGC:BC059950.1~uORF:IOH29294	2070	50	2020
B23R15C13	23-13-15	Hs~Ref:NM_016281.2~CAT:PV3652	327	47	280
B23R15C14	23-14-15	Hs~Ref:NM_016281.2~CAT:PV3652	358	60	298
B23R15C15	23-15-15	Hs~Ref:NM_152619.1~CAT:PV4297	247	48	199
B23R15C16	23-16-15	Hs~Ref:NM_152619.1~CAT:PV4297	248	45	203
B23R15C17	23-17-15	Hs~Ref:NM_005233.3~CAT:PV3359	1276	42	1234
B23R15C18	23-18-15	Hs~Ref:NM_005233.3~CAT:PV3359	1352	43	1309
B23R15C19	23-19-15	Hs~Ref:NM_001033578.1~CAT:PV3859	286	43	243
B23R15C20	23-20-15	Hs~Ref:NM_001033578.1~CAT:PV3859	288	45	243
B23R15C21	23-21-15	Hs~Ref:NM_005406.1~CAT:PV3691	133	48	85
B23R15C22	23-22-15	Hs~Ref:NM_005406.1~CAT:PV3691	60	41	19
B23R16C01	23-1-16	Hs~Ref:NM_004850.2~CAT:PV3759	145	40	105
B23R16C02	23-2-16	Hs~Ref:NM_004850.2~CAT:PV3759	193	110	83
B23R16C03	23-3-16	Hs~Ref:NM_002376.2~CAT:PV4819	2972	42	2930
B23R16C04	23-4-16	Hs~Ref:NM_002376.2~CAT:PV4819	3053	41	3012
B23R16C05	23-5-16	Hs~Ref:NM_002957.3~CAT:PV4799	221	41	180
B23R16C06	23-6-16	Hs~Ref:NM_002957.3~CAT:PV4799	172	41	131
B23R16C07	23-7-16	Hs~MGC:BC094800.1~uORF:IOH62619	1363	51	1312
B23R16C08	23-8-16	Hs~MGC:BC094800.1~uORF:IOH62619	1242	52	1190
B23R16C09	23-9-16	Hs~MGC:BC094687.1~uORF:IOH62581	408	43	365
B23R16C10	23-10-16	Hs~MGC:BC094687.1~uORF:IOH62581	414	45	369
B23R16C11	23-11-16	Hs~MGC:BC096312.2~uORF:IOH63282	1709	143	1566
B23R16C12	23-12-16	Hs~MGC:BC096312.2~uORF:IOH63282	2362	143	2219
B23R16C13	23-13-16	Hs~MGC:BC100290.1~uORF:IOH62780	318	173	145
B23R16C14	23-14-16	Hs~MGC:BC100290.1~uORF:IOH62780	291	150	141
B23R16C15	23-15-16	Hs~Ref:NM_001814.1~uORF:IOH29634	413	46	367
B23R16C16	23-16-16	Hs~Ref:NM_001814.1~uORF:IOH29634	350	44	306
B23R16C17	23-17-16	Hs~Ref:NM_000882.1~uORF:IOH29844	314	44	270
B23R16C18	23-18-16	Hs~Ref:NM_000882.1~uORF:IOH29844	336	45	291
B23R16C19	23-19-16	Hs~MGC:BC053898.1~uORF:IOH29029	702	45	657
B23R16C20	23-20-16	Hs~MGC:BC053898.1~uORF:IOH29029	711	45	666
B23R16C21	23-21-16	Hs~Ref:NM_016656.1~uORF:IOH29784	368	43	325
B23R16C22	23-22-16	Hs~Ref:NM_016656.1~uORF:IOH29784	351	40	311
B23R17C01	23-1-17	Hs~MGC:BC014144.1~uORF:IOH12115	744	41	703
B23R17C02	23-2-17	Hs~MGC:BC014144.1~uORF:IOH12115	897	42	855
B23R17C03	23-3-17	Hs~Ref:NM_144590.1~uORF:IOH12404	571	41	530
B23R17C04	23-4-17	Hs~Ref:NM_144590.1~uORF:IOH12404	543	40	503
B23R17C05	23-5-17	Hs~Ref:NM_000963.1~uORF:IOH11237	551	40	511
B23R17C06	23-6-17	Hs~Ref:NM_000963.1~uORF:IOH11237	577	40	537
B23R17C07	23-7-17	Hs~Ref:NM_144710.1~uORF:IOH10821	1400	40	1360
B23R17C08	23-8-17	Hs~Ref:NM_144710.1~uORF:IOH10821	1521	41	1480
B23R17C09	23-9-17	Hs~MGC:BC042553.1~uORF:IOH27411	270	76	194
B23R17C10	23-10-17	Hs~MGC:BC042553.1~uORF:IOH27411	128	42	86
B23R17C11	23-11-17	Hs~Ref:NM_130807.1~uORF:IOH10112	2810	64	2746
B23R17C12	23-12-17	Hs~Ref:NM_130807.1~uORF:IOH10112	2210	86	2124
B23R17C13	23-13-17	Hs~MGC:BC042035.1~uORF:IOH62381	175	51	124
B23R17C14	23-14-17	Hs~MGC:BC042035.1~uORF:IOH62381	159	47	112
B23R17C15	23-15-17	Hs~MGC:BC041172.1~uORF:IOH61509	362	48	314
B23R17C16	23-16-17	Hs~MGC:BC041172.1~uORF:IOH61509	335	44	291
B23R17C17	23-17-17	Hs~MGC:BC000503.1~uORF:IOH3515	461	45	416
B23R17C18	23-18-17	Hs~MGC:BC000503.1~uORF:IOH3515	478	47	431
B23R17C19	23-19-17	Hs~Ref:NM_002572.1~uORF:IOH3561	351	51	300
B23R17C20	23-20-17	Hs~Ref:NM_002572.1~uORF:IOH3561	318	52	266
B23R17C21	23-21-17	Hs~MGC:BC002906.2~uORF:IOH5684	353	46	307
B23R17C22	23-22-17	Hs~MGC:BC002906.2~uORF:IOH5684	315	41	274
B23R18C01	23-1-18	Hs~Ref:NM_000858.2~uORF:IOH6313	278	146	132
B23R18C02	23-2-18	Hs~Ref:NM_000858.2~uORF:IOH6313	254	68	186
B23R18C03	23-3-18	Hs~MGC:BC019239.1~uORF:IOH13580	381	45	336
B23R18C04	23-4-18	Hs~MGC:BC019239.1~uORF:IOH13580	374	44	330
B23R18C05	23-5-18	Hs~Ref:NM_002521.1~uORF:IOH22623	449	41	408
B23R18C06	23-6-18	Hs~Ref:NM_002521.1~uORF:IOH22623	468	42	426
B23R18C07	23-7-18	Hs~MGC:NM_152723.1~uORF:IOH27358	667	41	626
B23R18C08	23-8-18	Hs~MGC:NM_152723.1~uORF:IOH27358	628	42	586
B23R18C09	23-9-18	Hs~MGC:BC015734.1~uORF:IOH14771	471	42	429
B23R18C10	23-10-18	Hs~MGC:BC015734.1~uORF:IOH14771	449	42	407
B23R18C11	23-11-18	Hs~Ref:NM_012199.2~uORF:IOH55724	499	46	453
B23R18C12	23-12-18	Hs~Ref:NM_012199.2~uORF:IOH55724	1870	57	1813
B23R18C13	23-13-18	Hs~Ref:NM_207428.1~uORF:IOH58670	3166	130	3036
B23R18C14	23-14-18	Hs~Ref:NM_207428.1~uORF:IOH58670	469	47	422
B23R18C15	23-15-18	Hs~Ref:NM_001017926.1~uORF:IOH55729	424	63	361
B23R18C16	23-16-18	Hs~Ref:NM_001017926.1~uORF:IOH55729	383	47	336
B23R18C17	23-17-18	Hs~Ref:NM_198977.1~uORF:IOH57194	305	47	258
B23R18C18	23-18-18	Hs~Ref:NM_198977.1~uORF:IOH57194	319	59	260
B23R18C19	23-19-18	Hs~Ref:NM_016440.1~N/A	522	48	474
B23R18C20	23-20-18	Hs~Ref:NM_016440.1~N/A	501	46	455
B23R18C21	23-21-18	Hs~Ref:NM_004329.1~N/A	382	44	338
B23R18C22	23-22-18	Hs~Ref:NM_004329.1~N/A	401	42	359
B23R19C01	23-1-19	Hs~Ref:NM_001203.1~N/A	289	56	233
B23R19C02	23-2-19	Hs~Ref:NM_001203.1~N/A	375	47	328
B23R19C03	23-3-19	Hs~Ref:NM_005163.1~N/A	324	47	277
B23R19C04	23-4-19	Hs~Ref:NM_005163.1~N/A	314	48	266
B23R19C05	23-5-19	Hs~Ref:NM_173494.1~uORF:IOH27391	420	41	379
B23R19C06	23-6-19	Hs~Ref:NM_173494.1~uORF:IOH27391	396	40	356
B23R19C07	23-7-19	Hs~Ref:NM_022059.1~uORF:IOH26382	287	40	247
B23R19C08	23-8-19	Hs~Ref:NM_022059.1~uORF:IOH26382	276	41	235
B23R19C09	23-9-19	Hs~Ref:NM_018492.2~uORF:IOH12390	688	41	647
B23R19C10	23-10-19	Hs~Ref:NM_018492.2~uORF:IOH12390	658	42	616
B23R19C11	23-11-19	Hs~Ref:NM_004629.1~uORF:IOH4715	271	45	226
B23R19C12	23-12-19	Hs~Ref:NM_004629.1~uORF:IOH4715	687	55	632
B23R19C13	23-13-19	Hs~Ref:NM_001655.3~uORF:IOH43520	622	59	563
B23R19C14	23-14-19	Hs~Ref:NM_001655.3~uORF:IOH43520	514	53	461
B23R19C15	23-15-19	Hs~Ref:NM_053030.2~uORF:IOH44055	19502	47	19455
B23R19C16	23-16-19	Hs~Ref:NM_053030.2~uORF:IOH44055	19552	45	19507
B23R19C17	23-17-19	Hs~Ref:XM_379306.1~uORF:IOH43607	331	50	281
B23R19C18	23-18-19	Hs~Ref:XM_379306.1~uORF:IOH43607	310	55	255
B23R19C19	23-19-19	Hs~Ref:XM_209196.3~uORF:IOH43609	439	47	392
B23R19C20	23-20-19	Hs~Ref:XM_209196.3~uORF:IOH43609	425	42	383
B23R19C21	23-21-19	Hs~Ref:NM_138771.1~uORF:IOH10465	549	41	508
B23R19C22	23-22-19	Hs~Ref:NM_138771.1~uORF:IOH10465	560	40	520
B23R20C01	23-1-20	Hs~Ref:NM_022141.1~uORF:IOH22820	293	42	251
B23R20C02	23-2-20	Hs~Ref:NM_022141.1~uORF:IOH22820	304	47	257
B23R20C03	23-3-20	Hs~Ref:NM_002734.1~uORF:IOH25740	296	39	257
B23R20C04	23-4-20	Hs~Ref:NM_002734.1~uORF:IOH25740	320	40	280
B23R20C05	23-5-20	Hs~Ref:NM_080745.1~uORF:IOH27453	378	40	338
B23R20C06	23-6-20	Hs~Ref:NM_080745.1~uORF:IOH27453	361	40	321
B23R20C07	23-7-20	Hs~MGC:BC003502.1~uORF:IOH5490	44	39	5
B23R20C08	23-8-20	Hs~MGC:BC003502.1~uORF:IOH5490	42	39	3
B23R20C09	23-9-20	Hs~Ref:NM_006503.1~uORF:IOH3614	248	40	208
B23R20C10	23-10-20	Hs~Ref:NM_006503.1~uORF:IOH3614	299	49	250
B23R20C11	23-11-20	Hs~Ref:NM_013332.1~uORF:IOH4831	354	43	311
B23R20C12	23-12-20	Hs~Ref:NM_013332.1~uORF:IOH4831	330	44	286
B23R20C13	23-13-20	Hs~MGC:BC020646.1~uORF:IOH14210	901	85	816
B23R20C14	23-14-20	Hs~MGC:BC020646.1~uORF:IOH14210	135	77	58
B23R20C15	23-15-20	Hs~MGC:AB065760.1~uORF:IOH28256	307	49	258
B23R20C16	23-16-20	Hs~MGC:AB065760.1~uORF:IOH28256	176	51	125
B23R20C17	23-17-20	Hs~MGC:AB065508.1~uORF:IOH28316	490	62	428
B23R20C18	23-18-20	Hs~MGC:AB065508.1~uORF:IOH28316	129	74	55
B23R20C19	23-19-20	Hs~MGC:BC056878.1~uORF:IOH29056	486	54	432
B23R20C20	23-20-20	Hs~MGC:BC056878.1~uORF:IOH29056	476	42	434
B23R20C21	23-21-20	Hs~MGC:BC052964.1~uORF:IOH28843	231	45	186
B23R20C22	23-22-20	Hs~MGC:BC052964.1~uORF:IOH28843	93	41	52
B23R21C01	23-1-21	Hs~MGC:BC050711.2~uORF:IOH27066	179	39	140
B23R21C02	23-2-21	Hs~MGC:BC050711.2~uORF:IOH27066	291	177	114
B23R21C03	23-3-21	Hs~MGC:BC050524.1~uORF:IOH26923	198	64	134
B23R21C04	23-4-21	Hs~MGC:BC050524.1~uORF:IOH26923	165	44	121
B23R21C05	23-5-21	Hs~MGC:BC051909.1~uORF:IOH27067	41	41	0
B23R21C06	23-6-21	Hs~MGC:BC051909.1~uORF:IOH27067	44	43	1
B23R21C07	23-7-21	Hs~Ref:NM_006174.2~uORF:IOH27339	192	43	149
B23R21C08	23-8-21	Hs~Ref:NM_006174.2~uORF:IOH27339	207	42	165
B23R21C09	23-9-21	Hs~Ref:NP_002600.1~CAT_10514-H08H-25	40	39	1
B23R21C10	23-10-21	Hs~Ref:NP_002600.1~CAT_10514-H08H-25	39	39	0
B23R21C11	23-11-21	Internal_1007209	65535	46	65489
B23R21C12	23-12-21	Internal_1007209	65535	49	65486
B23R21C13	23-13-21	Hs~Ref:NP_001018016.1~CAT_12123-H02H-25	65535	65	65470
B23R21C14	23-14-21	Hs~Ref:NP_001018016.1~CAT_12123-H02H-25	65535	61	65474
B23R21C15	23-15-21	Internal_1007209	50	43	7
B23R21C16	23-16-21	Internal_1007209	46	41	5
B23R21C17	23-17-21	Hs~Ref:NP_000868.1~CAT_10126-H02H-25	22731	59	22672
B23R21C18	23-18-21	Hs~Ref:NP_000868.1~CAT_10126-H02H-25	22870	67	22803
B23R21C19	23-19-21	Internal_1007209	79	50	29
B23R21C20	23-20-21	Internal_1007209	68	41	27
B23R21C21	23-21-21	Internal_1007209	255	101	154
B23R21C22	23-22-21	Internal_1007209	206	118	88
B23R22C01	23-1-22	ERa~N/A	1796	40	1756
B23R22C02	23-2-22	ERa~N/A	2239	42	2197
B23R22C03	23-3-22	PKCeta~N/A	252	47	205
B23R22C04	23-4-22	PKCeta~N/A	240	44	196
B23R22C05	23-5-22	Calmodulin~N/A	84	41	43
B23R22C06	23-6-22	Calmodulin~N/A	68	45	23
B23R22C07	23-7-22	V5control5~N/A	2602	40	2562
B23R22C08	23-8-22	V5control5~N/A	2639	39	2600
B23R22C09	23-9-22	V5control4~N/A	199	58	141
B23R22C10	23-10-22	V5control4~N/A	148	49	99
B23R22C11	23-11-22	V5control3~N/A	79	41	38
B23R22C12	23-12-22	V5control3~N/A	86	42	44
B23R22C13	23-13-22	V5control2~N/A	63	44	19
B23R22C14	23-14-22	V5control2~N/A	949	49	900
B23R22C15	23-15-22	V5control1~N/A	49	42	7
B23R22C16	23-16-22	V5control1~N/A	52	39	13
B23R22C17	23-17-22	CMK2A~N/A	375	42	333
B23R22C18	23-18-22	CMK2A~N/A	381	43	338
B23R22C19	23-19-22	ERa~N/A	1647	41	1606
B23R22C20	23-20-22	ERa~N/A	1720	40	1680
B23R22C21	23-21-22	AlexaAntiMouseAb~N/A	11748	43	11705
B23R22C22	23-22-22	AlexaAntiMouseAb~N/A	10256	43	10213
B24R01C01	24-1-1	AlexaAntiMouseAb~N/A	37448	42	37406
B24R01C02	24-2-1	AlexaAntiMouseAb~N/A	35364	43	35321
B24R01C03	24-3-1	ERa~N/A	1808	41	1767
B24R01C04	24-4-1	ERa~N/A	2015	41	1974
B24R01C05	24-5-1	HumanIgG1~N/A	1138	42	1096
B24R01C06	24-6-1	HumanIgG1~N/A	1066	42	1024
B24R01C07	24-7-1	HumanIgG2~N/A	2332	41	2291
B24R01C08	24-8-1	HumanIgG2~N/A	2432	42	2390
B24R01C09	24-9-1	HumanIgG3~N/A	12261	42	12219
B24R01C10	24-10-1	HumanIgG3~N/A	11822	42	11780
B24R01C11	24-11-1	HumanIgG4~N/A	5326	47	5279
B24R01C12	24-12-1	HumanIgG4~N/A	36213	47	36166
B24R01C13	24-13-1	BiotinAb~N/A	317	96	221
B24R01C14	24-14-1	BiotinAb~N/A	243	47	196
B24R01C15	24-15-1	RanBP2deltaFG~N/A	254	48	206
B24R01C16	24-16-1	RanBP2deltaFG~N/A	252	44	208
B24R01C17	24-17-1	hMDM2~N/A	884	43	841
B24R01C18	24-18-1	hMDM2~N/A	860	42	818
B24R01C19	24-19-1	PKCeta~N/A	329	46	283
B24R01C20	24-20-1	PKCeta~N/A	204	48	156
B24R01C21	24-21-1	AlexaAntiMouseAb~N/A	32008	50	31958
B24R01C22	24-22-1	AlexaAntiMouseAb~N/A	30983	52	30931
B24R02C01	24-1-2	PKCeta~N/A	969	47	922
B24R02C02	24-2-2	PKCeta~N/A	974	56	918
B24R02C03	24-3-2	Buffer	200	88	112
B24R02C04	24-4-2	Buffer	203	65	138
B24R02C05	24-5-2	HumanIgA~N/A	17776	47	17729
B24R02C06	24-6-2	HumanIgA~N/A	18095	47	18048
B24R02C07	24-7-2	Buffer	77	61	16
B24R02C08	24-8-2	Buffer	223	48	175
B24R02C09	24-9-2	BSA~N/A	9548	43	9505
B24R02C10	24-10-2	BSA~N/A	9412	46	9366
B24R02C11	24-11-2	Hs~MGC:BC060758.1~uORF:IOH29250	799	247	552
B24R02C12	24-12-2	Hs~MGC:BC060758.1~uORF:IOH29250	721	55	666
B24R02C13	24-13-2	Hs~Ref:NM_014764.1~uORF:IOH6730	946	51	895
B24R02C14	24-14-2	Hs~Ref:NM_014764.1~uORF:IOH6730	1099	442	657
B24R02C15	24-15-2	Hs~Ref:NM_015201.3~uORF:IOH14400	531	68	463
B24R02C16	24-16-2	Hs~Ref:NM_015201.3~uORF:IOH14400	1377	398	979
B24R02C17	24-17-2	Hs~MGC:BC039576.1~uORF:IOH28775	1220	56	1164
B24R02C18	24-18-2	Hs~MGC:BC039576.1~uORF:IOH28775	57	58	-1
B24R02C19	24-19-2	Hs~MGC:BC011550.1~uORF:IOH12657	344	58	286
B24R02C20	24-20-2	Hs~MGC:BC011550.1~uORF:IOH12657	331	73	258
B24R02C21	24-21-2	Hs~MGC:BC018847.1~uORF:IOH14862	5572	70	5502
B24R02C22	24-22-2	Hs~MGC:BC018847.1~uORF:IOH14862	5001	62	4939
B24R03C01	24-1-3	Hs~MGC:BC012876.1~uORF:IOH10177	17911	48	17863
B24R03C02	24-2-3	Hs~MGC:BC012876.1~uORF:IOH10177	17914	54	17860
B24R03C03	24-3-3	Hs~Ref:NM_003720.1~uORF:IOH3819	741	48	693
B24R03C04	24-4-3	Hs~Ref:NM_003720.1~uORF:IOH3819	769	48	721
B24R03C05	24-5-3	Hs~MGC:BC069505.1~uORF:IOH40261	321	84	237
B24R03C06	24-6-3	Hs~MGC:BC069505.1~uORF:IOH40261	325	89	236
B24R03C07	24-7-3	Hs~Ref:NM_139348.1~uORF:IOH37807	388	187	201
B24R03C08	24-8-3	Hs~Ref:NM_139348.1~uORF:IOH37807	387	71	316
B24R03C09	24-9-3	Hs~Ref:NM_002365.3~uORF:IOH40373	403	49	354
B24R03C10	24-10-3	Hs~Ref:NM_002365.3~uORF:IOH40373	373	53	320
B24R03C11	24-11-3	Hs~Ref:NM_201567.1~uORF:IOH37812	54	134	-80
B24R03C12	24-12-3	Hs~Ref:NM_201567.1~uORF:IOH37812	730	155	575
B24R03C13	24-13-3	Hs~Ref:NM_181578.1~uORF:IOH45838	594	63	531
B24R03C14	24-14-3	Hs~Ref:NM_181578.1~uORF:IOH45838	46	58	-12
B24R03C15	24-15-3	Hs~Ref:NM_017847.3~uORF:IOH45570	1238	127	1111
B24R03C16	24-16-3	Hs~Ref:NM_017847.3~uORF:IOH45570	1333	88	1245
B24R03C17	24-17-3	Hs~Ref:NM_005469.2~uORF:IOH41012	2957	55	2902
B24R03C18	24-18-3	Hs~Ref:NM_005469.2~uORF:IOH41012	3040	55	2985
B24R03C19	24-19-3	Hs~Ref:NM_172160.1~uORF:IOH35727	9929	94	9835
B24R03C20	24-20-3	Hs~Ref:NM_172160.1~uORF:IOH35727	9624	117	9507
B24R03C21	24-21-3	Hs~MGC:BC018122.1~uORF:IOH10873	578	70	508
B24R03C22	24-22-3	Hs~MGC:BC018122.1~uORF:IOH10873	677	539	138
B24R04C01	24-1-4	Hs~MGC:BC027486.1~uORF:IOH22849	373	44	329
B24R04C02	24-2-4	Hs~MGC:BC027486.1~uORF:IOH22849	406	50	356
B24R04C03	24-3-4	Hs~Ref:NM_004291.1~uORF:IOH22771	337	44	293
B24R04C04	24-4-4	Hs~Ref:NM_004291.1~uORF:IOH22771	327	42	285
B24R04C05	24-5-4	Hs~MGC:BC029524.1~uORF:IOH22562	1561	49	1512
B24R04C06	24-6-4	Hs~MGC:BC029524.1~uORF:IOH22562	1515	52	1463
B24R04C07	24-7-4	Hs~MGC:BC008141.1~uORF:IOH10197	351	51	300
B24R04C08	24-8-4	Hs~MGC:BC008141.1~uORF:IOH10197	394	95	299
B24R04C09	24-9-4	Hs~Ref:NM_053285.1~uORF:IOH10741	535	44	491
B24R04C10	24-10-4	Hs~Ref:NM_053285.1~uORF:IOH10741	578	45	533
B24R04C11	24-11-4	Hs~MGC:BC012609.1~uORF:IOH12212	647	88	559
B24R04C12	24-12-4	Hs~MGC:BC012609.1~uORF:IOH12212	681	94	587
B24R04C13	24-13-4	Hs~Ref:NM_014372.1~uORF:IOH11235	194	47	147
B24R04C14	24-14-4	Hs~Ref:NM_014372.1~uORF:IOH11235	205	47	158
B24R04C15	24-15-4	Hs~MGC:BC022436.1~uORF:IOH29340	222	58	164
B24R04C16	24-16-4	Hs~MGC:BC022436.1~uORF:IOH29340	207	59	148
B24R04C17	24-17-4	Hs~Ref:NM_022074.2~uORF:IOH38055	57	73	-16
B24R04C18	24-18-4	Hs~Ref:NM_022074.2~uORF:IOH38055	42	66	-24
B24R04C19	24-19-4	Hs~Ref:NM_032943.2~uORF:IOH38478	3037	73	2964
B24R04C20	24-20-4	Hs~Ref:NM_032943.2~uORF:IOH38478	3036	73	2963
B24R04C21	24-21-4	Hs~Ref:NM_024915.1~uORF:IOH38073	327	59	268
B24R04C22	24-22-4	Hs~Ref:NM_024915.1~uORF:IOH38073	54	66	-12
B24R05C01	24-1-5	Hs~MGC:BC022407.1~uORF:IOH13027	422	47	375
B24R05C02	24-2-5	Hs~MGC:BC022407.1~uORF:IOH13027	464	59	405
B24R05C03	24-3-5	Hs~MGC:BC020843.1~uORF:IOH12055	513	52	461
B24R05C04	24-4-5	Hs~MGC:BC020843.1~uORF:IOH12055	382	45	337
B24R05C05	24-5-5	Hs~Ref:NM_016186.1~uORF:IOH12195	506	47	459
B24R05C06	24-6-5	Hs~Ref:NM_016186.1~uORF:IOH12195	469	45	424
B24R05C07	24-7-5	Hs~Ref:NM_014485.1~uORF:IOH13026	519	45	474
B24R05C08	24-8-5	Hs~Ref:NM_014485.1~uORF:IOH13026	526	45	481
B24R05C09	24-9-5	Hs~Ref:NM_004586.1~N/A	553	45	508
B24R05C10	24-10-5	Hs~Ref:NM_004586.1~N/A	506	47	459
B24R05C11	24-11-5	Hs~Ref:NM_003952.1~N/A	277	46	231
B24R05C12	24-12-5	Hs~Ref:NM_003952.1~N/A	50	53	-3
B24R05C13	24-13-5	Hs~Ref:NM_019884.1~N/A	547	45	502
B24R05C14	24-14-5	Hs~Ref:NM_019884.1~N/A	595	51	544
B24R05C15	24-15-5	Hs~Ref:NM_007064.1~N/A	633	303	330
B24R05C16	24-16-5	Hs~Ref:NM_007064.1~N/A	363	55	308
B24R05C17	24-17-5	Hs~MGC:BC024244.1~uORF:IOH40194	711	377	334
B24R05C18	24-18-5	Hs~MGC:BC024244.1~uORF:IOH40194	547	53	494
B24R05C19	24-19-5	Hs~Ref:NM_004991.1~uORF:IOH40284	796	66	730
B24R05C20	24-20-5	Hs~Ref:NM_004991.1~uORF:IOH40284	764	71	693
B24R05C21	24-21-5	Hs~Ref:NM_170610.2~uORF:IOH40168	901	58	843
B24R05C22	24-22-5	Hs~Ref:NM_170610.2~uORF:IOH40168	1118	541	577
B24R06C01	24-1-6	Hs~Ref:NM_000588.3~uORF:IOH40240	649	52	597
B24R06C02	24-2-6	Hs~Ref:NM_000588.3~uORF:IOH40240	675	77	598
B24R06C03	24-3-6	Hs~MGC:BC017926.1~uORF:IOH13470	558	51	507
B24R06C04	24-4-6	Hs~MGC:BC017926.1~uORF:IOH13470	785	46	739
B24R06C05	24-5-6	Hs~Ref:NM_018457.1~uORF:IOH23026	4202	49	4153
B24R06C06	24-6-6	Hs~Ref:NM_018457.1~uORF:IOH23026	4193	47	4146
B24R06C07	24-7-6	Hs~MGC:BC022378.1~uORF:IOH13502	933	43	890
B24R06C08	24-8-6	Hs~MGC:BC022378.1~uORF:IOH13502	872	43	829
B24R06C09	24-9-6	Hs~MGC:BC006234.1~uORF:IOH6300	1014	47	967
B24R06C10	24-10-6	Hs~MGC:BC006234.1~uORF:IOH6300	1037	51	986
B24R06C11	24-11-6	Hs~Ref:NM_004987.3~uORF:IOH55033	65535	47	65488
B24R06C12	24-12-6	Hs~Ref:NM_004987.3~uORF:IOH55033	65535	54	65481
B24R06C13	24-13-6	Hs~Ref:NM_004184.3~uORF:IOH59105	49	86	-37
B24R06C14	24-14-6	Hs~Ref:NM_004184.3~uORF:IOH59105	609	428	181
B24R06C15	24-15-6	Hs~Ref:NM_001006946.1~uORF:IOH54992	683	65	618
B24R06C16	24-16-6	Hs~Ref:NM_001006946.1~uORF:IOH54992	48	137	-89
B24R06C17	24-17-6	Hs~Ref:NM_020456.1~uORF:IOH59677	208	53	155
B24R06C18	24-18-6	Hs~Ref:NM_020456.1~uORF:IOH59677	39	56	-17
B24R06C19	24-19-6	Hs~MGC:BC030214.1~uORF:IOH22591	486	73	413
B24R06C20	24-20-6	Hs~MGC:BC030214.1~uORF:IOH22591	106	131	-25
B24R06C21	24-21-6	Hs~Ref:NM_152572.2~uORF:IOH22800	554	69	485
B24R06C22	24-22-6	Hs~Ref:NM_152572.2~uORF:IOH22800	42	204	-162
B24R07C01	24-1-7	Hs~Ref:NM_145691.3~uORF:IOH23101	2492	48	2444
B24R07C02	24-2-7	Hs~Ref:NM_145691.3~uORF:IOH23101	2444	57	2387
B24R07C03	24-3-7	Hs~MGC:BC032518.1~uORF:IOH21930	814	46	768
B24R07C04	24-4-7	Hs~MGC:BC032518.1~uORF:IOH21930	909	46	863
B24R07C05	24-5-7	Hs~MGC:BC014679.1~uORF:IOH10445	496	46	450
B24R07C06	24-6-7	Hs~MGC:BC014679.1~uORF:IOH10445	450	44	406
B24R07C07	24-7-7	Hs~Ref:NM_014331.2~uORF:IOH13064	540	46	494
B24R07C08	24-8-7	Hs~Ref:NM_014331.2~uORF:IOH13064	544	48	496
B24R07C09	24-9-7	Hs~MGC:BC005111.1~uORF:IOH6655	981	63	918
B24R07C10	24-10-7	Hs~MGC:BC005111.1~uORF:IOH6655	997	135	862
B24R07C11	24-11-7	Hs~Ref:NM_005653.2~uORF:IOH5160	986	51	935
B24R07C12	24-12-7	Hs~Ref:NM_005653.2~uORF:IOH5160	967	46	921
B24R07C13	24-13-7	Hs~MGC:BC010704.1~uORF:IOH9730	517	61	456
B24R07C14	24-14-7	Hs~MGC:BC010704.1~uORF:IOH9730	440	65	375
B24R07C15	24-15-7	Hs~MGC:BC015056.1~uORF:IOH10144	231	48	183
B24R07C16	24-16-7	Hs~MGC:BC015056.1~uORF:IOH10144	596	198	398
B24R07C17	24-17-7	Hs~Ref:NM_145265.1~uORF:IOH10426	60	55	5
B24R07C18	24-18-7	Hs~Ref:NM_145265.1~uORF:IOH10426	156	56	100
B24R07C19	24-19-7	Hs~MGC:BC015725.1~uORF:IOH10141	92	57	35
B24R07C20	24-20-7	Hs~MGC:BC015725.1~uORF:IOH10141	211	51	160
B24R07C21	24-21-7	Hs~MGC:BC033748.1~uORF:IOH21858	253	46	207
B24R07C22	24-22-7	Hs~MGC:BC033748.1~uORF:IOH21858	109	63	46
B24R08C01	24-1-8	Hs~Ref:NM_148176.1~uORF:IOH4678	1000	43	957
B24R08C02	24-2-8	Hs~Ref:NM_148176.1~uORF:IOH4678	975	45	930
B24R08C03	24-3-8	Hs~MGC:BC040053.1~uORF:IOH26397	496	46	450
B24R08C04	24-4-8	Hs~MGC:BC040053.1~uORF:IOH26397	503	49	454
B24R08C05	24-5-8	Hs~MGC:BC047443.1~uORF:IOH26545	299	47	252
B24R08C06	24-6-8	Hs~MGC:BC047443.1~uORF:IOH26545	130	48	82
B24R08C07	24-7-8	Hs~Ref:NM_177996.1~uORF:IOH14498	434	53	381
B24R08C08	24-8-8	Hs~Ref:NM_177996.1~uORF:IOH14498	384	61	323
B24R08C09	24-9-8	Hs~Ref:NM_032448.1~uORF:IOH13366	3128	62	3066
B24R08C10	24-10-8	Hs~Ref:NM_032448.1~uORF:IOH13366	2927	55	2872
B24R08C11	24-11-8	Hs~Ref:NM_005733.1~uORF:IOH13299	1763	46	1717
B24R08C12	24-12-8	Hs~Ref:NM_005733.1~uORF:IOH13299	1837	44	1793
B24R08C13	24-13-8	Hs~MGC:BC012349.1~uORF:IOH12510	484	48	436
B24R08C14	24-14-8	Hs~MGC:BC012349.1~uORF:IOH12510	571	52	519
B24R08C15	24-15-8	Hs~Ref:NM_004683.4~uORF:IOH42883	367	51	316
B24R08C16	24-16-8	Hs~Ref:NM_004683.4~uORF:IOH42883	651	46	605
B24R08C17	24-17-8	Hs~Ref:NM_004397.3~uORF:IOH45655	2551	45	2506
B24R08C18	24-18-8	Hs~Ref:NM_004397.3~uORF:IOH45655	2620	45	2575
B24R08C19	24-19-8	Hs~Ref:NM_032472.3~uORF:IOH44558	1004	45	959
B24R08C20	24-20-8	Hs~Ref:NM_032472.3~uORF:IOH44558	1025	45	980
B24R08C21	24-21-8	Hs~Ref:NM_207459.1~uORF:IOH45617	892	47	845
B24R08C22	24-22-8	Hs~Ref:NM_207459.1~uORF:IOH45617	989	47	942
B24R09C01	24-1-9	Hs~Ref:NM_001445.1~uORF:IOH54608	189	51	138
B24R09C02	24-2-9	Hs~Ref:NM_001445.1~uORF:IOH54608	102	48	54
B24R09C03	24-3-9	Hs~Ref:NM_001007232.1~uORF:IOH58619	179	149	30
B24R09C04	24-4-9	Hs~Ref:NM_001007232.1~uORF:IOH58619	165	138	27
B24R09C05	24-5-9	Hs~Ref:NM_001031.4~uORF:IOH58930	575	46	529
B24R09C06	24-6-9	Hs~Ref:NM_001031.4~uORF:IOH58930	615	47	568
B24R09C07	24-7-9	Hs~Ref:NM_015015.1~uORF:IOH53632	2981	61	2920
B24R09C08	24-8-9	Hs~Ref:NM_015015.1~uORF:IOH53632	2796	75	2721
B24R09C09	24-9-9	Hs~MGC:BC021709.2~uORF:IOH56019	130	43	87
B24R09C10	24-10-9	Hs~MGC:BC021709.2~uORF:IOH56019	133	41	92
B24R09C11	24-11-9	Hs~MGC:BC069530.1~uORF:IOH56631	191	42	149
B24R09C12	24-12-9	Hs~MGC:BC069530.1~uORF:IOH56631	396	79	317
B24R09C13	24-13-9	Hs~Ref:NM_003367.2~uORF:IOH57272	625	43	582
B24R09C14	24-14-9	Hs~Ref:NM_003367.2~uORF:IOH57272	628	44	584
B24R09C15	24-15-9	Hs~MGC:BC053836.1~uORF:IOH57277	443	45	398
B24R09C16	24-16-9	Hs~MGC:BC053836.1~uORF:IOH57277	425	46	379
B24R09C17	24-17-9	Hs~Ref:NM_006995.2~uORF:IOH14772	440	46	394
B24R09C18	24-18-9	Hs~Ref:NM_006995.2~uORF:IOH14772	436	45	391
B24R09C19	24-19-9	Hs~Ref:NM_014077.1~uORF:IOH4219	568	46	522
B24R09C20	24-20-9	Hs~Ref:NM_014077.1~uORF:IOH4219	563	47	516
B24R09C21	24-21-9	Hs~Ref:NM_018948.2~uORF:IOH14139	823	47	776
B24R09C22	24-22-9	Hs~Ref:NM_018948.2~uORF:IOH14139	63	48	15
B24R10C01	24-1-10	Hs~MGC:BC002622.1~uORF:IOH4142	557	42	515
B24R10C02	24-2-10	Hs~MGC:BC002622.1~uORF:IOH4142	414	44	370
B24R10C03	24-3-10	Hs~Ref:NM_022480.2~uORF:IOH21555	537	44	493
B24R10C04	24-4-10	Hs~Ref:NM_022480.2~uORF:IOH21555	569	44	525
B24R10C05	24-5-10	Hs~MGC:BC032485.1~uORF:IOH21724	712	42	670
B24R10C06	24-6-10	Hs~MGC:BC032485.1~uORF:IOH21724	741	42	699
B24R10C07	24-7-10	Hs~Ref:NM_022822.1~uORF:IOH22120	5305	50	5255
B24R10C08	24-8-10	Hs~Ref:NM_022822.1~uORF:IOH22120	5194	55	5139
B24R10C09	24-9-10	Hs~Ref:NM_012175.3~uORF:IOH26934	626	44	582
B24R10C10	24-10-10	Hs~Ref:NM_012175.3~uORF:IOH26934	595	41	554
B24R10C11	24-11-10	GST1	43	42	1
B24R10C12	24-12-10	GST1	45	42	3
B24R10C13	24-13-10	GST2	48	41	7
B24R10C14	24-14-10	GST2	45	41	4
B24R10C15	24-15-10	GST3	52	43	9
B24R10C16	24-16-10	GST3	53	44	9
B24R10C17	24-17-10	GST4	70	42	28
B24R10C18	24-18-10	GST4	385	50	335
B24R10C19	24-19-10	Anti-HumanIgA1~N/A	6978	44	6934
B24R10C20	24-20-10	Anti-HumanIgA1~N/A	7291	45	7246
B24R10C21	24-21-10	Anti-HumanIgA2~N/A	13821	45	13776
B24R10C22	24-22-10	Anti-HumanIgA2~N/A	13958	44	13914
B24R11C01	24-1-11	AlexaAntiMouseAb~N/A	24709	41	24668
B24R11C02	24-2-11	AlexaAntiMouseAb~N/A	23701	42	23659
B24R11C03	24-3-11	MAPKAP~N/A	87	42	45
B24R11C04	24-4-11	MAPKAP~N/A	121	58	63
B24R11C05	24-5-11	Buffer	95	44	51
B24R11C06	24-6-11	Buffer	99	42	57
B24R11C07	24-7-11	BSA~N/A	8322	41	8281
B24R11C08	24-8-11	BSA~N/A	8146	41	8105
B24R11C09	24-9-11	Anti-HumanIgG1~N/A	1494	42	1452
B24R11C10	24-10-11	Anti-HumanIgG1~N/A	1522	43	1479
B24R11C11	24-11-11	Anti-HumanIgG2~N/A	3079	43	3036
B24R11C12	24-12-11	Anti-HumanIgG2~N/A	3057	44	3013
B24R11C13	24-13-11	Anti-HumanIgG3~N/A	5643	43	5600
B24R11C14	24-14-11	Anti-HumanIgG3~N/A	5436	42	5394
B24R11C15	24-15-11	Anti-HumanIgG4~N/A	10817	44	10773
B24R11C16	24-16-11	Anti-HumanIgG4~N/A	10515	44	10471
B24R11C17	24-17-11	AntiBiotinAb~N/A	10776	45	10731
B24R11C18	24-18-11	AntiBiotinAb~N/A	10611	47	10564
B24R11C19	24-19-11	Buffer	49	42	7
B24R11C20	24-20-11	Buffer	50	42	8
B24R11C21	24-21-11	Hs~Ref:NM_006854.2~uORF:IOH5849	458	43	415
B24R11C22	24-22-11	Hs~Ref:NM_006854.2~uORF:IOH5849	496	41	455
B24R12C01	24-1-12	Hs~Ref:NM_000154.1~uORF:IOH4535	624	41	583
B24R12C02	24-2-12	Hs~Ref:NM_000154.1~uORF:IOH4535	631	42	589
B24R12C03	24-3-12	Hs~Ref:NM_130439.1~uORF:IOH10857	652	43	609
B24R12C04	24-4-12	Hs~Ref:NM_130439.1~uORF:IOH10857	660	45	615
B24R12C05	24-5-12	Hs~Ref:NM_002503.2~uORF:IOH11051	815	45	770
B24R12C06	24-6-12	Hs~Ref:NM_002503.2~uORF:IOH11051	828	44	784
B24R12C07	24-7-12	Hs~Ref:NM_138415.1~uORF:IOH13483	922	42	880
B24R12C08	24-8-12	Hs~Ref:NM_138415.1~uORF:IOH13483	926	45	881
B24R12C09	24-9-12	Hs~MGC:NM_173501.1~uORF:IOH11653	697	61	636
B24R12C10	24-10-12	Hs~MGC:NM_173501.1~uORF:IOH11653	796	80	716
B24R12C11	24-11-12	Hs~Ref:NM_012200.2~uORF:IOH6746	1005	55	950
B24R12C12	24-12-12	Hs~Ref:NM_012200.2~uORF:IOH6746	1192	537	655
B24R12C13	24-13-12	Hs~MGC:BC012176.1~uORF:IOH13364	829	236	593
B24R12C14	24-14-12	Hs~MGC:BC012176.1~uORF:IOH13364	653	47	606
B24R12C15	24-15-12	Hs~MGC:BC062625.1~uORF:IOH39875	52	47	5
B24R12C16	24-16-12	Hs~MGC:BC062625.1~uORF:IOH39875	90	43	47
B24R12C17	24-17-12	Hs~Ref:NM_207356.1~uORF:IOH40044	607	58	549
B24R12C18	24-18-12	Hs~Ref:NM_207356.1~uORF:IOH40044	609	421	188
B24R12C19	24-19-12	Hs~Ref:NM_138698.2~uORF:IOH36253	160	46	114
B24R12C20	24-20-12	Hs~Ref:NM_138698.2~uORF:IOH36253	140	44	96
B24R12C21	24-21-12	Hs~MGC:BC064532.1~uORF:IOH39909	125	44	81
B24R12C22	24-22-12	Hs~MGC:BC064532.1~uORF:IOH39909	118	43	75
B24R13C01	24-1-13	Hs~MGC:BC022083.2~uORF:IOH22422	1184	41	1143
B24R13C02	24-2-13	Hs~MGC:BC022083.2~uORF:IOH22422	1155	43	1112
B24R13C03	24-3-13	Hs~MGC:BC033035.1~uORF:IOH22449	2242	48	2194
B24R13C04	24-4-13	Hs~MGC:BC033035.1~uORF:IOH22449	2206	50	2156
B24R13C05	24-5-13	Hs~MGC:BC027978.1~uORF:IOH11454	397	46	351
B24R13C06	24-6-13	Hs~MGC:BC027978.1~uORF:IOH11454	431	45	386
B24R13C07	24-7-13	Hs~Ref:NM_058199.1~uORF:IOH4375	499	46	453
B24R13C08	24-8-13	Hs~Ref:NM_058199.1~uORF:IOH4375	512	50	462
B24R13C09	24-9-13	Hs~MGC:BC033736.1~uORF:IOH21824	9038	83	8955
B24R13C10	24-10-13	Hs~MGC:BC033736.1~uORF:IOH21824	8849	98	8751
B24R13C11	24-11-13	Hs~Ref:NM_013431.1~uORF:IOH12166	2676	58	2618
B24R13C12	24-12-13	Hs~Ref:NM_013431.1~uORF:IOH12166	2683	48	2635
B24R13C13	24-13-13	Hs~MGC:BC022297.1~uORF:IOH12908	565	66	499
B24R13C14	24-14-13	Hs~MGC:BC022297.1~uORF:IOH12908	598	225	373
B24R13C15	24-15-13	Hs~MGC:BC012620.1~uORF:IOH12299	280	45	235
B24R13C16	24-16-13	Hs~MGC:BC012620.1~uORF:IOH12299	59	49	10
B24R13C17	24-17-13	Hs~MGC:BC035716.2~uORF:IOH28745	47	47	0
B24R13C18	24-18-13	Hs~MGC:BC035716.2~uORF:IOH28745	165	48	117
B24R13C19	24-19-13	Hs~MGC:BC053508.1~uORF:IOH29392	166	45	121
B24R13C20	24-20-13	Hs~MGC:BC053508.1~uORF:IOH29392	152	46	106
B24R13C21	24-21-13	Hs~MGC:BC056150.1~uORF:IOH29126	299	49	250
B24R13C22	24-22-13	Hs~MGC:BC056150.1~uORF:IOH29126	470	78	392
B24R14C01	24-1-14	Hs~MGC:BC058906.1~uORF:IOH29100	337	44	293
B24R14C02	24-2-14	Hs~MGC:BC058906.1~uORF:IOH29100	335	44	291
B24R14C03	24-3-14	Hs~MGC:BC006005.1~uORF:IOH7509	1076	47	1029
B24R14C04	24-4-14	Hs~MGC:BC006005.1~uORF:IOH7509	1056	46	1010
B24R14C05	24-5-14	Hs~Ref:NM_002865.1~uORF:IOH5825	416	45	371
B24R14C06	24-6-14	Hs~Ref:NM_002865.1~uORF:IOH5825	425	44	381
B24R14C07	24-7-14	Hs~Ref:NM_015342.1~uORF:IOH10863	2674	46	2628
B24R14C08	24-8-14	Hs~Ref:NM_015342.1~uORF:IOH10863	2685	46	2639
B24R14C09	24-9-14	Hs~Ref:NM_032377.2~uORF:IOH6191	1816	53	1763
B24R14C10	24-10-14	Hs~Ref:NM_032377.2~uORF:IOH6191	1556	54	1502
B24R14C11	24-11-14	Hs~MGC:BC001728.1~uORF:IOH4430	446	46	400
B24R14C12	24-12-14	Hs~MGC:BC001728.1~uORF:IOH4430	433	42	391
B24R14C13	24-13-14	Hs~Ref:NM_006408.2~uORF:IOH10438	432	46	386
B24R14C14	24-14-14	Hs~Ref:NM_006408.2~uORF:IOH10438	43	59	-16
B24R14C15	24-15-14	Hs~Ref:NM_007006.1~uORF:IOH4064	1081	44	1037
B24R14C16	24-16-14	Hs~Ref:NM_007006.1~uORF:IOH4064	893	49	844
B24R14C17	24-17-14	Hs~MGC:BC031074.1~uORF:IOH22532	44	54	-10
B24R14C18	24-18-14	Hs~MGC:BC031074.1~uORF:IOH22532	49	53	-4
B24R14C19	24-19-14	Hs~MGC:BC004174.1~uORF:IOH3773	44	54	-10
B24R14C20	24-20-14	Hs~MGC:BC004174.1~uORF:IOH3773	54	64	-10
B24R14C21	24-21-14	Hs~Ref:NM_005130.1~uORF:IOH3926	55	59	-4
B24R14C22	24-22-14	Hs~Ref:NM_005130.1~uORF:IOH3926	250	48	202
B24R15C01	24-1-15	Hs~MGC:BC025781.1~uORF:IOH11788	284	42	242
B24R15C02	24-2-15	Hs~MGC:BC025781.1~uORF:IOH11788	318	44	274
B24R15C03	24-3-15	Hs~MGC:NM_174891.2~uORF:IOH11682	339	43	296
B24R15C04	24-4-15	Hs~MGC:NM_174891.2~uORF:IOH11682	315	43	272
B24R15C05	24-5-15	Hs~MGC:BC015417.2~uORF:IOH11018	618	43	575
B24R15C06	24-6-15	Hs~MGC:BC015417.2~uORF:IOH11018	632	43	589
B24R15C07	24-7-15	Hs~MGC:BC032455.1~uORF:IOH21667	354	42	312
B24R15C08	24-8-15	Hs~MGC:BC032455.1~uORF:IOH21667	370	41	329
B24R15C09	24-9-15	Hs~Ref:NM_006298.2~uORF:IOH34757	3138	42	3096
B24R15C10	24-10-15	Hs~Ref:NM_006298.2~uORF:IOH34757	3209	43	3166
B24R15C11	24-11-15	Hs~Ref:NM_004114.2~uORF:IOH13832	745	42	703
B24R15C12	24-12-15	Hs~Ref:NM_004114.2~uORF:IOH13832	768	41	727
B24R15C13	24-13-15	Hs~Ref:NM_002944.2~CAT:PV3814	143	43	100
B24R15C14	24-14-15	Hs~Ref:NM_002944.2~CAT:PV3814	152	44	108
B24R15C15	24-15-15	Hs~Ref:NM_001626.2~CAT:PV3184	46	50	-4
B24R15C16	24-16-15	Hs~Ref:NM_001626.2~CAT:PV3184	44	55	-11
B24R15C17	24-17-15	Hs~Ref:NM_001007097.1~CAT:PV3616	47	55	-8
B24R15C18	24-18-15	Hs~Ref:NM_001007097.1~CAT:PV3616	49	59	-10
B24R15C19	24-19-15	Hs~Ref:NM_020666.2~CAT:PV3839	44	58	-14
B24R15C20	24-20-15	Hs~Ref:NM_020666.2~CAT:PV3839	46	58	-12
B24R15C21	24-21-15	Hs~Ref:NM_000222.1~CAT:PV4132	56	49	7
B24R15C22	24-22-15	Hs~Ref:NM_000222.1~CAT:PV4132	56	49	7
B24R16C01	24-1-16	Hs~Ref:NM_172220.1~CAT_PHC2035	67	47	20
B24R16C02	24-2-16	Hs~Ref:NM_172220.1~CAT_PHC2035	59	41	18
B24R16C03	24-3-16	Hs~Ref:NM_018650.1~CAT:PV4395	3906	45	3861
B24R16C04	24-4-16	Hs~Ref:NM_018650.1~CAT:PV4395	3717	46	3671
B24R16C05	24-5-16	Hs~N/A:NM_002745.2~CAT:PV3314	12401	42	12359
B24R16C06	24-6-16	Hs~N/A:NM_002745.2~CAT:PV3314	12315	41	12274
B24R16C07	24-7-16	Hs~Ref:NM_001039517.1~uORF:IOH63103	472	41	431
B24R16C08	24-8-16	Hs~Ref:NM_001039517.1~uORF:IOH63103	444	41	403
B24R16C09	24-9-16	Hs~MGC:BC032889.1~uORF:IOH62262	303	47	256
B24R16C10	24-10-16	Hs~MGC:BC032889.1~uORF:IOH62262	291	43	248
B24R16C11	24-11-16	Hs~Ref:NM_001025092.1~uORF:IOH63097	872	42	830
B24R16C12	24-12-16	Hs~Ref:NM_001025092.1~uORF:IOH63097	1078	40	1038
B24R16C13	24-13-16	Hs~MGC:BC004205.2~uORF:IOH62903	542	42	500
B24R16C14	24-14-16	Hs~MGC:BC004205.2~uORF:IOH62903	59	50	9
B24R16C15	24-15-16	Hs~MGC:BC032749.1~uORF:IOH56253	48	59	-11
B24R16C16	24-16-16	Hs~MGC:BC032749.1~uORF:IOH56253	46	71	-25
B24R16C17	24-17-16	Hs~Ref:NM_005552.3~uORF:IOH57028	44	60	-16
B24R16C18	24-18-16	Hs~Ref:NM_005552.3~uORF:IOH57028	43	54	-11
B24R16C19	24-19-16	Hs~MGC:BC008040.2~uORF:IOH57008	47	53	-6
B24R16C20	24-20-16	Hs~MGC:BC008040.2~uORF:IOH57008	121	65	56
B24R16C21	24-21-16	Hs~MGC:BC008874.2~uORF:IOH57034	52	52	0
B24R16C22	24-22-16	Hs~MGC:BC008874.2~uORF:IOH57034	81	49	32
B24R17C01	24-1-17	Hs~MGC:BC093745.1~uORF:IOH61986	293	114	179
B24R17C02	24-2-17	Hs~MGC:BC093745.1~uORF:IOH61986	239	46	193
B24R17C03	24-3-17	Hs~MGC:BC093990.1~uORF:IOH62017	13401	47	13354
B24R17C04	24-4-17	Hs~MGC:BC093990.1~uORF:IOH62017	12430	51	12379
B24R17C05	24-5-17	Hs~MGC:BC031258.1~uORF:IOH62179	314	53	261
B24R17C06	24-6-17	Hs~MGC:BC031258.1~uORF:IOH62179	306	44	262
B24R17C07	24-7-17	Hs~Ref:NM_024626.2~uORF:IOH61921	251	45	206
B24R17C08	24-8-17	Hs~Ref:NM_024626.2~uORF:IOH61921	234	51	183
B24R17C09	24-9-17	Hs~MGC:BC013319.1~uORF:IOH12891	444	40	404
B24R17C10	24-10-17	Hs~MGC:BC013319.1~uORF:IOH12891	453	41	412
B24R17C11	24-11-17	Hs~MGC:BC022854.1~uORF:IOH12377	396	41	355
B24R17C12	24-12-17	Hs~MGC:BC022854.1~uORF:IOH12377	436	40	396
B24R17C13	24-13-17	Hs~MGC:BC012569.1~uORF:IOH12120	371	41	330
B24R17C14	24-14-17	Hs~MGC:BC012569.1~uORF:IOH12120	42	74	-32
B24R17C15	24-15-17	Hs~MGC:BC020942.1~uORF:IOH11137	631	214	417
B24R17C16	24-16-17	Hs~MGC:BC020942.1~uORF:IOH11137	39	92	-53
B24R17C17	24-17-17	Hs~MGC:BC000201.1~uORF:IOH4385	106	55	51
B24R17C18	24-18-17	Hs~MGC:BC000201.1~uORF:IOH4385	230	49	181
B24R17C19	24-19-17	Hs~Ref:NM_005174.2~uORF:IOH45903	244	53	191
B24R17C20	24-20-17	Hs~Ref:NM_005174.2~uORF:IOH45903	49	51	-2
B24R17C21	24-21-17	Hs~Ref:NM_014678.3~uORF:IOH45905	1326	56	1270
B24R17C22	24-22-17	Hs~Ref:NM_014678.3~uORF:IOH45905	1269	44	1225
B24R18C01	24-1-18	Hs~Ref:NM_012121.4~uORF:IOH45907	2074	41	2033
B24R18C02	24-2-18	Hs~Ref:NM_012121.4~uORF:IOH45907	2055	43	2012
B24R18C03	24-3-18	Hs~MGC:BC007646.1~uORF:IOH7001	363	42	321
B24R18C04	24-4-18	Hs~MGC:BC007646.1~uORF:IOH7001	416	45	371
B24R18C05	24-5-18	Hs~MGC:BC047536.1~uORF:IOH27737	5760	46	5714
B24R18C06	24-6-18	Hs~MGC:BC047536.1~uORF:IOH27737	5675	43	5632
B24R18C07	24-7-18	Hs~MGC:BC048988.1~uORF:IOH26773	333	43	290
B24R18C08	24-8-18	Hs~MGC:BC048988.1~uORF:IOH26773	342	44	298
B24R18C09	24-9-18	Hs~MGC:BC057237.1~uORF:IOH29417	318	42	276
B24R18C10	24-10-18	Hs~MGC:BC057237.1~uORF:IOH29417	307	47	260
B24R18C11	24-11-18	Hs~MGC:BC017016.1~uORF:IOH10367	379	42	337
B24R18C12	24-12-18	Hs~MGC:BC017016.1~uORF:IOH10367	381	42	339
B24R18C13	24-13-18	Hs~Ref:NM_012279.1~uORF:IOH6492	628	41	587
B24R18C14	24-14-18	Hs~Ref:NM_012279.1~uORF:IOH6492	654	44	610
B24R18C15	24-15-18	Hs~MGC:BC056870.1~uORF:IOH29112	50	56	-6
B24R18C16	24-16-18	Hs~MGC:BC056870.1~uORF:IOH29112	49	64	-15
B24R18C17	24-17-18	Hs~MGC:BC053617.1~uORF:IOH29004	50	56	-6
B24R18C18	24-18-18	Hs~MGC:BC053617.1~uORF:IOH29004	214	48	166
B24R18C19	24-19-18	Hs~Ref:NM_153344.1~uORF:IOH40885	370	48	322
B24R18C20	24-20-18	Hs~Ref:NM_153344.1~uORF:IOH40885	219	52	167
B24R18C21	24-21-18	Hs~Ref:NM_180976.1~uORF:IOH43173	711	50	661
B24R18C22	24-22-18	Hs~Ref:NM_180976.1~uORF:IOH43173	1092	48	1044
B24R19C01	24-1-19	Hs~Ref:NM_006315.4~uORF:IOH41174	382	44	338
B24R19C02	24-2-19	Hs~Ref:NM_006315.4~uORF:IOH41174	408	44	364
B24R19C03	24-3-19	Hs~Ref:XM_373630.2~uORF:IOH41531	605	44	561
B24R19C04	24-4-19	Hs~Ref:XM_373630.2~uORF:IOH41531	597	43	554
B24R19C05	24-5-19	Hs~MGC:BC002369.1~N/A	324	44	280
B24R19C06	24-6-19	Hs~MGC:BC002369.1~N/A	321	44	277
B24R19C07	24-7-19	Hs~Ref:NM_004517.1~N/A	202	46	156
B24R19C08	24-8-19	Hs~Ref:NM_004517.1~N/A	180	67	113
B24R19C09	24-9-19	Hs~MGC:XM_291436.1~uORF:IOH28529	227	46	181
B24R19C10	24-10-19	Hs~MGC:XM_291436.1~uORF:IOH28529	314	45	269
B24R19C11	24-11-19	Hs~MGC:BC040606.1~uORF:IOH27734	374	43	331
B24R19C12	24-12-19	Hs~MGC:BC040606.1~uORF:IOH27734	378	42	336
B24R19C13	24-13-19	Hs~Ref:NM_001008660.1~uORF:IOH39850	702	42	660
B24R19C14	24-14-19	Hs~Ref:NM_001008660.1~uORF:IOH39850	707	43	664
B24R19C15	24-15-19	Hs~MGC:BC065918.1~uORF:IOH40465	346	52	294
B24R19C16	24-16-19	Hs~MGC:BC065918.1~uORF:IOH40465	299	56	243
B24R19C17	24-17-19	Hs~Ref:NM_004707.2~uORF:IOH40867	124	67	57
B24R19C18	24-18-19	Hs~Ref:NM_004707.2~uORF:IOH40867	115	56	59
B24R19C19	24-19-19	Hs~MGC:BC021988.1~uORF:IOH14635	526	52	474
B24R19C20	24-20-19	Hs~MGC:BC021988.1~uORF:IOH14635	649	56	593
B24R19C21	24-21-19	Hs~Ref:NM_031483.3~uORF:IOH52904	43	46	-3
B24R19C22	24-22-19	Hs~Ref:NM_031483.3~uORF:IOH52904	40	43	-3
B24R20C01	24-1-20	Hs~Ref:NM_024306.1~uORF:IOH5298	306	44	262
B24R20C02	24-2-20	Hs~Ref:NM_024306.1~uORF:IOH5298	334	43	291
B24R20C03	24-3-20	Hs~MGC:BC003606.1~uORF:IOH4960	311	43	268
B24R20C04	24-4-20	Hs~MGC:BC003606.1~uORF:IOH4960	328	44	284
B24R20C05	24-5-20	Hs~MGC:BC001610.1~uORF:IOH4912	218	62	156
B24R20C06	24-6-20	Hs~MGC:BC001610.1~uORF:IOH4912	221	59	162
B24R20C07	24-7-20	Hs~MGC:BC005212.1~uORF:IOH7144	134	50	84
B24R20C08	24-8-20	Hs~MGC:BC005212.1~uORF:IOH7144	136	53	83
B24R20C09	24-9-20	Hs~Ref:NM_080660.2~uORF:IOH6727	381	41	340
B24R20C10	24-10-20	Hs~Ref:NM_080660.2~uORF:IOH6727	381	41	340
B24R20C11	24-11-20	Hs~Ref:NM_080862.1~uORF:IOH6956	192	43	149
B24R20C12	24-12-20	Hs~Ref:NM_080862.1~uORF:IOH6956	197	43	154
B24R20C13	24-13-20	Hs~Ref:NM_002789.2~uORF:IOH7299	75	41	34
B24R20C14	24-14-20	Hs~Ref:NM_002789.2~uORF:IOH7299	68	42	26
B24R20C15	24-15-20	Hs~Ref:NM_006028.3~uORF:IOH34752	178	72	106
B24R20C16	24-16-20	Hs~Ref:NM_006028.3~uORF:IOH34752	137	47	90
B24R20C17	24-17-20	Hs~Ref:NM_018268.2~uORF:IOH25728	200	45	155
B24R20C18	24-18-20	Hs~Ref:NM_018268.2~uORF:IOH25728	45	57	-12
B24R20C19	24-19-20	Hs~Ref:NM_172238.1~uORF:IOH34861	1229	48	1181
B24R20C20	24-20-20	Hs~Ref:NM_172238.1~uORF:IOH34861	1305	48	1257
B24R20C21	24-21-20	Hs~Ref:NM_002371.2~uORF:IOH42398	58	75	-17
B24R20C22	24-22-20	Hs~Ref:NM_002371.2~uORF:IOH42398	48	55	-7
B24R21C01	24-1-21	Hs~MGC:BC022410.1~uORF:IOH13092	378	42	336
B24R21C02	24-2-21	Hs~MGC:BC022410.1~uORF:IOH13092	350	43	307
B24R21C03	24-3-21	Hs~MGC:BC031332.1~uORF:IOH23253	230	44	186
B24R21C04	24-4-21	Hs~MGC:BC031332.1~uORF:IOH23253	193	49	144
B24R21C05	24-5-21	Hs~Ref:NM_003889.2~uORF:IOH34726	264	43	221
B24R21C06	24-6-21	Hs~Ref:NM_003889.2~uORF:IOH34726	226	43	183
B24R21C07	24-7-21	Hs~Ref:NM_001030010.1~uORF:IOH23280	311	40	271
B24R21C08	24-8-21	Hs~Ref:NM_001030010.1~uORF:IOH23280	314	39	275
B24R21C09	24-9-21	Hs~Ref:NP_067004.3~CAT_11691-H08H-25	38	39	-1
B24R21C10	24-10-21	Hs~Ref:NP_067004.3~CAT_11691-H08H-25	38	39	-1
B24R21C11	24-11-21	Internal_1007209	44	40	4
B24R21C12	24-12-21	Internal_1007209	41	41	0
B24R21C13	24-13-21	Hs~Ref:NP_055747.1~CAT_12071-H08H-25	50	43	7
B24R21C14	24-14-21	Hs~Ref:NP_055747.1~CAT_12071-H08H-25	38	44	-6
B24R21C15	24-15-21	Internal_1007209	51	42	9
B24R21C16	24-16-21	Internal_1007209	46	48	-2
B24R21C17	24-17-21	Hs~Ref:NP_001267.2~CAT_11227-H08H-25	41	42	-1
B24R21C18	24-18-21	Hs~Ref:NP_001267.2~CAT_11227-H08H-25	40	42	-2
B24R21C19	24-19-21	Internal_1007209	41	43	-2
B24R21C20	24-20-21	Internal_1007209	189	44	145
B24R21C21	24-21-21	Internal_1007209	44	43	1
B24R21C22	24-22-21	Internal_1007209	73	41	32
B24R22C01	24-1-22	ERa~N/A	2880	41	2839
B24R22C02	24-2-22	ERa~N/A	2700	41	2659
B24R22C03	24-3-22	PKCeta~N/A	249	42	207
B24R22C04	24-4-22	PKCeta~N/A	259	41	218
B24R22C05	24-5-22	Calmodulin~N/A	104	43	61
B24R22C06	24-6-22	Calmodulin~N/A	59	41	18
B24R22C07	24-7-22	V5control5~N/A	288	42	246
B24R22C08	24-8-22	V5control5~N/A	342	40	302
B24R22C09	24-9-22	V5control4~N/A	90	39	51
B24R22C10	24-10-22	V5control4~N/A	170	44	126
B24R22C11	24-11-22	V5control3~N/A	64	40	24
B24R22C12	24-12-22	V5control3~N/A	63	39	24
B24R22C13	24-13-22	V5control2~N/A	49	40	9
B24R22C14	24-14-22	V5control2~N/A	54	39	15
B24R22C15	24-15-22	V5control1~N/A	49	40	9
B24R22C16	24-16-22	V5control1~N/A	50	42	8
B24R22C17	24-17-22	CMK2A~N/A	795	43	752
B24R22C18	24-18-22	CMK2A~N/A	734	42	692
B24R22C19	24-19-22	ERa~N/A	2290	44	2246
B24R22C20	24-20-22	ERa~N/A	2257	45	2212
B24R22C21	24-21-22	AlexaAntiMouseAb~N/A	8772	44	8728
B24R22C22	24-22-22	AlexaAntiMouseAb~N/A	7426	42	7384
B25R01C01	25-1-1	AlexaAntiMouseAb~N/A	29785	37	29748
B25R01C02	25-2-1	AlexaAntiMouseAb~N/A	24201	35	24166
B25R01C03	25-3-1	ERa~N/A	1855	35	1820
B25R01C04	25-4-1	ERa~N/A	1871	35	1836
B25R01C05	25-5-1	HumanIgG1~N/A	824	35	789
B25R01C06	25-6-1	HumanIgG1~N/A	1075	36	1039
B25R01C07	25-7-1	HumanIgG2~N/A	2235	36	2199
B25R01C08	25-8-1	HumanIgG2~N/A	2036	37	1999
B25R01C09	25-9-1	HumanIgG3~N/A	10501	36	10465
B25R01C10	25-10-1	HumanIgG3~N/A	8755	41	8714
B25R01C11	25-11-1	HumanIgG4~N/A	35991	48	35943
B25R01C12	25-12-1	HumanIgG4~N/A	35101	42	35059
B25R01C13	25-13-1	BiotinAb~N/A	333	35	298
B25R01C14	25-14-1	BiotinAb~N/A	323	35	288
B25R01C15	25-15-1	RanBP2deltaFG~N/A	287	36	251
B25R01C16	25-16-1	RanBP2deltaFG~N/A	284	35	249
B25R01C17	25-17-1	hMDM2~N/A	741	35	706
B25R01C18	25-18-1	hMDM2~N/A	774	37	737
B25R01C19	25-19-1	PKCeta~N/A	69	37	32
B25R01C20	25-20-1	PKCeta~N/A	347	39	308
B25R01C21	25-21-1	AlexaAntiMouseAb~N/A	31588	42	31546
B25R01C22	25-22-1	AlexaAntiMouseAb~N/A	31869	41	31828
B25R02C01	25-1-2	PKCeta~N/A	864	50	814
B25R02C02	25-2-2	PKCeta~N/A	875	44	831
B25R02C03	25-3-2	Buffer	274	42	232
B25R02C04	25-4-2	Buffer	250	54	196
B25R02C05	25-5-2	HumanIgA~N/A	18606	42	18564
B25R02C06	25-6-2	HumanIgA~N/A	19174	43	19131
B25R02C07	25-7-2	Buffer	92	42	50
B25R02C08	25-8-2	Buffer	84	42	42
B25R02C09	25-9-2	BSA~N/A	10939	41	10898
B25R02C10	25-10-2	BSA~N/A	10616	42	10574
B25R02C11	25-11-2	Hs~MGC:BC002488.1~uORF:IOH3970	10556	45	10511
B25R02C12	25-12-2	Hs~MGC:BC002488.1~uORF:IOH3970	10185	40	10145
B25R02C13	25-13-2	Hs~MGC:BC004106.1~uORF:IOH5672	553	37	516
B25R02C14	25-14-2	Hs~MGC:BC004106.1~uORF:IOH5672	542	37	505
B25R02C15	25-15-2	Hs~MGC:BC030957.1~uORF:IOH23131	464	39	425
B25R02C16	25-16-2	Hs~MGC:BC030957.1~uORF:IOH23131	454	38	416
B25R02C17	25-17-2	Hs~MGC:BC011774.1~uORF:IOH12522	366	37	329
B25R02C18	25-18-2	Hs~MGC:BC011774.1~uORF:IOH12522	379	37	342
B25R02C19	25-19-2	Hs~Ref:NM_052940.3~uORF:IOH10671	469	37	432
B25R02C20	25-20-2	Hs~Ref:NM_052940.3~uORF:IOH10671	510	38	472
B25R02C21	25-21-2	Hs~MGC:BC031227.1~uORF:IOH21600	987	44	943
B25R02C22	25-22-2	Hs~MGC:BC031227.1~uORF:IOH21600	983	39	944
B25R03C01	25-1-3	Hs~MGC:BC030516.1~uORF:IOH21650	1498	62	1436
B25R03C02	25-2-3	Hs~MGC:BC030516.1~uORF:IOH21650	1493	53	1440
B25R03C03	25-3-3	Hs~Ref:NM_001325.1~uORF:IOH11230	1168	41	1127
B25R03C04	25-4-3	Hs~Ref:NM_001325.1~uORF:IOH11230	1211	43	1168
B25R03C05	25-5-3	Hs~Ref:NM_001207.2~uORF:IOH5823	569	51	518
B25R03C06	25-6-3	Hs~Ref:NM_001207.2~uORF:IOH5823	759	82	677
B25R03C07	25-7-3	Hs~Ref:NM_004355.1~uORF:IOH13998	168	54	114
B25R03C08	25-8-3	Hs~Ref:NM_004355.1~uORF:IOH13998	174	53	121
B25R03C09	25-9-3	Hs~Ref:NM_019058.1~uORF:IOH6497	859	49	810
B25R03C10	25-10-3	Hs~Ref:NM_019058.1~uORF:IOH6497	881	41	840
B25R03C11	25-11-3	Hs~Ref:NM_054016.1~uORF:IOH6575	2223	35	2188
B25R03C12	25-12-3	Hs~Ref:NM_054016.1~uORF:IOH6575	2038	34	2004
B25R03C13	25-13-3	Hs~Ref:NM_004039.1~uORF:IOH3974	1221	38	1183
B25R03C14	25-14-3	Hs~Ref:NM_004039.1~uORF:IOH3974	1260	41	1219
B25R03C15	25-15-3	Hs~Ref:NM_004169.2~uORF:IOH25904	496	38	458
B25R03C16	25-16-3	Hs~Ref:NM_004169.2~uORF:IOH25904	482	38	444
B25R03C17	25-17-3	Hs~MGC:BC001918.1~uORF:IOH5019	110	57	53
B25R03C18	25-18-3	Hs~MGC:BC001918.1~uORF:IOH5019	159	40	119
B25R03C19	25-19-3	Hs~MGC:BC037900.2~uORF:IOH27758	456	36	420
B25R03C20	25-20-3	Hs~MGC:BC037900.2~uORF:IOH27758	451	37	414
B25R03C21	25-21-3	Hs~Ref:NM_007255.1~uORF:IOH5828	7808	37	7771
B25R03C22	25-22-3	Hs~Ref:NM_007255.1~uORF:IOH5828	7515	35	7480
B25R04C01	25-1-4	Hs~Ref:NM_015987.2~uORF:IOH9993	245	56	189
B25R04C02	25-2-4	Hs~Ref:NM_015987.2~uORF:IOH9993	184	144	40
B25R04C03	25-3-4	Hs~MGC:BC007414.2~uORF:IOH5824	724	43	681
B25R04C04	25-4-4	Hs~MGC:BC007414.2~uORF:IOH5824	741	39	702
B25R04C05	25-5-4	Hs~Ref:NM_002648.1~uORF:IOH14704	680	43	637
B25R04C06	25-6-4	Hs~Ref:NM_002648.1~uORF:IOH14704	662	45	617
B25R04C07	25-7-4	Hs~MGC:BC030827.1~uORF:IOH22231	101	41	60
B25R04C08	25-8-4	Hs~MGC:BC030827.1~uORF:IOH22231	106	50	56
B25R04C09	25-9-4	Hs~MGC:BC030586.2~uORF:IOH22241	1455	55	1400
B25R04C10	25-10-4	Hs~MGC:BC030586.2~uORF:IOH22241	1455	45	1410
B25R04C11	25-11-4	Hs~MGC:BC030585.2~uORF:IOH22261	302	36	266
B25R04C12	25-12-4	Hs~MGC:BC030585.2~uORF:IOH22261	327	37	290
B25R04C13	25-13-4	Hs~Ref:NM_003498.2~uORF:IOH22278	305	137	168
B25R04C14	25-14-4	Hs~Ref:NM_003498.2~uORF:IOH22278	228	153	75
B25R04C15	25-15-4	Hs~MGC:BC031682.1~uORF:IOH22859	1006	40	966
B25R04C16	25-16-4	Hs~MGC:BC031682.1~uORF:IOH22859	902	38	864
B25R04C17	25-17-4	Hs~MGC:BC021118.1~uORF:IOH13386	306	38	268
B25R04C18	25-18-4	Hs~MGC:BC021118.1~uORF:IOH13386	319	37	282
B25R04C19	25-19-4	Hs~MGC:BC045606.1~uORF:IOH27193	239	36	203
B25R04C20	25-20-4	Hs~MGC:BC045606.1~uORF:IOH27193	224	40	184
B25R04C21	25-21-4	Hs~Ref:NM_004252.1~uORF:IOH4025	382	37	345
B25R04C22	25-22-4	Hs~Ref:NM_004252.1~uORF:IOH4025	380	35	345
B25R05C01	25-1-5	Hs~MGC:BC023990.1~uORF:IOH27874	1513	40	1473
B25R05C02	25-2-5	Hs~MGC:BC023990.1~uORF:IOH27874	1492	45	1447
B25R05C03	25-3-5	Hs~MGC:BC059366.1~uORF:IOH39823	180	157	23
B25R05C04	25-4-5	Hs~MGC:BC059366.1~uORF:IOH39823	234	52	182
B25R05C05	25-5-5	Hs~Ref:NM_016062.1~uORF:IOH4424	436	38	398
B25R05C06	25-6-5	Hs~Ref:NM_016062.1~uORF:IOH4424	437	36	401
B25R05C07	25-7-5	Hs~Ref:NM_012232.2~uORF:IOH39825	293	37	256
B25R05C08	25-8-5	Hs~Ref:NM_012232.2~uORF:IOH39825	325	41	284
B25R05C09	25-9-5	Hs~Ref:NM_006705.2~uORF:IOH3588	323	199	124
B25R05C10	25-10-5	Hs~Ref:NM_006705.2~uORF:IOH3588	311	66	245
B25R05C11	25-11-5	Hs~MGC:BC030805.1~uORF:IOH23050	657	41	616
B25R05C12	25-12-5	Hs~MGC:BC030805.1~uORF:IOH23050	662	39	623
B25R05C13	25-13-5	Hs~MGC:BC001648.1~uORF:IOH3702	533	41	492
B25R05C14	25-14-5	Hs~MGC:BC001648.1~uORF:IOH3702	520	41	479
B25R05C15	25-15-5	Hs~MGC:BC009398.1~uORF:IOH14462	431	38	393
B25R05C16	25-16-5	Hs~MGC:BC009398.1~uORF:IOH14462	409	38	371
B25R05C17	25-17-5	Hs~MGC:BC046117.1~uORF:IOH26985	1287	38	1249
B25R05C18	25-18-5	Hs~MGC:BC046117.1~uORF:IOH26985	1254	40	1214
B25R05C19	25-19-5	Hs~MGC:BC045563.1~uORF:IOH26744	338	41	297
B25R05C20	25-20-5	Hs~MGC:BC045563.1~uORF:IOH26744	325	40	285
B25R05C21	25-21-5	Hs~MGC:BC047303.1~uORF:IOH26558	507	36	471
B25R05C22	25-22-5	Hs~MGC:BC047303.1~uORF:IOH26558	527	36	491
B25R06C01	25-1-6	Hs~MGC:NM_175085.1~uORF:IOH26153	129	36	93
B25R06C02	25-2-6	Hs~MGC:NM_175085.1~uORF:IOH26153	124	38	86
B25R06C03	25-3-6	Hs~Ref:NM_018153.2~uORF:IOH12656	143	44	99
B25R06C04	25-4-6	Hs~Ref:NM_018153.2~uORF:IOH12656	64	50	14
B25R06C05	25-5-6	Hs~MGC:BC012098.1~uORF:IOH13158	407	37	370
B25R06C06	25-6-6	Hs~MGC:BC012098.1~uORF:IOH13158	371	36	335
B25R06C07	25-7-6	Hs~Ref:NM_022915.2~uORF:IOH13325	424	37	387
B25R06C08	25-8-6	Hs~Ref:NM_022915.2~uORF:IOH13325	480	38	442
B25R06C09	25-9-6	Hs~MGC:BC024002.2~uORF:IOH11100	377	54	323
B25R06C10	25-10-6	Hs~MGC:BC024002.2~uORF:IOH11100	360	62	298
B25R06C11	25-11-6	Hs~Ref:NM_002307.1~uORF:IOH40009	886	41	845
B25R06C12	25-12-6	Hs~Ref:NM_002307.1~uORF:IOH40009	890	43	847
B25R06C13	25-13-6	Hs~MGC:BC065290.1~uORF:IOH39961	231	59	172
B25R06C14	25-14-6	Hs~MGC:BC065290.1~uORF:IOH39961	261	128	133
B25R06C15	25-15-6	Hs~Ref:NM_153043.3~uORF:IOH40012	381	38	343
B25R06C16	25-16-6	Hs~Ref:NM_153043.3~uORF:IOH40012	379	37	342
B25R06C17	25-17-6	Hs~Ref:NM_133635.3~uORF:IOH39914	253	46	207
B25R06C18	25-18-6	Hs~Ref:NM_133635.3~uORF:IOH39914	241	116	125
B25R06C19	25-19-6	Hs~MGC:BC021983.1~uORF:IOH27884	576	44	532
B25R06C20	25-20-6	Hs~MGC:BC021983.1~uORF:IOH27884	572	40	532
B25R06C21	25-21-6	Hs~MGC:BC017570.1~uORF:IOH27880	5623	38	5585
B25R06C22	25-22-6	Hs~MGC:BC017570.1~uORF:IOH27880	5654	36	5618
B25R07C01	25-1-7	Hs~Ref:NM_012280.1~uORF:IOH27897	983	36	947
B25R07C02	25-2-7	Hs~Ref:NM_012280.1~uORF:IOH27897	965	39	926
B25R07C03	25-3-7	Hs~Ref:NM_014239.1~uORF:IOH27837	306	42	264
B25R07C04	25-4-7	Hs~Ref:NM_014239.1~uORF:IOH27837	298	42	256
B25R07C05	25-5-7	Hs~MGC:BC000921.2~uORF:IOH2975	388	39	349
B25R07C06	25-6-7	Hs~MGC:BC000921.2~uORF:IOH2975	352	38	314
B25R07C07	25-7-7	Hs~MGC:BC003397.1~uORF:IOH3007	313	44	269
B25R07C08	25-8-7	Hs~MGC:BC003397.1~uORF:IOH3007	311	55	256
B25R07C09	25-9-7	Hs~MGC:BC048214.1~uORF:IOH28047	295	63	232
B25R07C10	25-10-7	Hs~MGC:BC048214.1~uORF:IOH28047	374	145	229
B25R07C11	25-11-7	Hs~MGC:BC000578.1~uORF:IOH4180	467	37	430
B25R07C12	25-12-7	Hs~MGC:BC000578.1~uORF:IOH4180	418	42	376
B25R07C13	25-13-7	Hs~Ref:NM_030803.5~uORF:IOH43648	961	53	908
B25R07C14	25-14-7	Hs~Ref:NM_030803.5~uORF:IOH43648	982	48	934
B25R07C15	25-15-7	Hs~Ref:NM_005622.3~uORF:IOH42133	990	38	952
B25R07C16	25-16-7	Hs~Ref:NM_005622.3~uORF:IOH42133	951	36	915
B25R07C17	25-17-7	Hs~Ref:NM_033194.1~uORF:IOH43657	1074	38	1036
B25R07C18	25-18-7	Hs~Ref:NM_033194.1~uORF:IOH43657	1058	38	1020
B25R07C19	25-19-7	Hs~Ref:NM_006156.1~uORF:IOH42171	475	39	436
B25R07C20	25-20-7	Hs~Ref:NM_006156.1~uORF:IOH42171	481	39	442
B25R07C21	25-21-7	Hs~MGC:NM_138355.1~uORF:IOH14669	610	37	573
B25R07C22	25-22-7	Hs~MGC:NM_138355.1~uORF:IOH14669	614	36	578
B25R08C01	25-1-8	Hs~MGC:BC017262.1~uORF:IOH13986	732	48	684
B25R08C02	25-2-8	Hs~MGC:BC017262.1~uORF:IOH13986	714	44	670
B25R08C03	25-3-8	Hs~MGC:BC021930.1~uORF:IOH13703	3332	41	3291
B25R08C04	25-4-8	Hs~MGC:BC021930.1~uORF:IOH13703	3325	39	3286
B25R08C05	25-5-8	Hs~Ref:NM_006332.1~uORF:IOH13656	980	38	942
B25R08C06	25-6-8	Hs~Ref:NM_006332.1~uORF:IOH13656	920	38	882
B25R08C07	25-7-8	Hs~MGC:BC028739.2~uORF:IOH11395	317	40	277
B25R08C08	25-8-8	Hs~MGC:BC028739.2~uORF:IOH11395	335	53	282
B25R08C09	25-9-8	Hs~MGC:NM_172016.1~uORF:IOH5913	1052	39	1013
B25R08C10	25-10-8	Hs~MGC:NM_172016.1~uORF:IOH5913	1059	39	1020
B25R08C11	25-11-8	Hs~Ref:NM_016301.2~uORF:IOH7464	422	37	385
B25R08C12	25-12-8	Hs~Ref:NM_016301.2~uORF:IOH7464	407	41	366
B25R08C13	25-13-8	Hs~MGC:BC029220.1~uORF:IOH22755	1163	45	1118
B25R08C14	25-14-8	Hs~MGC:BC029220.1~uORF:IOH22755	1213	41	1172
B25R08C15	25-15-8	Hs~MGC:BC012536.1~uORF:IOH14192	368	38	330
B25R08C16	25-16-8	Hs~MGC:BC012536.1~uORF:IOH14192	331	37	294
B25R08C17	25-17-8	Hs~Ref:NM_031992.1~uORF:IOH13859	454	37	417
B25R08C18	25-18-8	Hs~Ref:NM_031992.1~uORF:IOH13859	453	38	415
B25R08C19	25-19-8	Hs~Ref:NM_030673.1~uORF:IOH5238	288	49	239
B25R08C20	25-20-8	Hs~Ref:NM_030673.1~uORF:IOH5238	305	47	258
B25R08C21	25-21-8	Hs~MGC:BC003566.1~uORF:IOH4871	474	38	436
B25R08C22	25-22-8	Hs~MGC:BC003566.1~uORF:IOH4871	451	36	415
B25R09C01	25-1-9	Hs~Ref:NM_021032.2~uORF:IOH35339	2016	49	1967
B25R09C02	25-2-9	Hs~Ref:NM_021032.2~uORF:IOH35339	1970	40	1930
B25R09C03	25-3-9	Hs~Ref:NM_025091.2~uORF:IOH35195	1591	35	1556
B25R09C04	25-4-9	Hs~Ref:NM_025091.2~uORF:IOH35195	1493	35	1458
B25R09C05	25-5-9	Hs~Ref:NM_130848.1~uORF:IOH35344	1838	36	1802
B25R09C06	25-6-9	Hs~Ref:NM_130848.1~uORF:IOH35344	1826	39	1787
B25R09C07	25-7-9	Hs~Ref:NM_018467.2~uORF:IOH7563	617	43	574
B25R09C08	25-8-9	Hs~Ref:NM_018467.2~uORF:IOH7563	601	43	558
B25R09C09	25-9-9	Hs~MGC:BC005313.1~uORF:IOH7368	227	47	180
B25R09C10	25-10-9	Hs~MGC:BC005313.1~uORF:IOH7368	285	169	116
B25R09C11	25-11-9	Hs~MGC:NM_007041.1~uORF:IOH10743	312	38	274
B25R09C12	25-12-9	Hs~MGC:NM_007041.1~uORF:IOH10743	309	36	273
B25R09C13	25-13-9	Hs~Ref:NM_053004.1~uORF:IOH14758	325	91	234
B25R09C14	25-14-9	Hs~Ref:NM_053004.1~uORF:IOH14758	179	47	132
B25R09C15	25-15-9	Hs~Ref:NM_054012.1~uORF:IOH14007	842	36	806
B25R09C16	25-16-9	Hs~Ref:NM_054012.1~uORF:IOH14007	853	36	817
B25R09C17	25-17-9	Hs~Ref:NM_006829.1~uORF:IOH5620	431	41	390
B25R09C18	25-18-9	Hs~Ref:NM_006829.1~uORF:IOH5620	484	82	402
B25R09C19	25-19-9	Hs~MGC:BC004876.1~uORF:IOH5626	3281	45	3236
B25R09C20	25-20-9	Hs~MGC:BC004876.1~uORF:IOH5626	3389	42	3347
B25R09C21	25-21-9	Hs~MGC:BC001817.1~uORF:IOH5174	171	40	131
B25R09C22	25-22-9	Hs~MGC:BC001817.1~uORF:IOH5174	234	42	192
B25R10C01	25-1-10	Hs~MGC:BC004902.1~uORF:IOH5223	193	36	157
B25R10C02	25-2-10	Hs~MGC:BC004902.1~uORF:IOH5223	175	36	139
B25R10C03	25-3-10	Hs~MGC:BC033710.2~uORF:IOH45968	911	35	876
B25R10C04	25-4-10	Hs~MGC:BC033710.2~uORF:IOH45968	875	35	840
B25R10C05	25-5-10	Hs~Ref:NM_017572.2~uORF:IOH53775	465	34	431
B25R10C06	25-6-10	Hs~Ref:NM_017572.2~uORF:IOH53775	502	36	466
B25R10C07	25-7-10	Hs~MGC:BC006106.1~uORF:IOH6536	3165	42	3123
B25R10C08	25-8-10	Hs~MGC:BC006106.1~uORF:IOH6536	3133	41	3092
B25R10C09	25-9-10	Hs~Ref:NM_032303.2~uORF:IOH57810	479	40	439
B25R10C10	25-10-10	Hs~Ref:NM_032303.2~uORF:IOH57810	480	38	442
B25R10C11	25-11-10	GST1	36	35	1
B25R10C12	25-12-10	GST1	43	35	8
B25R10C13	25-13-10	GST2	39	35	4
B25R10C14	25-14-10	GST2	40	36	4
B25R10C15	25-15-10	GST3	43	35	8
B25R10C16	25-16-10	GST3	43	35	8
B25R10C17	25-17-10	GST4	56	35	21
B25R10C18	25-18-10	GST4	54	37	17
B25R10C19	25-19-10	Anti-HumanIgA1~N/A	8315	36	8279
B25R10C20	25-20-10	Anti-HumanIgA1~N/A	8233	37	8196
B25R10C21	25-21-10	Anti-HumanIgA2~N/A	14581	42	14539
B25R10C22	25-22-10	Anti-HumanIgA2~N/A	14365	40	14325
B25R11C01	25-1-11	AlexaAntiMouseAb~N/A	19976	36	19940
B25R11C02	25-2-11	AlexaAntiMouseAb~N/A	19749	37	19712
B25R11C03	25-3-11	MAPKAP~N/A	82	39	43
B25R11C04	25-4-11	MAPKAP~N/A	94	49	45
B25R11C05	25-5-11	Buffer	1720	34	1686
B25R11C06	25-6-11	Buffer	1681	34	1647
B25R11C07	25-7-11	BSA~N/A	7688	37	7651
B25R11C08	25-8-11	BSA~N/A	8093	36	8057
B25R11C09	25-9-11	Anti-HumanIgG1~N/A	1610	35	1575
B25R11C10	25-10-11	Anti-HumanIgG1~N/A	1459	35	1424
B25R11C11	25-11-11	Anti-HumanIgG2~N/A	3053	35	3018
B25R11C12	25-12-11	Anti-HumanIgG2~N/A	2831	36	2795
B25R11C13	25-13-11	Anti-HumanIgG3~N/A	5521	35	5486
B25R11C14	25-14-11	Anti-HumanIgG3~N/A	5517	36	5481
B25R11C15	25-15-11	Anti-HumanIgG4~N/A	10942	38	10904
B25R11C16	25-16-11	Anti-HumanIgG4~N/A	10470	36	10434
B25R11C17	25-17-11	AntiBiotinAb~N/A	11041	35	11006
B25R11C18	25-18-11	AntiBiotinAb~N/A	11246	35	11211
B25R11C19	25-19-11	Buffer	57	35	22
B25R11C20	25-20-11	Buffer	56	36	20
B25R11C21	25-21-11	Hs~Ref:NM_000576.1~uORF:IOH9821	351	43	308
B25R11C22	25-22-11	Hs~Ref:NM_000576.1~uORF:IOH9821	359	41	318
B25R12C01	25-1-12	Hs~Ref:NM_017840.1~uORF:IOH3760	603	36	567
B25R12C02	25-2-12	Hs~Ref:NM_017840.1~uORF:IOH3760	533	36	497
B25R12C03	25-3-12	Hs~MGC:BC013945.1~uORF:IOH13217	465	35	430
B25R12C04	25-4-12	Hs~MGC:BC013945.1~uORF:IOH13217	509	35	474
B25R12C05	25-5-12	Hs~Ref:NM_002422.2~uORF:IOH29837	623	35	588
B25R12C06	25-6-12	Hs~Ref:NM_002422.2~uORF:IOH29837	633	36	597
B25R12C07	25-7-12	Hs~MGC:BC050351.1~uORF:IOH62378	318	44	274
B25R12C08	25-8-12	Hs~MGC:BC050351.1~uORF:IOH62378	336	40	296
B25R12C09	25-9-12	Hs~MGC:BC068602.1~uORF:IOH61659	110	37	73
B25R12C10	25-10-12	Hs~MGC:BC068602.1~uORF:IOH61659	418	74	344
B25R12C11	25-11-12	Hs~MGC:BC033905.1~uORF:IOH61608	358	40	318
B25R12C12	25-12-12	Hs~MGC:BC033905.1~uORF:IOH61608	372	40	332
B25R12C13	25-13-12	Hs~MGC:BC068496.1~uORF:IOH62478	86	37	49
B25R12C14	25-14-12	Hs~MGC:BC068496.1~uORF:IOH62478	117	74	43
B25R12C15	25-15-12	Hs~Ref:NM_012198.2~uORF:IOH7201	163	45	118
B25R12C16	25-16-12	Hs~Ref:NM_012198.2~uORF:IOH7201	116	36	80
B25R12C17	25-17-12	Hs~Ref:NM_000989.2~uORF:IOH3809	401	36	365
B25R12C18	25-18-12	Hs~Ref:NM_000989.2~uORF:IOH3809	405	36	369
B25R12C19	25-19-12	Hs~Ref:NM_005326.2~uORF:IOH3130	189	39	150
B25R12C20	25-20-12	Hs~Ref:NM_005326.2~uORF:IOH3130	312	108	204
B25R12C21	25-21-12	Hs~MGC:BC015109.1~uORF:IOH14036	438	38	400
B25R12C22	25-22-12	Hs~MGC:BC015109.1~uORF:IOH14036	417	37	380
B25R13C01	25-1-13	Hs~Ref:NM_024330.1~uORF:IOH5056	519	34	485
B25R13C02	25-2-13	Hs~Ref:NM_024330.1~uORF:IOH5056	469	35	434
B25R13C03	25-3-13	Hs~MGC:BC002655.2~uORF:IOH5256	323	37	286
B25R13C04	25-4-13	Hs~MGC:BC002655.2~uORF:IOH5256	332	36	296
B25R13C05	25-5-13	Hs~MGC:BC007022.1~uORF:IOH7234	130	73	57
B25R13C06	25-6-13	Hs~MGC:BC007022.1~uORF:IOH7234	141	50	91
B25R13C07	25-7-13	Hs~MGC:BC016283.1~uORF:IOH10041	378	36	342
B25R13C08	25-8-13	Hs~MGC:BC016283.1~uORF:IOH10041	375	37	338
B25R13C09	25-9-13	Hs~Ref:NM_001011669.1~uORF:IOH57339	333	38	295
B25R13C10	25-10-13	Hs~Ref:NM_001011669.1~uORF:IOH57339	315	39	276
B25R13C11	25-11-13	Hs~Ref:NM_147196.1~uORF:IOH42270	2572	40	2532
B25R13C12	25-12-13	Hs~Ref:NM_147196.1~uORF:IOH42270	2622	41	2581
B25R13C13	25-13-13	Hs~Ref:NM_024515.1~uORF:IOH5172	1263	42	1221
B25R13C14	25-14-13	Hs~Ref:NM_024515.1~uORF:IOH5172	1173	41	1132
B25R13C15	25-15-13	Hs~MGC:NM_024511.3~uORF:IOH5198	482	39	443
B25R13C16	25-16-13	Hs~MGC:NM_024511.3~uORF:IOH5198	461	38	423
B25R13C17	25-17-13	Hs~MGC:BC017871.1~uORF:IOH13901	462	36	426
B25R13C18	25-18-13	Hs~MGC:BC017871.1~uORF:IOH13901	488	36	452
B25R13C19	25-19-13	Hs~Ref:NM_007220.1~uORF:IOH11664	394	38	356
B25R13C20	25-20-13	Hs~Ref:NM_007220.1~uORF:IOH11664	409	38	371
B25R13C21	25-21-13	Hs~MGC:BC011863.2~uORF:IOH14833	715	38	677
B25R13C22	25-22-13	Hs~MGC:BC011863.2~uORF:IOH14833	715	36	679
B25R14C01	25-1-14	Hs~Ref:NM_024790.2~uORF:IOH13277	1020	34	986
B25R14C02	25-2-14	Hs~Ref:NM_024790.2~uORF:IOH13277	967	35	932
B25R14C03	25-3-14	Hs~MGC:BC008788.2~uORF:IOH6237	322	36	286
B25R14C04	25-4-14	Hs~MGC:BC008788.2~uORF:IOH6237	337	36	301
B25R14C05	25-5-14	Hs~Ref:NM_014475.2~uORF:IOH21985	335	37	298
B25R14C06	25-6-14	Hs~Ref:NM_014475.2~uORF:IOH21985	334	36	298
B25R14C07	25-7-14	Hs~MGC:BC036784.1~uORF:IOH22104	351	37	314
B25R14C08	25-8-14	Hs~MGC:BC036784.1~uORF:IOH22104	346	36	310
B25R14C09	25-9-14	Hs~MGC:BC033882.1~uORF:IOH22100	367	36	331
B25R14C10	25-10-14	Hs~MGC:BC033882.1~uORF:IOH22100	321	36	285
B25R14C11	25-11-14	Hs~Ref:NM_017724.1~uORF:IOH29011	424	37	387
B25R14C12	25-12-14	Hs~Ref:NM_017724.1~uORF:IOH29011	459	39	420
B25R14C13	25-13-14	Hs~Ref:NM_032786.1~uORF:IOH13275	2157	41	2116
B25R14C14	25-14-14	Hs~Ref:NM_032786.1~uORF:IOH13275	2098	39	2059
B25R14C15	25-15-14	Hs~Ref:NM_052901.2~uORF:IOH42062	344	38	306
B25R14C16	25-16-14	Hs~Ref:NM_052901.2~uORF:IOH42062	272	37	235
B25R14C17	25-17-14	Hs~Ref:NM_014157.2~uORF:IOH42224	346	36	310
B25R14C18	25-18-14	Hs~Ref:NM_014157.2~uORF:IOH42224	329	36	293
B25R14C19	25-19-14	Hs~Ref:NM_004548.1~uORF:IOH5864	362	37	325
B25R14C20	25-20-14	Hs~Ref:NM_004548.1~uORF:IOH5864	313	37	276
B25R14C21	25-21-14	Hs~Ref:NM_015407.3~uORF:IOH4118	425	36	389
B25R14C22	25-22-14	Hs~Ref:NM_015407.3~uORF:IOH4118	445	36	409
B25R15C01	25-1-15	Hs~Ref:NM_005855.1~uORF:IOH4168	325	37	288
B25R15C02	25-2-15	Hs~Ref:NM_005855.1~uORF:IOH4168	338	37	301
B25R15C03	25-3-15	Hs~MGC:BC033790.1~uORF:IOH21793	412	35	377
B25R15C04	25-4-15	Hs~MGC:BC033790.1~uORF:IOH21793	422	36	386
B25R15C05	25-5-15	Hs~Ref:NM_170750.1~uORF:IOH41229	340	37	303
B25R15C06	25-6-15	Hs~Ref:NM_170750.1~uORF:IOH41229	301	37	264
B25R15C07	25-7-15	Hs~Ref:NM_005440.3~uORF:IOH44761	543	36	507
B25R15C08	25-8-15	Hs~Ref:NM_005440.3~uORF:IOH44761	542	36	506
B25R15C09	25-9-15	Hs~Ref:XM_048235.2~uORF:IOH43018	353	36	317
B25R15C10	25-10-15	Hs~Ref:XM_048235.2~uORF:IOH43018	376	38	338
B25R15C11	25-11-15	Hs~Ref:NM_005776.2~uORF:IOH41416	276	38	238
B25R15C12	25-12-15	Hs~Ref:NM_005776.2~uORF:IOH41416	266	80	186
B25R15C13	25-13-15	Hs~IVGN:PM_2139~Ext:histone~N/A	236	39	197
B25R15C14	25-14-15	Hs~IVGN:PM_2139~Ext:histone~N/A	252	39	213
B25R15C15	25-15-15	Hs~Ref:NM_005465.3~CAT:PV3185	72	56	16
B25R15C16	25-16-15	Hs~Ref:NM_005465.3~CAT:PV3185	176	50	126
B25R15C17	25-17-15	Hs~Ref:NM_002344.3~CAT:PV4651	307	34	273
B25R15C18	25-18-15	Hs~Ref:NM_002344.3~CAT:PV4651	320	35	285
B25R15C19	25-19-15	Hs~Ref:NM_001240.2~CAT:PV4131	238	68	170
B25R15C20	25-20-15	Hs~Ref:NM_001240.2~CAT:PV4131	209	72	137
B25R15C21	25-21-15	Hs~Ref:NM_020630.2~CAT:PV3819	249	38	211
B25R15C22	25-22-15	Hs~Ref:NM_020630.2~CAT:PV3819	251	69	182
B25R16C01	25-1-16	Hs~Ref:NM_003215.1~CAT:PV3269	538	42	496
B25R16C02	25-2-16	Hs~Ref:NM_003215.1~CAT:PV3269	545	37	508
B25R16C03	25-3-16	Hs~MGC:NM_015191.1~CAT:PV4792	690	34	656
B25R16C04	25-4-16	Hs~MGC:NM_015191.1~CAT:PV4792	713	34	679
B25R16C05	25-5-16	Hs~Ref:NM_005163.1~CAT:PV3685	149	36	113
B25R16C06	25-6-16	Hs~Ref:NM_005163.1~CAT:PV3685	111	36	75
B25R16C07	25-7-16	Hs~MGC:BC009390.1~uORF:IOH27829	270	82	188
B25R16C08	25-8-16	Hs~MGC:BC009390.1~uORF:IOH27829	200	84	116
B25R16C09	25-9-16	Hs~MGC:BC042150.1~uORF:IOH27999	246	42	204
B25R16C10	25-10-16	Hs~MGC:BC042150.1~uORF:IOH27999	335	71	264
B25R16C11	25-11-16	Hs~MGC:BC050377.1~uORF:IOH26671	338	37	301
B25R16C12	25-12-16	Hs~MGC:BC050377.1~uORF:IOH26671	367	43	324
B25R16C13	25-13-16	Hs~Ref:NM_006214.2~uORF:IOH22535	411	35	376
B25R16C14	25-14-16	Hs~Ref:NM_006214.2~uORF:IOH22535	433	36	397
B25R16C15	25-15-16	Hs~Ref:NM_203488.1~uORF:IOH44619	442	37	405
B25R16C16	25-16-16	Hs~Ref:NM_203488.1~uORF:IOH44619	416	36	380
B25R16C17	25-17-16	Hs~Ref:NM_001011670.1~uORF:IOH57330	382	37	345
B25R16C18	25-18-16	Hs~Ref:NM_001011670.1~uORF:IOH57330	407	36	371
B25R16C19	25-19-16	Hs~MGC:BC038467.1~uORF:IOH25921	370	37	333
B25R16C20	25-20-16	Hs~MGC:BC038467.1~uORF:IOH25921	398	38	360
B25R16C21	25-21-16	Hs~MGC:BC069412.1~uORF:IOH40305	438	37	401
B25R16C22	25-22-16	Hs~MGC:BC069412.1~uORF:IOH40305	443	36	407
B25R17C01	25-1-17	Hs~MGC:BC028199.1~uORF:IOH11414	491	37	454
B25R17C02	25-2-17	Hs~MGC:BC028199.1~uORF:IOH11414	439	34	405
B25R17C03	25-3-17	Hs~Ref:NM_006597.3~uORF:IOH11329	346	33	313
B25R17C04	25-4-17	Hs~Ref:NM_006597.3~uORF:IOH11329	354	34	320
B25R17C05	25-5-17	Hs~MGC:BC017594.2~uORF:IOH27762	429	34	395
B25R17C06	25-6-17	Hs~MGC:BC017594.2~uORF:IOH27762	423	34	389
B25R17C07	25-7-17	Hs~Ref:NM_001889.2~uORF:IOH26287	447	33	414
B25R17C08	25-8-17	Hs~Ref:NM_001889.2~uORF:IOH26287	493	34	459
B25R17C09	25-9-17	Hs~MGC:BC027484.1~uORF:IOH27427	701	34	667
B25R17C10	25-10-17	Hs~MGC:BC027484.1~uORF:IOH27427	686	38	648
B25R17C11	25-11-17	Hs~Ref:NM_032023.3~uORF:IOH21970	1095	42	1053
B25R17C12	25-12-17	Hs~Ref:NM_032023.3~uORF:IOH21970	1103	39	1064
B25R17C13	25-13-17	Hs~MGC:BC004966.1~uORF:IOH4560	517	34	483
B25R17C14	25-14-17	Hs~MGC:BC004966.1~uORF:IOH4560	541	36	505
B25R17C15	25-15-17	Hs~MGC:BC008808.2~uORF:IOH6341	612	36	576
B25R17C16	25-16-17	Hs~MGC:BC008808.2~uORF:IOH6341	608	37	571
B25R17C17	25-17-17	Hs~MGC:BC021741.1~uORF:IOH22430	285	37	248
B25R17C18	25-18-17	Hs~MGC:BC021741.1~uORF:IOH22430	328	39	289
B25R17C19	25-19-17	Hs~MGC:BC015155.1~uORF:IOH10623	256	55	201
B25R17C20	25-20-17	Hs~MGC:BC015155.1~uORF:IOH10623	267	63	204
B25R17C21	25-21-17	Hs~Ref:NM_016613.3~uORF:IOH11008	184	85	99
B25R17C22	25-22-17	Hs~Ref:NM_016613.3~uORF:IOH11008	151	79	72
B25R18C01	25-1-18	Hs~MGC:BC009710.1~uORF:IOH9854	709	40	669
B25R18C02	25-2-18	Hs~MGC:BC009710.1~uORF:IOH9854	664	36	628
B25R18C03	25-3-18	Hs~Ref:NM_002745.2~N/A	454	34	420
B25R18C04	25-4-18	Hs~Ref:NM_002745.2~N/A	539	36	503
B25R18C05	25-5-18	Hs~MGC:BC019064.1~uORF:IOH12760	349	37	312
B25R18C06	25-6-18	Hs~MGC:BC019064.1~uORF:IOH12760	352	37	315
B25R18C07	25-7-18	Hs~MGC:BC010360.1~uORF:IOH12880	311	35	276
B25R18C08	25-8-18	Hs~MGC:BC010360.1~uORF:IOH12880	483	36	447
B25R18C09	25-9-18	Hs~Ref:NM_017609.2~uORF:IOH27480	372	37	335
B25R18C10	25-10-18	Hs~Ref:NM_017609.2~uORF:IOH27480	402	43	359
B25R18C11	25-11-18	Hs~MGC:BC022362.1~uORF:IOH14191	65535	44	65491
B25R18C12	25-12-18	Hs~MGC:BC022362.1~uORF:IOH14191	65535	40	65495
B25R18C13	25-13-18	Hs~MGC:BC017356.1~uORF:IOH14096	1246	36	1210
B25R18C14	25-14-18	Hs~MGC:BC017356.1~uORF:IOH14096	1205	37	1168
B25R18C15	25-15-18	Hs~MGC:BC007524.1~uORF:IOH6913	381	36	345
B25R18C16	25-16-18	Hs~MGC:BC007524.1~uORF:IOH6913	407	39	368
B25R18C17	25-17-18	Hs~Ref:NM_152785.3~uORF:IOH21630	582	39	543
B25R18C18	25-18-18	Hs~Ref:NM_152785.3~uORF:IOH21630	620	38	582
B25R18C19	25-19-18	Hs~Ref:NM_015634.2~uORF:IOH14837	432	40	392
B25R18C20	25-20-18	Hs~Ref:NM_015634.2~uORF:IOH14837	427	41	386
B25R18C21	25-21-18	Hs~Ref:NM_032902.5~uORF:IOH27809	637	39	598
B25R18C22	25-22-18	Hs~Ref:NM_032902.5~uORF:IOH27809	512	36	476
B25R19C01	25-1-19	Hs~Ref:NM_004409.2~uORF:IOH40696	602	39	563
B25R19C02	25-2-19	Hs~Ref:NM_004409.2~uORF:IOH40696	599	41	558
B25R19C03	25-3-19	Hs~MGC:BC062701.1~uORF:IOH40710	736	35	701
B25R19C04	25-4-19	Hs~MGC:BC062701.1~uORF:IOH40710	709	35	674
B25R19C05	25-5-19	Hs~MGC:BC037207.1~uORF:IOH27659	740	35	705
B25R19C06	25-6-19	Hs~MGC:BC037207.1~uORF:IOH27659	768	35	733
B25R19C07	25-7-19	Hs~Ref:NM_006804.2~uORF:IOH27296	1117	34	1083
B25R19C08	25-8-19	Hs~Ref:NM_006804.2~uORF:IOH27296	1075	34	1041
B25R19C09	25-9-19	Hs~Ref:NM_145899.1~uORF:IOH6516	920	34	886
B25R19C10	25-10-19	Hs~Ref:NM_145899.1~uORF:IOH6516	926	35	891
B25R19C11	25-11-19	Hs~MGC:BC029827.1~uORF:IOH28674	498	37	461
B25R19C12	25-12-19	Hs~MGC:BC029827.1~uORF:IOH28674	541	37	504
B25R19C13	25-13-19	Hs~Ref:NM_014045.1~uORF:IOH3680	162	36	126
B25R19C14	25-14-19	Hs~Ref:NM_014045.1~uORF:IOH3680	264	116	148
B25R19C15	25-15-19	Hs~MGC:BC016327.1~uORF:IOH13232	281	38	243
B25R19C16	25-16-19	Hs~MGC:BC016327.1~uORF:IOH13232	436	72	364
B25R19C17	25-17-19	Hs~MGC:BC018722.1~uORF:IOH13970	485	38	447
B25R19C18	25-18-19	Hs~MGC:BC018722.1~uORF:IOH13970	447	39	408
B25R19C19	25-19-19	Hs~Ref:NM_182575.1~uORF:IOH27360	330	75	255
B25R19C20	25-20-19	Hs~Ref:NM_182575.1~uORF:IOH27360	213	82	131
B25R19C21	25-21-19	Hs~MGC:BC028728.1~uORF:IOH11804	267	37	230
B25R19C22	25-22-19	Hs~MGC:BC028728.1~uORF:IOH11804	279	36	243
B25R20C01	25-1-20	Hs~MGC:BC018426.1~uORF:IOH9673	82	39	43
B25R20C02	25-2-20	Hs~MGC:BC018426.1~uORF:IOH9673	355	87	268
B25R20C03	25-3-20	Hs~MGC:BC008305.1~uORF:IOH6986	285	42	243
B25R20C04	25-4-20	Hs~MGC:BC008305.1~uORF:IOH6986	287	37	250
B25R20C05	25-5-20	Hs~Ref:NM_032848.1~uORF:IOH13466	858	35	823
B25R20C06	25-6-20	Hs~Ref:NM_032848.1~uORF:IOH13466	823	35	788
B25R20C07	25-7-20	Hs~MGC:BC037963.1~uORF:IOH25981	34	33	1
B25R20C08	25-8-20	Hs~MGC:BC037963.1~uORF:IOH25981	40	33	7
B25R20C09	25-9-20	Hs~Ref:NM_023030.1~N/A	355	33	322
B25R20C10	25-10-20	Hs~Ref:NM_023030.1~N/A	373	34	339
B25R20C11	25-11-20	Hs~MGC:BC003065.1~N/A	15274	36	15238
B25R20C12	25-12-20	Hs~MGC:BC003065.1~N/A	15127	37	15090
B25R20C13	25-13-20	Hs~Ref:NM_003160.1~N/A	280	38	242
B25R20C14	25-14-20	Hs~Ref:NM_003160.1~N/A	320	39	281
B25R20C15	25-15-20	Hs~Ref:NM_014210.2~uORF:IOH45478	234	124	110
B25R20C16	25-16-20	Hs~Ref:NM_014210.2~uORF:IOH45478	137	35	102
B25R20C17	25-17-20	Hs~Ref:ENST00000362035~uORF:IOH45515	98	34	64
B25R20C18	25-18-20	Hs~Ref:ENST00000362035~uORF:IOH45515	210	48	162
B25R20C19	25-19-20	Hs~Ref:NM_177988.1~uORF:IOH45539	525	35	490
B25R20C20	25-20-20	Hs~Ref:NM_177988.1~uORF:IOH45539	514	35	479
B25R20C21	25-21-20	Hs~Ref:NM_175081.1~uORF:IOH45450	210	73	137
B25R20C22	25-22-20	Hs~Ref:NM_175081.1~uORF:IOH45450	192	38	154
B25R21C01	25-1-21	Hs~Ref:NM_174900.2~uORF:IOH42924	47	37	10
B25R21C02	25-2-21	Hs~Ref:NM_174900.2~uORF:IOH42924	71	36	35
B25R21C03	25-3-21	Hs~Ref:NM_138634.1~uORF:IOH44784	143	34	109
B25R21C04	25-4-21	Hs~Ref:NM_138634.1~uORF:IOH44784	256	108	148
B25R21C05	25-5-21	Hs~MGC:NM_032021.2~uORF:IOH44529	347	38	309
B25R21C06	25-6-21	Hs~MGC:NM_032021.2~uORF:IOH44529	287	37	250
B25R21C07	25-7-21	Hs~Ref:P59092~uORF:IOH43062	346	35	311
B25R21C08	25-8-21	Hs~Ref:P59092~uORF:IOH43062	335	33	302
B25R21C09	25-9-21	Hs~Ref:NP_000221.1~CAT_10221-HNAE-25	34	33	1
B25R21C10	25-10-21	Hs~Ref:NP_000221.1~CAT_10221-HNAE-25	35	33	2
B25R21C11	25-11-21	Internal_1007209	1810	35	1775
B25R21C12	25-12-21	Internal_1007209	1952	35	1917
B25R21C13	25-13-21	Hs~Ref:AAH19931.1~CAT_10374-H08B-25	4741	34	4707
B25R21C14	25-14-21	Hs~Ref:AAH19931.1~CAT_10374-H08B-25	4634	34	4600
B25R21C15	25-15-21	Internal_1007209	39	33	6
B25R21C16	25-16-21	Internal_1007209	55	35	20
B25R21C17	25-17-21	Hs~Ref:NP_000565.1~CAT_10101-H08H-25	41	33	8
B25R21C18	25-18-21	Hs~Ref:NP_000565.1~CAT_10101-H08H-25	55	38	17
B25R21C19	25-19-21	Internal_1007209	35	33	2
B25R21C20	25-20-21	Internal_1007209	35	33	2
B25R21C21	25-21-21	Hs~Ref:NP_001020539.2~CAT_PHC9391	93	34	59
B25R21C22	25-22-21	Hs~Ref:NP_001020539.2~CAT_PHC9391	91	34	57
B25R22C01	25-1-22	ERa~N/A	2624	36	2588
B25R22C02	25-2-22	ERa~N/A	2593	36	2557
B25R22C03	25-3-22	PKCeta~N/A	184	35	149
B25R22C04	25-4-22	PKCeta~N/A	277	37	240
B25R22C05	25-5-22	Calmodulin~N/A	50	35	15
B25R22C06	25-6-22	Calmodulin~N/A	47	39	8
B25R22C07	25-7-22	V5control5~N/A	353	125	228
B25R22C08	25-8-22	V5control5~N/A	281	83	198
B25R22C09	25-9-22	V5control4~N/A	88	35	53
B25R22C10	25-10-22	V5control4~N/A	55	42	13
B25R22C11	25-11-22	V5control3~N/A	65	34	31
B25R22C12	25-12-22	V5control3~N/A	69	34	35
B25R22C13	25-13-22	V5control2~N/A	50	34	16
B25R22C14	25-14-22	V5control2~N/A	89	39	50
B25R22C15	25-15-22	V5control1~N/A	47	33	14
B25R22C16	25-16-22	V5control1~N/A	50	34	16
B25R22C17	25-17-22	CMK2A~N/A	559	34	525
B25R22C18	25-18-22	CMK2A~N/A	548	34	514
B25R22C19	25-19-22	ERa~N/A	1951	34	1917
B25R22C20	25-20-22	ERa~N/A	1995	34	1961
B25R22C21	25-21-22	AlexaAntiMouseAb~N/A	9538	36	9502
B25R22C22	25-22-22	AlexaAntiMouseAb~N/A	9249	36	9213
B26R01C01	26-1-1	AlexaAntiMouseAb~N/A	34210	37	34173
B26R01C02	26-2-1	AlexaAntiMouseAb~N/A	34066	37	34029
B26R01C03	26-3-1	ERa~N/A	1859	36	1823
B26R01C04	26-4-1	ERa~N/A	1884	36	1848
B26R01C05	26-5-1	HumanIgG1~N/A	816	38	778
B26R01C06	26-6-1	HumanIgG1~N/A	1798	45	1753
B26R01C07	26-7-1	HumanIgG2~N/A	2951	48	2903
B26R01C08	26-8-1	HumanIgG2~N/A	3366	51	3315
B26R01C09	26-9-1	HumanIgG3~N/A	15858	58	15800
B26R01C10	26-10-1	HumanIgG3~N/A	17169	72	17097
B26R01C11	26-11-1	HumanIgG4~N/A	53709	78	53631
B26R01C12	26-12-1	HumanIgG4~N/A	65535	64	65471
B26R01C13	26-13-1	BiotinAb~N/A	425	45	380
B26R01C14	26-14-1	BiotinAb~N/A	486	44	442
B26R01C15	26-15-1	RanBP2deltaFG~N/A	297	44	253
B26R01C16	26-16-1	RanBP2deltaFG~N/A	230	43	187
B26R01C17	26-17-1	hMDM2~N/A	843	42	801
B26R01C18	26-18-1	hMDM2~N/A	920	42	878
B26R01C19	26-19-1	PKCeta~N/A	478	43	435
B26R01C20	26-20-1	PKCeta~N/A	316	41	275
B26R01C21	26-21-1	AlexaAntiMouseAb~N/A	36649	42	36607
B26R01C22	26-22-1	AlexaAntiMouseAb~N/A	29306	43	29263
B26R02C01	26-1-2	PKCeta~N/A	929	36	893
B26R02C02	26-2-2	PKCeta~N/A	1170	38	1132
B26R02C03	26-3-2	Buffer	253	96	157
B26R02C04	26-4-2	Buffer	140	38	102
B26R02C05	26-5-2	HumanIgA~N/A	18885	41	18844
B26R02C06	26-6-2	HumanIgA~N/A	23010	49	22961
B26R02C07	26-7-2	Buffer	146	79	67
B26R02C08	26-8-2	Buffer	106	50	56
B26R02C09	26-9-2	BSA~N/A	12782	54	12728
B26R02C10	26-10-2	BSA~N/A	14294	73	14221
B26R02C11	26-11-2	Hs~Ref:NM_023079.2~uORF:IOH10095	254	90	164
B26R02C12	26-12-2	Hs~Ref:NM_023079.2~uORF:IOH10095	822	224	598
B26R02C13	26-13-2	Hs~MGC:BC031427.1~uORF:IOH22113	217	49	168
B26R02C14	26-14-2	Hs~MGC:BC031427.1~uORF:IOH22113	174	60	114
B26R02C15	26-15-2	Hs~Ref:NM_002001.1~uORF:IOH7481	448	45	403
B26R02C16	26-16-2	Hs~Ref:NM_002001.1~uORF:IOH7481	398	47	351
B26R02C17	26-17-2	Hs~MGC:BC009623.1~uORF:IOH9844	340	67	273
B26R02C18	26-18-2	Hs~MGC:BC009623.1~uORF:IOH9844	279	79	200
B26R02C19	26-19-2	Hs~Ref:NM_004809.3~uORF:IOH22671	624	46	578
B26R02C20	26-20-2	Hs~Ref:NM_004809.3~uORF:IOH22671	645	43	602
B26R02C21	26-21-2	Hs~Ref:NM_021103.2~uORF:IOH10060	367	43	324
B26R02C22	26-22-2	Hs~Ref:NM_021103.2~uORF:IOH10060	356	42	314
B26R03C01	26-1-3	Hs~Ref:NM_000909.4~uORF:IOH22474	265	36	229
B26R03C02	26-2-3	Hs~Ref:NM_000909.4~uORF:IOH22474	271	40	231
B26R03C03	26-3-3	Hs~Ref:NM_003827.2~uORF:IOH4804	229	47	182
B26R03C04	26-4-3	Hs~Ref:NM_003827.2~uORF:IOH4804	201	46	155
B26R03C05	26-5-3	Hs~Ref:NM_013313.3~uORF:IOH43282	552	44	508
B26R03C06	26-6-3	Hs~Ref:NM_013313.3~uORF:IOH43282	556	41	515
B26R03C07	26-7-3	Hs~Ref:NM_002934.2~uORF:IOH44348	444	50	394
B26R03C08	26-8-3	Hs~Ref:NM_002934.2~uORF:IOH44348	399	380	19
B26R03C09	26-9-3	Hs~Ref:NM_182759.2~uORF:IOH42521	199	57	142
B26R03C10	26-10-3	Hs~Ref:NM_182759.2~uORF:IOH42521	248	176	72
B26R03C11	26-11-3	Hs~Ref:NM_007075.3~uORF:IOH45934	338	91	247
B26R03C12	26-12-3	Hs~Ref:NM_007075.3~uORF:IOH45934	304	77	227
B26R03C13	26-13-3	Hs~Ref:XM_096472.2~uORF:IOH42996	309	48	261
B26R03C14	26-14-3	Hs~Ref:XM_096472.2~uORF:IOH42996	390	71	319
B26R03C15	26-15-3	Hs~Ref:NM_018664.1~uORF:IOH44746	1482	45	1437
B26R03C16	26-16-3	Hs~Ref:NM_018664.1~uORF:IOH44746	1555	49	1506
B26R03C17	26-17-3	Hs~Ref:NM_017927.2~uORF:IOH43690	396	83	313
B26R03C18	26-18-3	Hs~Ref:NM_017927.2~uORF:IOH43690	112	50	62
B26R03C19	26-19-3	Hs~Ref:NM_016339.1~uORF:IOH42129	516	103	413
B26R03C20	26-20-3	Hs~Ref:NM_016339.1~uORF:IOH42129	399	63	336
B26R03C21	26-21-3	Hs~Ref:NM_018129.1~uORF:IOH5875	666	46	620
B26R03C22	26-22-3	Hs~Ref:NM_018129.1~uORF:IOH5875	608	42	566
B26R04C01	26-1-4	Hs~Ref:NM_007241.2~uORF:IOH3275	337	36	301
B26R04C02	26-2-4	Hs~Ref:NM_007241.2~uORF:IOH3275	340	37	303
B26R04C03	26-3-4	Hs~Ref:NM_015975.3~uORF:IOH14186	556	39	517
B26R04C04	26-4-4	Hs~Ref:NM_015975.3~uORF:IOH14186	557	39	518
B26R04C05	26-5-4	Hs~Ref:NM_024093.1~uORF:IOH3089	1054	39	1015
B26R04C06	26-6-4	Hs~Ref:NM_024093.1~uORF:IOH3089	827	38	789
B26R04C07	26-7-4	Hs~MGC:BC029580.1~uORF:IOH21597	506	44	462
B26R04C08	26-8-4	Hs~MGC:BC029580.1~uORF:IOH21597	621	76	545
B26R04C09	26-9-4	Hs~MGC:BC033154.1~uORF:IOH23226	1412	69	1343
B26R04C10	26-10-4	Hs~MGC:BC033154.1~uORF:IOH23226	1553	84	1469
B26R04C11	26-11-4	Hs~MGC:BC017114.1~uORF:IOH9995	40132	94	40038
B26R04C12	26-12-4	Hs~MGC:BC017114.1~uORF:IOH9995	37724	89	37635
B26R04C13	26-13-4	Hs~MGC:BC011963.1~uORF:IOH10799	458	258	200
B26R04C14	26-14-4	Hs~MGC:BC011963.1~uORF:IOH10799	235	58	177
B26R04C15	26-15-4	Hs~MGC:BC004207.1~N/A	166	47	119
B26R04C16	26-16-4	Hs~MGC:BC004207.1~N/A	341	123	218
B26R04C17	26-17-4	Hs~Ref:NM_002750.2~N/A	199	47	152
B26R04C18	26-18-4	Hs~Ref:NM_002750.2~N/A	199	51	148
B26R04C19	26-19-4	Hs~MGC:BC020555.1~uORF:IOH10305	9602	66	9536
B26R04C20	26-20-4	Hs~MGC:BC020555.1~uORF:IOH10305	9221	56	9165
B26R04C21	26-21-4	Hs~MGC:BC011519.1~uORF:IOH9674	380	44	336
B26R04C22	26-22-4	Hs~MGC:BC011519.1~uORF:IOH9674	341	43	298
B26R05C01	26-1-5	Hs~Ref:XM_379183.1~uORF:IOH43202	289	36	253
B26R05C02	26-2-5	Hs~Ref:XM_379183.1~uORF:IOH43202	310	37	273
B26R05C03	26-3-5	Hs~Ref:NM_198156.1~uORF:IOH43352	309	39	270
B26R05C04	26-4-5	Hs~Ref:NM_198156.1~uORF:IOH43352	268	50	218
B26R05C05	26-5-5	Hs~Ref:NM_181678.1~uORF:IOH43154	135	38	97
B26R05C06	26-6-5	Hs~Ref:NM_181678.1~uORF:IOH43154	189	37	152
B26R05C07	26-7-5	Hs~Ref:NM_030650.1~uORF:IOH43353	313	44	269
B26R05C08	26-8-5	Hs~Ref:NM_030650.1~uORF:IOH43353	80	84	-4
B26R05C09	26-9-5	Hs~Ref:NM_017822.2~uORF:IOH13333	3462	81	3381
B26R05C10	26-10-5	Hs~Ref:NM_017822.2~uORF:IOH13333	3533	81	3452
B26R05C11	26-11-5	Hs~MGC:BC001871.1~uORF:IOH4982	482	164	318
B26R05C12	26-12-5	Hs~MGC:BC001871.1~uORF:IOH4982	391	95	296
B26R05C13	26-13-5	Hs~MGC:BC003049.1~uORF:IOH4999	22024	74	21950
B26R05C14	26-14-5	Hs~MGC:BC003049.1~uORF:IOH4999	23594	61	23533
B26R05C15	26-15-5	Hs~Ref:NM_001859.2~uORF:IOH11517	273	52	221
B26R05C16	26-16-5	Hs~Ref:NM_001859.2~uORF:IOH11517	594	49	545
B26R05C17	26-17-5	Hs~Ref:NM_032405.1~uORF:IOH35575	339	58	281
B26R05C18	26-18-5	Hs~Ref:NM_032405.1~uORF:IOH35575	150	64	86
B26R05C19	26-19-5	Hs~Ref:NM_198460.1~uORF:IOH36042	244	87	157
B26R05C20	26-20-5	Hs~Ref:NM_198460.1~uORF:IOH36042	289	54	235
B26R05C21	26-21-5	Hs~Ref:NM_021155.2~uORF:IOH35696	125	49	76
B26R05C22	26-22-5	Hs~Ref:NM_021155.2~uORF:IOH35696	148	68	80
B26R06C01	26-1-6	Hs~Ref:NM_001821.2~uORF:IOH36065	308	37	271
B26R06C02	26-2-6	Hs~Ref:NM_001821.2~uORF:IOH36065	277	38	239
B26R06C03	26-3-6	Hs~Ref:NM_003406.2~uORF:IOH3874	686	38	648
B26R06C04	26-4-6	Hs~Ref:NM_003406.2~uORF:IOH3874	711	38	673
B26R06C05	26-5-6	Hs~Ref:NM_000074.2~uORF:IOH44350	315	40	275
B26R06C06	26-6-6	Hs~Ref:NM_000074.2~uORF:IOH44350	312	38	274
B26R06C07	26-7-6	Hs~Ref:NM_006808.2~uORF:IOH4539	350	45	305
B26R06C08	26-8-6	Hs~Ref:NM_006808.2~uORF:IOH4539	237	56	181
B26R06C09	26-9-6	Hs~MGC:BC025767.1~uORF:IOH11434	326	54	272
B26R06C10	26-10-6	Hs~MGC:BC025767.1~uORF:IOH11434	530	160	370
B26R06C11	26-11-6	Hs~MGC:NM_019010.1~uORF:IOH22697	666	70	596
B26R06C12	26-12-6	Hs~MGC:NM_019010.1~uORF:IOH22697	521	64	457
B26R06C13	26-13-6	Hs~Ref:NM_002201.3~uORF:IOH6793	725	52	673
B26R06C14	26-14-6	Hs~Ref:NM_002201.3~uORF:IOH6793	739	47	692
B26R06C15	26-15-6	Hs~Ref:NM_018466.2~uORF:IOH7131	213	123	90
B26R06C16	26-16-6	Hs~Ref:NM_018466.2~uORF:IOH7131	241	82	159
B26R06C17	26-17-6	Hs~MGC:BC005187.1~uORF:IOH7207	464	49	415
B26R06C18	26-18-6	Hs~MGC:BC005187.1~uORF:IOH7207	490	67	423
B26R06C19	26-19-6	Hs~MGC:BC096245.1~uORF:IOH63235	2223	52	2171
B26R06C20	26-20-6	Hs~MGC:BC096245.1~uORF:IOH63235	2167	51	2116
B26R06C21	26-21-6	Hs~Ref:NM_022438.1~uORF:IOH58625	124	48	76
B26R06C22	26-22-6	Hs~Ref:NM_022438.1~uORF:IOH58625	112	52	60
B26R07C01	26-1-7	Hs~MGC:BC092473.1~uORF:IOH62652	312	37	275
B26R07C02	26-2-7	Hs~MGC:BC092473.1~uORF:IOH62652	320	37	283
B26R07C03	26-3-7	Hs~Ref:NM_207002.1~uORF:IOH58626	481	36	445
B26R07C04	26-4-7	Hs~Ref:NM_207002.1~uORF:IOH58626	456	36	420
B26R07C05	26-5-7	Hs~Ref:NM_022551.2~uORF:IOH41520	500	39	461
B26R07C06	26-6-7	Hs~Ref:NM_022551.2~uORF:IOH41520	484	39	445
B26R07C07	26-7-7	Hs~Ref:NM_004403.1~uORF:IOH41276	248	46	202
B26R07C08	26-8-7	Hs~Ref:NM_004403.1~uORF:IOH41276	167	56	111
B26R07C09	26-9-7	Hs~Ref:NM_005765.2~uORF:IOH42509	709	119	590
B26R07C10	26-10-7	Hs~Ref:NM_005765.2~uORF:IOH42509	559	63	496
B26R07C11	26-11-7	Hs~Ref:NM_194457.1~uORF:IOH41277	617	73	544
B26R07C12	26-12-7	Hs~Ref:NM_194457.1~uORF:IOH41277	640	65	575
B26R07C13	26-13-7	Hs~Ref:NM_003576.2~N/A	314	62	252
B26R07C14	26-14-7	Hs~Ref:NM_003576.2~N/A	102	45	57
B26R07C15	26-15-7	Hs~Ref:NM_003160.1~N/A	138	46	92
B26R07C16	26-16-7	Hs~Ref:NM_003160.1~N/A	166	48	118
B26R07C17	26-17-7	Hs~MGC:BC015833.1~uORF:IOH14840	8814	48	8766
B26R07C18	26-18-7	Hs~MGC:BC015833.1~uORF:IOH14840	8736	53	8683
B26R07C19	26-19-7	Hs~MGC:BC019015.2~uORF:IOH12089	268	61	207
B26R07C20	26-20-7	Hs~MGC:BC019015.2~uORF:IOH12089	283	138	145
B26R07C21	26-21-7	Hs~Ref:NM_016819.2~uORF:IOH59379	373	54	319
B26R07C22	26-22-7	Hs~Ref:NM_016819.2~uORF:IOH59379	417	46	371
B26R08C01	26-1-8	Hs~Ref:NM_020386.2~uORF:IOH54689	293	37	256
B26R08C02	26-2-8	Hs~Ref:NM_020386.2~uORF:IOH54689	321	41	280
B26R08C03	26-3-8	Hs~Ref:NM_014606.1~uORF:IOH53090	413	49	364
B26R08C04	26-4-8	Hs~Ref:NM_014606.1~uORF:IOH53090	344	47	297
B26R08C05	26-5-8	Hs~Ref:NM_014721.1~uORF:IOH60008	537	43	494
B26R08C06	26-6-8	Hs~Ref:NM_014721.1~uORF:IOH60008	753	45	708
B26R08C07	26-7-8	Hs~Ref:NM_004990.2~uORF:IOH3655	1390	52	1338
B26R08C08	26-8-8	Hs~Ref:NM_004990.2~uORF:IOH3655	1335	56	1279
B26R08C09	26-9-8	Hs~MGC:BC000525.1~uORF:IOH3627	437	56	381
B26R08C10	26-10-8	Hs~MGC:BC000525.1~uORF:IOH3627	452	63	389
B26R08C11	26-11-8	Hs~MGC:BC000645.1~uORF:IOH4240	516	74	442
B26R08C12	26-12-8	Hs~MGC:BC000645.1~uORF:IOH4240	485	65	420
B26R08C13	26-13-8	Hs~MGC:BC012824.1~uORF:IOH22892	356	51	305
B26R08C14	26-14-8	Hs~MGC:BC012824.1~uORF:IOH22892	399	50	349
B26R08C15	26-15-8	Hs~MGC:NM_006216.2~uORF:IOH12816	421	50	371
B26R08C16	26-16-8	Hs~MGC:NM_006216.2~uORF:IOH12816	544	46	498
B26R08C17	26-17-8	Hs~Ref:NM_144982.1~uORF:IOH12275	4097	44	4053
B26R08C18	26-18-8	Hs~Ref:NM_144982.1~uORF:IOH12275	4413	46	4367
B26R08C19	26-19-8	Hs~Ref:NM_025065.4~uORF:IOH13307	576	50	526
B26R08C20	26-20-8	Hs~Ref:NM_025065.4~uORF:IOH13307	578	50	528
B26R08C21	26-21-8	Hs~Ref:NM_002704.1~uORF:IOH12030	345	51	294
B26R08C22	26-22-8	Hs~Ref:NM_002704.1~uORF:IOH12030	466	51	415
B26R09C01	26-1-9	Hs~Ref:NM_005512.1~uORF:IOH40550	312	40	272
B26R09C02	26-2-9	Hs~Ref:NM_005512.1~uORF:IOH40550	250	119	131
B26R09C03	26-3-9	Hs~Ref:NM_006205.1~uORF:IOH40356	1938	49	1889
B26R09C04	26-4-9	Hs~Ref:NM_006205.1~uORF:IOH40356	1979	46	1933
B26R09C05	26-5-9	Hs~MGC:BC069285.1~uORF:IOH40391	375	48	327
B26R09C06	26-6-9	Hs~MGC:BC069285.1~uORF:IOH40391	432	51	381
B26R09C07	26-7-9	Hs~MGC:BC065030.1~uORF:IOH40478	624	61	563
B26R09C08	26-8-9	Hs~MGC:BC065030.1~uORF:IOH40478	911	390	521
B26R09C09	26-9-9	Hs~Ref:NM_014325.1~uORF:IOH3562	221	54	167
B26R09C10	26-10-9	Hs~Ref:NM_014325.1~uORF:IOH3562	157	57	100
B26R09C11	26-11-9	Hs~Ref:NM_002802.1~uORF:IOH3591	330	69	261
B26R09C12	26-12-9	Hs~Ref:NM_002802.1~uORF:IOH3591	420	81	339
B26R09C13	26-13-9	Hs~Ref:NM_005566.1~uORF:IOH3797	290	52	238
B26R09C14	26-14-9	Hs~Ref:NM_005566.1~uORF:IOH3797	66	52	14
B26R09C15	26-15-9	Hs~Ref:NM_032214.1~uORF:IOH26309	562	51	511
B26R09C16	26-16-9	Hs~Ref:NM_032214.1~uORF:IOH26309	439	47	392
B26R09C17	26-17-9	Hs~Ref:NM_138810.1~uORF:IOH12231	458	44	414
B26R09C18	26-18-9	Hs~Ref:NM_138810.1~uORF:IOH12231	462	46	416
B26R09C19	26-19-9	Hs~MGC:BC022043.1~uORF:IOH13409	44	46	-2
B26R09C20	26-20-9	Hs~MGC:BC022043.1~uORF:IOH13409	48	46	2
B26R09C21	26-21-9	Hs~MGC:BC017249.1~uORF:IOH12653	511	53	458
B26R09C22	26-22-9	Hs~MGC:BC017249.1~uORF:IOH12653	626	51	575
B26R10C01	26-1-10	Hs~MGC:NM_173474.2~uORF:IOH13254	1301	36	1265
B26R10C02	26-2-10	Hs~MGC:NM_173474.2~uORF:IOH13254	1397	37	1360
B26R10C03	26-3-10	Hs~MGC:BC037219.1~uORF:IOH28669	302	37	265
B26R10C04	26-4-10	Hs~MGC:BC037219.1~uORF:IOH28669	294	37	257
B26R10C05	26-5-10	Hs~MGC:BC052813.1~uORF:IOH29045	716	40	676
B26R10C06	26-6-10	Hs~MGC:BC052813.1~uORF:IOH29045	753	52	701
B26R10C07	26-7-10	Hs~MGC:BC057774.1~uORF:IOH29168	1190	55	1135
B26R10C08	26-8-10	Hs~MGC:BC057774.1~uORF:IOH29168	1062	52	1010
B26R10C09	26-9-10	Hs~MGC:BC051000.1~uORF:IOH28084	2044	51	1993
B26R10C10	26-10-10	Hs~MGC:BC051000.1~uORF:IOH28084	2062	53	2009
B26R10C11	26-11-10	GST1	401	64	337
B26R10C12	26-12-10	GST1	117	60	57
B26R10C13	26-13-10	GST2	69	49	20
B26R10C14	26-14-10	GST2	46	48	-2
B26R10C15	26-15-10	GST3	56	45	11
B26R10C16	26-16-10	GST3	53	45	8
B26R10C17	26-17-10	GST4	69	44	25
B26R10C18	26-18-10	GST4	101	54	47
B26R10C19	26-19-10	Anti-HumanIgA1~N/A	7963	47	7916
B26R10C20	26-20-10	Anti-HumanIgA1~N/A	9321	46	9275
B26R10C21	26-21-10	Anti-HumanIgA2~N/A	15580	50	15530
B26R10C22	26-22-10	Anti-HumanIgA2~N/A	16219	49	16170
B26R11C01	26-1-11	AlexaAntiMouseAb~N/A	24618	37	24581
B26R11C02	26-2-11	AlexaAntiMouseAb~N/A	23974	37	23937
B26R11C03	26-3-11	MAPKAP~N/A	66	35	31
B26R11C04	26-4-11	MAPKAP~N/A	61	36	25
B26R11C05	26-5-11	Buffer	411	37	374
B26R11C06	26-6-11	Buffer	578	92	486
B26R11C07	26-7-11	BSA~N/A	9122	53	9069
B26R11C08	26-8-11	BSA~N/A	10416	48	10368
B26R11C09	26-9-11	Anti-HumanIgG1~N/A	1740	48	1692
B26R11C10	26-10-11	Anti-HumanIgG1~N/A	2008	51	1957
B26R11C11	26-11-11	Anti-HumanIgG2~N/A	2895	60	2835
B26R11C12	26-12-11	Anti-HumanIgG2~N/A	3675	59	3616
B26R11C13	26-13-11	Anti-HumanIgG3~N/A	4928	51	4877
B26R11C14	26-14-11	Anti-HumanIgG3~N/A	6725	45	6680
B26R11C15	26-15-11	Anti-HumanIgG4~N/A	10738	45	10693
B26R11C16	26-16-11	Anti-HumanIgG4~N/A	12544	44	12500
B26R11C17	26-17-11	AntiBiotinAb~N/A	13303	45	13258
B26R11C18	26-18-11	AntiBiotinAb~N/A	13201	47	13154
B26R11C19	26-19-11	Buffer	89	48	41
B26R11C20	26-20-11	Buffer	57	46	11
B26R11C21	26-21-11	Hs~MGC:BC027596.1~uORF:IOH11362	853	76	777
B26R11C22	26-22-11	Hs~MGC:BC027596.1~uORF:IOH11362	231	51	180
B26R12C01	26-1-12	Hs~MGC:BC040693.1~uORF:IOH26345	265	38	227
B26R12C02	26-2-12	Hs~MGC:BC040693.1~uORF:IOH26345	318	43	275
B26R12C03	26-3-12	Hs~MGC:BC041133.1~uORF:IOH26142	637	37	600
B26R12C04	26-4-12	Hs~MGC:BC041133.1~uORF:IOH26142	765	37	728
B26R12C05	26-5-12	Hs~MGC:BC044953.1~uORF:IOH26375	416	38	378
B26R12C06	26-6-12	Hs~MGC:BC044953.1~uORF:IOH26375	372	48	324
B26R12C07	26-7-12	Hs~Ref:NM_012148.1~uORF:IOH39321	787	72	715
B26R12C08	26-8-12	Hs~Ref:NM_012148.1~uORF:IOH39321	706	56	650
B26R12C09	26-9-12	Hs~Ref:NM_144980.1~uORF:IOH12741	335	54	281
B26R12C10	26-10-12	Hs~Ref:NM_144980.1~uORF:IOH12741	455	54	401
B26R12C11	26-11-12	Hs~MGC:NM_182661.1~uORF:IOH5501	606	63	543
B26R12C12	26-12-12	Hs~MGC:NM_182661.1~uORF:IOH5501	688	67	621
B26R12C13	26-13-12	Hs~MGC:BC036054.2~uORF:IOH27217	353	58	295
B26R12C14	26-14-12	Hs~MGC:BC036054.2~uORF:IOH27217	490	47	443
B26R12C15	26-15-12	Hs~MGC:BC034762.1~uORF:IOH22673	402	46	356
B26R12C16	26-16-12	Hs~MGC:BC034762.1~uORF:IOH22673	410	45	365
B26R12C17	26-17-12	Hs~MGC:BC096281.2~uORF:IOH63276	194	46	148
B26R12C18	26-18-12	Hs~MGC:BC096281.2~uORF:IOH63276	140	47	93
B26R12C19	26-19-12	Hs~Ref:NM_145293.1~uORF:IOH11848	141	52	89
B26R12C20	26-20-12	Hs~Ref:NM_145293.1~uORF:IOH11848	119	57	62
B26R12C21	26-21-12	Hs~Ref:NM_000232.1~uORF:IOH12316	566	98	468
B26R12C22	26-22-12	Hs~Ref:NM_000232.1~uORF:IOH12316	611	95	516
B26R13C01	26-1-13	Hs~Ref:NM_032853.2~uORF:IOH42561	405	36	369
B26R13C02	26-2-13	Hs~Ref:NM_032853.2~uORF:IOH42561	444	37	407
B26R13C03	26-3-13	Hs~Ref:NM_015554.1~uORF:IOH44553	453	37	416
B26R13C04	26-4-13	Hs~Ref:NM_015554.1~uORF:IOH44553	467	38	429
B26R13C05	26-5-13	Hs~Ref:NM_003592.2~uORF:IOH41991	369	40	329
B26R13C06	26-6-13	Hs~Ref:NM_003592.2~uORF:IOH41991	661	58	603
B26R13C07	26-7-13	Hs~Ref:NM_182800.2~uORF:IOH44806	574	321	253
B26R13C08	26-8-13	Hs~Ref:NM_182800.2~uORF:IOH44806	350	97	253
B26R13C09	26-9-13	Hs~Ref:NM_001894.2~uORF:IOH21160	3022	55	2967
B26R13C10	26-10-13	Hs~Ref:NM_001894.2~uORF:IOH21160	5107	54	5053
B26R13C11	26-11-13	Hs~MGC:BC005982.1~uORF:IOH7502	185	62	123
B26R13C12	26-12-13	Hs~MGC:BC005982.1~uORF:IOH7502	280	71	209
B26R13C13	26-13-13	Hs~Ref:NM_000430.2~uORF:IOH39940	738	85	653
B26R13C14	26-14-13	Hs~Ref:NM_000430.2~uORF:IOH39940	575	57	518
B26R13C15	26-15-13	Hs~MGC:NM_198498.1~uORF:IOH26293	305	54	251
B26R13C16	26-16-13	Hs~MGC:NM_198498.1~uORF:IOH26293	193	83	110
B26R13C17	26-17-13	Hs~MGC:BC006456.1~uORF:IOH5963	392	48	344
B26R13C18	26-18-13	Hs~MGC:BC006456.1~uORF:IOH5963	477	57	420
B26R13C19	26-19-13	Hs~Ref:NM_004781.2~uORF:IOH4958	314	82	232
B26R13C20	26-20-13	Hs~Ref:NM_004781.2~uORF:IOH4958	420	99	321
B26R13C21	26-21-13	Hs~Ref:NM_138480.1~uORF:IOH10174	201	46	155
B26R13C22	26-22-13	Hs~Ref:NM_138480.1~uORF:IOH10174	215	80	135
B26R14C01	26-1-14	Hs~Ref:NM_138470.1~uORF:IOH10205	315	36	279
B26R14C02	26-2-14	Hs~Ref:NM_138470.1~uORF:IOH10205	315	37	278
B26R14C03	26-3-14	Hs~Ref:NM_019117.3~uORF:IOH52693	259	39	220
B26R14C04	26-4-14	Hs~Ref:NM_019117.3~uORF:IOH52693	293	120	173
B26R14C05	26-5-14	Hs~Ref:NM_007087.1~uORF:IOH59514	241	107	134
B26R14C06	26-6-14	Hs~Ref:NM_007087.1~uORF:IOH59514	133	49	84
B26R14C07	26-7-14	Hs~Ref:NM_006987.2~uORF:IOH59342	757	58	699
B26R14C08	26-8-14	Hs~Ref:NM_006987.2~uORF:IOH59342	736	51	685
B26R14C09	26-9-14	Hs~Ref:NM_006287.3~uORF:IOH59292	115	50	65
B26R14C10	26-10-14	Hs~Ref:NM_006287.3~uORF:IOH59292	288	57	231
B26R14C11	26-11-14	Hs~MGC:BC002553.1~uORF:IOH4036	672	80	592
B26R14C12	26-12-14	Hs~MGC:BC002553.1~uORF:IOH4036	340	115	225
B26R14C13	26-13-14	Hs~Ref:NM_007051.2~uORF:IOH5135	212	93	119
B26R14C14	26-14-14	Hs~Ref:NM_007051.2~uORF:IOH5135	112	103	9
B26R14C15	26-15-14	Hs~MGC:BC001904.1~uORF:IOH4832	287	96	191
B26R14C16	26-16-14	Hs~MGC:BC001904.1~uORF:IOH4832	217	83	134
B26R14C17	26-17-14	Hs~Ref:NM_000291.2~uORF:IOH42151	327	47	280
B26R14C18	26-18-14	Hs~Ref:NM_000291.2~uORF:IOH42151	294	55	239
B26R14C19	26-19-14	Hs~Ref:NM_001025595.1~uORF:IOH60838	318	50	268
B26R14C20	26-20-14	Hs~Ref:NM_001025595.1~uORF:IOH60838	335	86	249
B26R14C21	26-21-14	Hs~Ref:NM_001005284.1~uORF:IOH60781	199	44	155
B26R14C22	26-22-14	Hs~Ref:NM_001005284.1~uORF:IOH60781	249	44	205
B26R15C01	26-1-15	Hs~MGC:BC102030.1~uORF:IOH63600	347	35	312
B26R15C02	26-2-15	Hs~MGC:BC102030.1~uORF:IOH63600	335	36	299
B26R15C03	26-3-15	Hs~Ref:NM_173824.2~uORF:IOH60782	257	37	220
B26R15C04	26-4-15	Hs~Ref:NM_173824.2~uORF:IOH60782	251	37	214
B26R15C05	26-5-15	Hs~MGC:NM_174930.2~uORF:IOH11024	352	38	314
B26R15C06	26-6-15	Hs~MGC:NM_174930.2~uORF:IOH11024	431	56	375
B26R15C07	26-7-15	Hs~Ref:NM_032564.1~uORF:IOH10833	380	62	318
B26R15C08	26-8-15	Hs~Ref:NM_032564.1~uORF:IOH10833	288	56	232
B26R15C09	26-9-15	Hs~MGC:BC029605.1~uORF:IOH21616	601	62	539
B26R15C10	26-10-15	Hs~MGC:BC029605.1~uORF:IOH21616	451	51	400
B26R15C11	26-11-15	Hs~Ref:NM_006869.1~uORF:IOH21856	1841	58	1783
B26R15C12	26-12-15	Hs~Ref:NM_006869.1~uORF:IOH21856	1915	64	1851
B26R15C13	26-13-15	Hs~IVGN:PM_2137~Ext:La~N/A	60	63	-3
B26R15C14	26-14-15	Hs~IVGN:PM_2137~Ext:La~N/A	70	52	18
B26R15C15	26-15-15	Hs~Ref:NM_005030.2~CAT:PV3501	1468	46	1422
B26R15C16	26-16-15	Hs~Ref:NM_005030.2~CAT:PV3501	1614	48	1566
B26R15C17	26-17-15	Hs~Ref:NM_003390.2~CAT:PV3817	787	46	741
B26R15C18	26-18-15	Hs~Ref:NM_003390.2~CAT:PV3817	748	47	701
B26R15C19	26-19-15	Hs~Ref:NM_004635.2~CAT:PV3299	277	62	215
B26R15C20	26-20-15	Hs~Ref:NM_004635.2~CAT:PV3299	114	51	63
B26R15C21	26-21-15	Hs~Ref:NM_004431.1~CAT:PV3688	500	45	455
B26R15C22	26-22-15	Hs~Ref:NM_004431.1~CAT:PV3688	500	48	452
B26R16C01	26-1-16	Hs~Ref:NM_004836.2~CAT:PV5106	259	34	225
B26R16C02	26-2-16	Hs~Ref:NM_004836.2~CAT:PV5106	267	37	230
B26R16C03	26-3-16	Hs~Ref:NM_018724.3~CAT_PHC0205	374	37	337
B26R16C04	26-4-16	Hs~Ref:NM_018724.3~CAT_PHC0205	382	35	347
B26R16C05	26-5-16	Hs~Ref:NM_006274.2~CAT_PHC1244	93	35	58
B26R16C06	26-6-16	Hs~Ref:NM_006274.2~CAT_PHC1244	87	39	48
B26R16C07	26-7-16	Hs~Ref:NM_004127.3~uORF:IOH2368	697	296	401
B26R16C08	26-8-16	Hs~Ref:NM_004127.3~uORF:IOH2368	519	73	446
B26R16C09	26-9-16	Hs~MGC:BC012362.1~uORF:IOH12046	92	49	43
B26R16C10	26-10-16	Hs~MGC:BC012362.1~uORF:IOH12046	97	49	48
B26R16C11	26-11-16	Hs~Ref:NM_007198.1~uORF:IOH12511	1250	55	1195
B26R16C12	26-12-16	Hs~Ref:NM_007198.1~uORF:IOH12511	1329	63	1266
B26R16C13	26-13-16	Hs~Ref:NM_024821.1~uORF:IOH10944	243	110	133
B26R16C14	26-14-16	Hs~Ref:NM_024821.1~uORF:IOH10944	141	56	85
B26R16C15	26-15-16	Hs~Ref:NM_153329.2~uORF:IOH21432	483	82	401
B26R16C16	26-16-16	Hs~Ref:NM_153329.2~uORF:IOH21432	864	235	629
B26R16C17	26-17-16	Hs~MGC:BC022534.1~uORF:IOH10832	566	59	507
B26R16C18	26-18-16	Hs~MGC:BC022534.1~uORF:IOH10832	471	62	409
B26R16C19	26-19-16	Hs~Ref:NM_001024631.1~uORF:IOH57349	374	94	280
B26R16C20	26-20-16	Hs~Ref:NM_001024631.1~uORF:IOH57349	308	131	177
B26R16C21	26-21-16	Hs~Ref:NM_152485.2~uORF:IOH26147	388	52	336
B26R16C22	26-22-16	Hs~Ref:NM_152485.2~uORF:IOH26147	350	43	307
B26R17C01	26-1-17	Hs~Ref:NM_006695.2~uORF:IOH5798	291	36	255
B26R17C02	26-2-17	Hs~Ref:NM_006695.2~uORF:IOH5798	264	75	189
B26R17C03	26-3-17	Hs~MGC:BC010427.1~uORF:IOH14505	309	72	237
B26R17C04	26-4-17	Hs~MGC:BC010427.1~uORF:IOH14505	133	57	76
B26R17C05	26-5-17	Hs~Ref:NM_006713.2~uORF:IOH14686	332	92	240
B26R17C06	26-6-17	Hs~Ref:NM_006713.2~uORF:IOH14686	319	50	269
B26R17C07	26-7-17	Hs~MGC:NM_138353.1~uORF:IOH13957	314	62	252
B26R17C08	26-8-17	Hs~MGC:NM_138353.1~uORF:IOH13957	490	59	431
B26R17C09	26-9-17	Hs~Ref:NM_001005176.1~uORF:IOH40807	427	52	375
B26R17C10	26-10-17	Hs~Ref:NM_001005176.1~uORF:IOH40807	167	55	112
B26R17C11	26-11-17	Hs~Ref:NM_007117.1~uORF:IOH40291	321	144	177
B26R17C12	26-12-17	Hs~Ref:NM_007117.1~uORF:IOH40291	891	123	768
B26R17C13	26-13-17	Hs~MGC:BC021187.1~uORF:IOH10893	1315	62	1253
B26R17C14	26-14-17	Hs~MGC:BC021187.1~uORF:IOH10893	1434	56	1378
B26R17C15	26-15-17	Hs~Ref:NM_001412.2~uORF:IOH3055	822	69	753
B26R17C16	26-16-17	Hs~Ref:NM_001412.2~uORF:IOH3055	833	64	769
B26R17C17	26-17-17	Hs~Ref:NM_015509.2~uORF:IOH43513	1163	54	1109
B26R17C18	26-18-17	Hs~Ref:NM_015509.2~uORF:IOH43513	1026	49	977
B26R17C19	26-19-17	Hs~Ref:NM_031845.1~uORF:IOH37776	1400	68	1332
B26R17C20	26-20-17	Hs~Ref:NM_031845.1~uORF:IOH37776	1499	62	1437
B26R17C21	26-21-17	Hs~Ref:NM_001008723.1~uORF:IOH43999	509	56	453
B26R17C22	26-22-17	Hs~Ref:NM_001008723.1~uORF:IOH43999	536	42	494
B26R18C01	26-1-18	Hs~Ref:NM_018063.3~uORF:IOH44165	389	35	354
B26R18C02	26-2-18	Hs~Ref:NM_018063.3~uORF:IOH44165	394	36	358
B26R18C03	26-3-18	Hs~Ref:NM_002984.1~uORF:IOH29652	229	48	181
B26R18C04	26-4-18	Hs~Ref:NM_002984.1~uORF:IOH29652	72	37	35
B26R18C05	26-5-18	Hs~Ref:NM_005114.1~uORF:IOH29561	280	58	222
B26R18C06	26-6-18	Hs~Ref:NM_005114.1~uORF:IOH29561	387	87	300
B26R18C07	26-7-18	Hs~Ref:NM_004583.1~uORF:IOH29836	452	147	305
B26R18C08	26-8-18	Hs~Ref:NM_004583.1~uORF:IOH29836	164	59	105
B26R18C09	26-9-18	Hs~Ref:NM_080391.1~uORF:IOH29576	302	55	247
B26R18C10	26-10-18	Hs~Ref:NM_080391.1~uORF:IOH29576	673	83	590
B26R18C11	26-11-18	Hs~MGC:BC047223.1~uORF:IOH62429	350	60	290
B26R18C12	26-12-18	Hs~MGC:BC047223.1~uORF:IOH62429	211	122	89
B26R18C13	26-13-18	Hs~MGC:BC072461.1~uORF:IOH62565	1914	65	1849
B26R18C14	26-14-18	Hs~MGC:BC072461.1~uORF:IOH62565	1870	52	1818
B26R18C15	26-15-18	Hs~MGC:BC065533.1~uORF:IOH61590	1078	48	1030
B26R18C16	26-16-18	Hs~MGC:BC065533.1~uORF:IOH61590	1029	49	980
B26R18C17	26-17-18	Hs~MGC:BC070091.1~uORF:IOH62493	520	51	469
B26R18C18	26-18-18	Hs~MGC:BC070091.1~uORF:IOH62493	415	49	366
B26R18C19	26-19-18	Hs~MGC:BC033013.1~uORF:IOH62061	598	47	551
B26R18C20	26-20-18	Hs~MGC:BC033013.1~uORF:IOH62061	528	43	485
B26R18C21	26-21-18	Hs~Ref:NM_014021.2~uORF:IOH61022	284	44	240
B26R18C22	26-22-18	Hs~Ref:NM_014021.2~uORF:IOH61022	203	42	161
B26R19C01	26-1-19	Hs~Ref:NM_024770.1~uORF:IOH12447	353	37	316
B26R19C02	26-2-19	Hs~Ref:NM_024770.1~uORF:IOH12447	358	37	321
B26R19C03	26-3-19	Hs~MGC:BC003360.1~uORF:IOH2892	625	37	588
B26R19C04	26-4-19	Hs~MGC:BC003360.1~uORF:IOH2892	680	37	643
B26R19C05	26-5-19	Hs~Ref:NM_032016.1~uORF:IOH4681	292	52	240
B26R19C06	26-6-19	Hs~Ref:NM_032016.1~uORF:IOH4681	587	60	527
B26R19C07	26-7-19	Hs~Ref:NM_021107.1~uORF:IOH6073	311	57	254
B26R19C08	26-8-19	Hs~Ref:NM_021107.1~uORF:IOH6073	372	63	309
B26R19C09	26-9-19	Hs~MGC:BC063431.1~uORF:IOH61542	97	47	50
B26R19C10	26-10-19	Hs~MGC:BC063431.1~uORF:IOH61542	79	48	31
B26R19C11	26-11-19	Hs~MGC:BC027858.1~uORF:IOH61722	130	59	71
B26R19C12	26-12-19	Hs~MGC:BC027858.1~uORF:IOH61722	138	62	76
B26R19C13	26-13-19	Hs~MGC:BC039826.1~uORF:IOH26225	444	64	380
B26R19C14	26-14-19	Hs~MGC:BC039826.1~uORF:IOH26225	463	50	413
B26R19C15	26-15-19	Hs~Ref:NM_201432.1~uORF:IOH40915	559	47	512
B26R19C16	26-16-19	Hs~Ref:NM_201432.1~uORF:IOH40915	545	53	492
B26R19C17	26-17-19	Hs~Ref:NM_030971.3~uORF:IOH40819	504	198	306
B26R19C18	26-18-19	Hs~Ref:NM_030971.3~uORF:IOH40819	283	67	216
B26R19C19	26-19-19	Hs~Ref:NM_030570.2~uORF:IOH5529	376	45	331
B26R19C20	26-20-19	Hs~Ref:NM_030570.2~uORF:IOH5529	220	46	174
B26R19C21	26-21-19	Hs~MGC:BC008145.1~uORF:IOH3304	295	58	237
B26R19C22	26-22-19	Hs~MGC:BC008145.1~uORF:IOH3304	180	72	108
B26R20C01	26-1-20	Hs~Ref:NM_021159.2~uORF:IOH3912	201	37	164
B26R20C02	26-2-20	Hs~Ref:NM_021159.2~uORF:IOH3912	195	41	154
B26R20C03	26-3-20	Hs~Ref:NM_016049.1~uORF:IOH3959	375	115	260
B26R20C04	26-4-20	Hs~Ref:NM_016049.1~uORF:IOH3959	228	41	187
B26R20C05	26-5-20	Hs~MGC:BC015684.2~uORF:IOH14516	275	41	234
B26R20C06	26-6-20	Hs~MGC:BC015684.2~uORF:IOH14516	632	63	569
B26R20C07	26-7-20	Hs~Ref:NM_138369.1~uORF:IOH40571	291	214	77
B26R20C08	26-8-20	Hs~Ref:NM_138369.1~uORF:IOH40571	372	76	296
B26R20C09	26-9-20	Hs~Ref:NM_032017.1~uORF:IOH40615	5866	49	5817
B26R20C10	26-10-20	Hs~Ref:NM_032017.1~uORF:IOH40615	6137	45	6092
B26R20C11	26-11-20	Hs~Ref:NM_006611.1~uORF:IOH40369	310	46	264
B26R20C12	26-12-20	Hs~Ref:NM_006611.1~uORF:IOH40369	60	60	0
B26R20C13	26-13-20	Hs~Ref:NM_033345.1~uORF:IOH40371	2270	59	2211
B26R20C14	26-14-20	Hs~Ref:NM_033345.1~uORF:IOH40371	2182	49	2133
B26R20C15	26-15-20	Hs~Ref:NM_001005849.1~uORF:IOH50113	604	45	559
B26R20C16	26-16-20	Hs~Ref:NM_001005849.1~uORF:IOH50113	640	50	590
B26R20C17	26-17-20	Hs~Ref:ENST00000372698~uORF:IOH50095	202	69	133
B26R20C18	26-18-20	Hs~Ref:ENST00000372698~uORF:IOH50095	226	134	92
B26R20C19	26-19-20	Hs~Ref:NM_001009181.1~uORF:IOH50084	482	48	434
B26R20C20	26-20-20	Hs~Ref:NM_001009181.1~uORF:IOH50084	480	41	439
B26R20C21	26-21-20	Hs~Ref:NM_205837.1~uORF:IOH50125	2291	48	2243
B26R20C22	26-22-20	Hs~Ref:NM_205837.1~uORF:IOH50125	2757	45	2712
B26R21C01	26-1-21	Hs~Ref:NM_001002924.1~uORF:IOH50054	774	34	740
B26R21C02	26-2-21	Hs~Ref:NM_001002924.1~uORF:IOH50054	766	34	732
B26R21C03	26-3-21	Hs~Ref:NM_031416.1~uORF:IOH50153	811	36	775
B26R21C04	26-4-21	Hs~Ref:NM_031416.1~uORF:IOH50153	812	36	776
B26R21C05	26-5-21	Hs~Ref:NM_001187.1~uORF:IOH50070	467	38	429
B26R21C06	26-6-21	Hs~Ref:NM_001187.1~uORF:IOH50070	612	49	563
B26R21C07	26-7-21	Hs~Ref:NM_207288.1~uORF:IOH50123	825	53	772
B26R21C08	26-8-21	Hs~Ref:NM_207288.1~uORF:IOH50123	860	51	809
B26R21C09	26-9-21	Hs~Ref:NP_001769.2~CAT_10797-H08H-25	43	44	-1
B26R21C10	26-10-21	Hs~Ref:NP_001769.2~CAT_10797-H08H-25	46	43	3
B26R21C11	26-11-21	Internal_1007209	76	52	24
B26R21C12	26-12-21	Internal_1007209	75	63	12
B26R21C13	26-13-21	Hs~Ref:NP_004420.1~CAT_10894-H08H-25	414	69	345
B26R21C14	26-14-21	Hs~Ref:NP_004420.1~CAT_10894-H08H-25	160	57	103
B26R21C15	26-15-21	Internal_1007209	465	49	416
B26R21C16	26-16-21	Internal_1007209	226	45	181
B26R21C17	26-17-21	Hs~Ref:NP_004834.1~CAT_10489-H02H-25	17382	49	17333
B26R21C18	26-18-21	Hs~Ref:NP_004834.1~CAT_10489-H02H-25	17533	47	17486
B26R21C19	26-19-21	Internal_1007209	48	40	8
B26R21C20	26-20-21	Internal_1007209	62	43	19
B26R21C21	26-21-21	Internal_1007209	44	40	4
B26R21C22	26-22-21	Internal_1007209	42	40	2
B26R22C01	26-1-22	ERa~N/A	1731	34	1697
B26R22C02	26-2-22	ERa~N/A	1932	35	1897
B26R22C03	26-3-22	PKCeta~N/A	250	38	212
B26R22C04	26-4-22	PKCeta~N/A	226	43	183
B26R22C05	26-5-22	Calmodulin~N/A	53	38	15
B26R22C06	26-6-22	Calmodulin~N/A	367	53	314
B26R22C07	26-7-22	V5control5~N/A	582	52	530
B26R22C08	26-8-22	V5control5~N/A	583	52	531
B26R22C09	26-9-22	V5control4~N/A	174	46	128
B26R22C10	26-10-22	V5control4~N/A	197	99	98
B26R22C11	26-11-22	V5control3~N/A	95	51	44
B26R22C12	26-12-22	V5control3~N/A	58	64	-6
B26R22C13	26-13-22	V5control2~N/A	1426	67	1359
B26R22C14	26-14-22	V5control2~N/A	61	45	16
B26R22C15	26-15-22	V5control1~N/A	228	42	186
B26R22C16	26-16-22	V5control1~N/A	53	41	12
B26R22C17	26-17-22	CMK2A~N/A	666	40	626
B26R22C18	26-18-22	CMK2A~N/A	678	39	639
B26R22C19	26-19-22	ERa~N/A	1237	40	1197
B26R22C20	26-20-22	ERa~N/A	1315	41	1274
B26R22C21	26-21-22	AlexaAntiMouseAb~N/A	9338	44	9294
B26R22C22	26-22-22	AlexaAntiMouseAb~N/A	9795	42	9753
B27R01C01	27-1-1	AlexaAntiMouseAb~N/A	37485	42	37443
B27R01C02	27-2-1	AlexaAntiMouseAb~N/A	35438	42	35396
B27R01C03	27-3-1	ERa~N/A	1870	42	1828
B27R01C04	27-4-1	ERa~N/A	1785	41	1744
B27R01C05	27-5-1	HumanIgG1~N/A	1042	40	1002
B27R01C06	27-6-1	HumanIgG1~N/A	1418	40	1378
B27R01C07	27-7-1	HumanIgG2~N/A	2145	39	2106
B27R01C08	27-8-1	HumanIgG2~N/A	2878	40	2838
B27R01C09	27-9-1	HumanIgG3~N/A	12233	41	12192
B27R01C10	27-10-1	HumanIgG3~N/A	15438	42	15396
B27R01C11	27-11-1	HumanIgG4~N/A	34743	43	34700
B27R01C12	27-12-1	HumanIgG4~N/A	43095	43	43052
B27R01C13	27-13-1	BiotinAb~N/A	317	43	274
B27R01C14	27-14-1	BiotinAb~N/A	337	48	289
B27R01C15	27-15-1	RanBP2deltaFG~N/A	394	46	348
B27R01C16	27-16-1	RanBP2deltaFG~N/A	337	41	296
B27R01C17	27-17-1	hMDM2~N/A	730	42	688
B27R01C18	27-18-1	hMDM2~N/A	828	43	785
B27R01C19	27-19-1	PKCeta~N/A	332	42	290
B27R01C20	27-20-1	PKCeta~N/A	391	42	349
B27R01C21	27-21-1	AlexaAntiMouseAb~N/A	34188	43	34145
B27R01C22	27-22-1	AlexaAntiMouseAb~N/A	41348	44	41304
B27R02C01	27-1-2	PKCeta~N/A	1451	43	1408
B27R02C02	27-2-2	PKCeta~N/A	1719	45	1674
B27R02C03	27-3-2	Buffer	205	58	147
B27R02C04	27-4-2	Buffer	153	47	106
B27R02C05	27-5-2	HumanIgA~N/A	22327	46	22281
B27R02C06	27-6-2	HumanIgA~N/A	21928	43	21885
B27R02C07	27-7-2	Buffer	95	41	54
B27R02C08	27-8-2	Buffer	99	41	58
B27R02C09	27-9-2	BSA~N/A	12953	42	12911
B27R02C10	27-10-2	BSA~N/A	13537	42	13495
B27R02C11	27-11-2	Hs~MGC:BC000942.2~uORF:IOH2983	1147	45	1102
B27R02C12	27-12-2	Hs~MGC:BC000942.2~uORF:IOH2983	1104	46	1058
B27R02C13	27-13-2	Hs~Ref:NM_003251.1~uORF:IOH22149	377	45	332
B27R02C14	27-14-2	Hs~Ref:NM_003251.1~uORF:IOH22149	370	47	323
B27R02C15	27-15-2	Hs~MGC:BC030237.1~uORF:IOH21507	620	48	572
B27R02C16	27-16-2	Hs~MGC:BC030237.1~uORF:IOH21507	752	49	703
B27R02C17	27-17-2	Hs~MGC:NM_148179.1~uORF:IOH23094	523	48	475
B27R02C18	27-18-2	Hs~MGC:NM_148179.1~uORF:IOH23094	485	44	441
B27R02C19	27-19-2	Hs~MGC:BC031228.1~uORF:IOH21599	7893	45	7848
B27R02C20	27-20-2	Hs~MGC:BC031228.1~uORF:IOH21599	7477	46	7431
B27R02C21	27-21-2	Hs~MGC:BC032379.1~uORF:IOH21649	966	44	922
B27R02C22	27-22-2	Hs~MGC:BC032379.1~uORF:IOH21649	966	42	924
B27R03C01	27-1-3	Hs~Ref:NM_016102.1~uORF:IOH21790	731	47	684
B27R03C02	27-2-3	Hs~Ref:NM_016102.1~uORF:IOH21790	738	53	685
B27R03C03	27-3-3	Hs~Ref:NM_152318.1~uORF:IOH21631	721	58	663
B27R03C04	27-4-3	Hs~Ref:NM_152318.1~uORF:IOH21631	690	72	618
B27R03C05	27-5-3	Hs~Ref:NM_016009.2~uORF:IOH5827	308	195	113
B27R03C06	27-6-3	Hs~Ref:NM_016009.2~uORF:IOH5827	255	52	203
B27R03C07	27-7-3	Hs~MGC:BC005969.1~uORF:IOH7578	521	46	475
B27R03C08	27-8-3	Hs~MGC:BC005969.1~uORF:IOH7578	479	45	434
B27R03C09	27-9-3	Hs~Ref:NM_032403.1~uORF:IOH6540	1355	44	1311
B27R03C10	27-10-3	Hs~Ref:NM_032403.1~uORF:IOH6540	1325	46	1279
B27R03C11	27-11-3	Hs~Ref:NM_006360.1~uORF:IOH14618	395	53	342
B27R03C12	27-12-3	Hs~Ref:NM_006360.1~uORF:IOH14618	420	56	364
B27R03C13	27-13-3	Hs~Ref:NM_006038.1~uORF:IOH14383	1529	48	1481
B27R03C14	27-14-3	Hs~Ref:NM_006038.1~uORF:IOH14383	1495	45	1450
B27R03C15	27-15-3	Hs~MGC:BC047776.2~uORF:IOH26688	559	47	512
B27R03C16	27-16-3	Hs~MGC:BC047776.2~uORF:IOH26688	491	50	441
B27R03C17	27-17-3	Hs~Ref:NM_004236.1~uORF:IOH13834	546	49	497
B27R03C18	27-18-3	Hs~Ref:NM_004236.1~uORF:IOH13834	534	46	488
B27R03C19	27-19-3	Hs~MGC:BC046349.1~uORF:IOH26611	143	52	91
B27R03C20	27-20-3	Hs~MGC:BC046349.1~uORF:IOH26611	208	91	117
B27R03C21	27-21-3	Hs~Ref:NM_006333.1~uORF:IOH9978	661	46	615
B27R03C22	27-22-3	Hs~Ref:NM_006333.1~uORF:IOH9978	667	40	627
B27R04C01	27-1-4	Hs~Ref:NM_004649.1~uORF:IOH5054	361	59	302
B27R04C02	27-2-4	Hs~Ref:NM_004649.1~uORF:IOH5054	322	156	166
B27R04C03	27-3-4	Hs~MGC:BC005055.1~uORF:IOH6528	375	82	293
B27R04C04	27-4-4	Hs~MGC:BC005055.1~uORF:IOH6528	457	239	218
B27R04C05	27-5-4	Hs~MGC:BC007110.1~uORF:IOH7547	983	79	904
B27R04C06	27-6-4	Hs~MGC:BC007110.1~uORF:IOH7547	1045	55	990
B27R04C07	27-7-4	Hs~MGC:NM_016544.1~uORF:IOH22234	525	47	478
B27R04C08	27-8-4	Hs~MGC:NM_016544.1~uORF:IOH22234	477	47	430
B27R04C09	27-9-4	Hs~Ref:NM_024893.1~uORF:IOH22245	505	50	455
B27R04C10	27-10-4	Hs~Ref:NM_024893.1~uORF:IOH22245	471	48	423
B27R04C11	27-11-4	Hs~MGC:NM_152510.1~uORF:IOH22269	590	48	542
B27R04C12	27-12-4	Hs~MGC:NM_152510.1~uORF:IOH22269	609	47	562
B27R04C13	27-13-4	Hs~MGC:BC030602.2~uORF:IOH22288	394	49	345
B27R04C14	27-14-4	Hs~MGC:BC030602.2~uORF:IOH22288	393	54	339
B27R04C15	27-15-4	Hs~MGC:BC014336.1~uORF:IOH12611	468	44	424
B27R04C16	27-16-4	Hs~MGC:BC014336.1~uORF:IOH12611	488	45	443
B27R04C17	27-17-4	Hs~MGC:BC014260.2~uORF:IOH14850	505	50	455
B27R04C18	27-18-4	Hs~MGC:BC014260.2~uORF:IOH14850	421	48	373
B27R04C19	27-19-4	Hs~Ref:XM_499573.1~uORF:IOH22041	337	48	289
B27R04C20	27-20-4	Hs~Ref:XM_499573.1~uORF:IOH22041	320	45	275
B27R04C21	27-21-4	Hs~MGC:BC031964.1~uORF:IOH27669	1144	43	1101
B27R04C22	27-22-4	Hs~MGC:BC031964.1~uORF:IOH27669	1118	41	1077
B27R05C01	27-1-5	Hs~Ref:NM_000197.1~uORF:IOH21502	179	67	112
B27R05C02	27-2-5	Hs~Ref:NM_000197.1~uORF:IOH21502	247	65	182
B27R05C03	27-3-5	Hs~Ref:NM_006754.2~uORF:IOH39858	164	46	118
B27R05C04	27-4-5	Hs~Ref:NM_006754.2~uORF:IOH39858	306	115	191
B27R05C05	27-5-5	Hs~MGC:BC013918.1~uORF:IOH27878	341	216	125
B27R05C06	27-6-5	Hs~MGC:BC013918.1~uORF:IOH27878	198	129	69
B27R05C07	27-7-5	Hs~Ref:NM_001007098.1~uORF:IOH39860	125	47	78
B27R05C08	27-8-5	Hs~Ref:NM_001007098.1~uORF:IOH39860	212	82	130
B27R05C09	27-9-5	Hs~Ref:NM_032354.1~uORF:IOH6348	798	49	749
B27R05C10	27-10-5	Hs~Ref:NM_032354.1~uORF:IOH6348	726	48	678
B27R05C11	27-11-5	Hs~MGC:NM_174896.2~uORF:IOH23052	637	43	594
B27R05C12	27-12-5	Hs~MGC:NM_174896.2~uORF:IOH23052	642	43	599
B27R05C13	27-13-5	Hs~Ref:NM_032735.1~uORF:IOH6549	682	45	637
B27R05C14	27-14-5	Hs~Ref:NM_032735.1~uORF:IOH6549	655	44	611
B27R05C15	27-15-5	Hs~MGC:BC011554.1~uORF:IOH12718	1025	44	981
B27R05C16	27-16-5	Hs~MGC:BC011554.1~uORF:IOH12718	1020	44	976
B27R05C17	27-17-5	Hs~MGC:BC050401.1~uORF:IOH26650	6265	49	6216
B27R05C18	27-18-5	Hs~MGC:BC050401.1~uORF:IOH26650	6523	52	6471
B27R05C19	27-19-5	Hs~Ref:NM_005061.2~uORF:IOH26731	213	60	153
B27R05C20	27-20-5	Hs~Ref:NM_005061.2~uORF:IOH26731	301	146	155
B27R05C21	27-21-5	Hs~MGC:NM_173850.2~uORF:IOH26319	285	49	236
B27R05C22	27-22-5	Hs~MGC:NM_173850.2~uORF:IOH26319	239	47	192
B27R06C01	27-1-6	Hs~Ref:NM_033642.1~uORF:IOH36760	257	48	209
B27R06C02	27-2-6	Hs~Ref:NM_033642.1~uORF:IOH36760	95	76	19
B27R06C03	27-3-6	Hs~Ref:NM_004896.2~uORF:IOH10674	413	47	366
B27R06C04	27-4-6	Hs~Ref:NM_004896.2~uORF:IOH10674	349	46	303
B27R06C05	27-5-6	Hs~MGC:BC012094.1~uORF:IOH13126	283	49	234
B27R06C06	27-6-6	Hs~MGC:BC012094.1~uORF:IOH13126	313	50	263
B27R06C07	27-7-6	Hs~Ref:NM_019863.1~uORF:IOH10704	805	45	760
B27R06C08	27-8-6	Hs~Ref:NM_019863.1~uORF:IOH10704	806	45	761
B27R06C09	27-9-6	Hs~MGC:BC014602.2~uORF:IOH10869	426	47	379
B27R06C10	27-10-6	Hs~MGC:BC014602.2~uORF:IOH10869	391	45	346
B27R06C11	27-11-6	Hs~Ref:NM_014460.2~uORF:IOH39936	1237	45	1192
B27R06C12	27-12-6	Hs~Ref:NM_014460.2~uORF:IOH39936	1179	47	1132
B27R06C13	27-13-6	Hs~Ref:NM_172251.1~uORF:IOH39983	303	49	254
B27R06C14	27-14-6	Hs~Ref:NM_172251.1~uORF:IOH39983	303	50	253
B27R06C15	27-15-6	Hs~Ref:NM_178833.3~uORF:IOH40887	311	75	236
B27R06C16	27-16-6	Hs~Ref:NM_178833.3~uORF:IOH40887	259	59	200
B27R06C17	27-17-6	Hs~Ref:NM_006388.2~uORF:IOH39963	2296	71	2225
B27R06C18	27-18-6	Hs~Ref:NM_006388.2~uORF:IOH39963	1885	68	1817
B27R06C19	27-19-6	Hs~MGC:NM_177553.1~uORF:IOH27961	1119	49	1070
B27R06C20	27-20-6	Hs~MGC:NM_177553.1~uORF:IOH27961	1095	46	1049
B27R06C21	27-21-6	Hs~Ref:NM_007122.1~uORF:IOH27901	349	47	302
B27R06C22	27-22-6	Hs~Ref:NM_007122.1~uORF:IOH27901	373	48	325
B27R07C01	27-1-7	Hs~MGC:BC041626.1~uORF:IOH27997	805	47	758
B27R07C02	27-2-7	Hs~MGC:BC041626.1~uORF:IOH27997	703	54	649
B27R07C03	27-3-7	Hs~Ref:NM_001633.1~uORF:IOH28015	306	51	255
B27R07C04	27-4-7	Hs~Ref:NM_001633.1~uORF:IOH28015	296	48	248
B27R07C05	27-5-7	Hs~MGC:BC047471.1~uORF:IOH26529	402	93	309
B27R07C06	27-6-7	Hs~MGC:BC047471.1~uORF:IOH26529	205	53	152
B27R07C07	27-7-7	Hs~MGC:BC042101.1~uORF:IOH26308	133	54	79
B27R07C08	27-8-7	Hs~MGC:BC042101.1~uORF:IOH26308	605	58	547
B27R07C09	27-9-7	Hs~Ref:NM_002157.1~uORF:IOH27794	588	51	537
B27R07C10	27-10-7	Hs~Ref:NM_002157.1~uORF:IOH27794	580	49	531
B27R07C11	27-11-7	Hs~MGC:BC046129.1~uORF:IOH26911	592	56	536
B27R07C12	27-12-7	Hs~MGC:BC046129.1~uORF:IOH26911	545	58	487
B27R07C13	27-13-7	Hs~Ref:NM_002767.2~uORF:IOH42120	478	56	422
B27R07C14	27-14-7	Hs~Ref:NM_002767.2~uORF:IOH42120	474	53	421
B27R07C15	27-15-7	Hs~Ref:XM_379025.2~uORF:IOH44514	710	45	665
B27R07C16	27-16-7	Hs~Ref:XM_379025.2~uORF:IOH44514	688	46	642
B27R07C17	27-17-7	Hs~Ref:NM_001008737.1~uORF:IOH42047	8935	66	8869
B27R07C18	27-18-7	Hs~Ref:NM_001008737.1~uORF:IOH42047	8453	72	8381
B27R07C19	27-19-7	Hs~Ref:XM_376658.1~uORF:IOH44528	598	50	548
B27R07C20	27-20-7	Hs~Ref:XM_376658.1~uORF:IOH44528	535	47	488
B27R07C21	27-21-7	Hs~MGC:BC021263.1~uORF:IOH14642	733	46	687
B27R07C22	27-22-7	Hs~MGC:BC021263.1~uORF:IOH14642	708	43	665
B27R08C01	27-1-8	Hs~Ref:NM_016093.2~uORF:IOH14674	1631	45	1586
B27R08C02	27-2-8	Hs~Ref:NM_016093.2~uORF:IOH14674	1881	48	1833
B27R08C03	27-3-8	Hs~MGC:BC018736.1~uORF:IOH14106	1180	48	1132
B27R08C04	27-4-8	Hs~MGC:BC018736.1~uORF:IOH14106	1268	49	1219
B27R08C05	27-5-8	Hs~MGC:BC021551.1~uORF:IOH14682	694	52	642
B27R08C06	27-6-8	Hs~MGC:BC021551.1~uORF:IOH14682	652	55	597
B27R08C07	27-7-8	Hs~Ref:NM_054033.1~uORF:IOH4141	842	59	783
B27R08C08	27-8-8	Hs~Ref:NM_054033.1~uORF:IOH4141	996	58	938
B27R08C09	27-9-8	Hs~Ref:NM_006790.1~uORF:IOH7249	5840	49	5791
B27R08C10	27-10-8	Hs~Ref:NM_006790.1~uORF:IOH7249	5870	48	5822
B27R08C11	27-11-8	Hs~Ref:NM_145109.1~uORF:IOH21715	820	62	758
B27R08C12	27-12-8	Hs~Ref:NM_145109.1~uORF:IOH21715	443	84	359
B27R08C13	27-13-8	Hs~Ref:NM_014305.1~uORF:IOH21821	574	124	450
B27R08C14	27-14-8	Hs~Ref:NM_014305.1~uORF:IOH21821	266	61	205
B27R08C15	27-15-8	Hs~Ref:NM_018090.2~uORF:IOH14317	978	45	933
B27R08C16	27-16-8	Hs~Ref:NM_018090.2~uORF:IOH14317	971	44	927
B27R08C17	27-17-8	Hs~Ref:NM_003732.1~uORF:IOH14774	619	49	570
B27R08C18	27-18-8	Hs~Ref:NM_003732.1~uORF:IOH14774	347	61	286
B27R08C19	27-19-8	Hs~MGC:BC033856.1~uORF:IOH21797	23505	53	23452
B27R08C20	27-20-8	Hs~MGC:BC033856.1~uORF:IOH21797	23253	48	23205
B27R08C21	27-21-8	Hs~Ref:NM_007080.1~uORF:IOH10074	515	45	470
B27R08C22	27-22-8	Hs~Ref:NM_007080.1~uORF:IOH10074	465	43	422
B27R09C01	27-1-9	Hs~MGC:BC059363.1~uORF:IOH29178	465	46	419
B27R09C02	27-2-9	Hs~MGC:BC059363.1~uORF:IOH29178	525	53	472
B27R09C03	27-3-9	Hs~Ref:NM_145208.1~uORF:IOH35247	832	46	786
B27R09C04	27-4-9	Hs~Ref:NM_145208.1~uORF:IOH35247	860	44	816
B27R09C05	27-5-9	Hs~Ref:NM_171830.1~uORF:IOH35405	605	47	558
B27R09C06	27-6-9	Hs~Ref:NM_171830.1~uORF:IOH35405	611	50	561
B27R09C07	27-7-9	Hs~Ref:NM_173859.1~uORF:IOH35196	57	60	-3
B27R09C08	27-8-9	Hs~Ref:NM_173859.1~uORF:IOH35196	426	51	375
B27R09C09	27-9-9	Hs~Ref:NM_004542.1~uORF:IOH14726	237	47	190
B27R09C10	27-10-9	Hs~Ref:NM_004542.1~uORF:IOH14726	222	64	158
B27R09C11	27-11-9	Hs~Ref:NM_144971.1~uORF:IOH10719	277	51	226
B27R09C12	27-12-9	Hs~Ref:NM_144971.1~uORF:IOH10719	305	95	210
B27R09C13	27-13-9	Hs~MGC:BC016341.1~uORF:IOH13791	201	76	125
B27R09C14	27-14-9	Hs~MGC:BC016341.1~uORF:IOH13791	294	140	154
B27R09C15	27-15-9	Hs~MGC:BC005249.1~uORF:IOH7355	356	48	308
B27R09C16	27-16-9	Hs~MGC:BC005249.1~uORF:IOH7355	369	48	321
B27R09C17	27-17-9	Hs~Ref:NM_003357.2~uORF:IOH5625	2022	74	1948
B27R09C18	27-18-9	Hs~Ref:NM_003357.2~uORF:IOH5625	2397	272	2125
B27R09C19	27-19-9	Hs~MGC:BC003545.1~uORF:IOH5488	2363	81	2282
B27R09C20	27-20-9	Hs~MGC:BC003545.1~uORF:IOH5488	183	49	134
B27R09C21	27-21-9	Hs~Ref:NM_024112.1~uORF:IOH5161	220	63	157
B27R09C22	27-22-9	Hs~Ref:NM_024112.1~uORF:IOH5161	236	77	159
B27R10C01	27-1-10	Hs~MGC:BC002804.1~uORF:IOH5414	226	50	176
B27R10C02	27-2-10	Hs~MGC:BC002804.1~uORF:IOH5414	6144	60	6084
B27R10C03	27-3-10	Hs~Ref:NM_006476.4~uORF:IOH53833	726	45	681
B27R10C04	27-4-10	Hs~Ref:NM_006476.4~uORF:IOH53833	716	45	671
B27R10C05	27-5-10	Hs~MGC:BC009416.1~uORF:IOH46085	576	48	528
B27R10C06	27-6-10	Hs~MGC:BC009416.1~uORF:IOH46085	585	49	536
B27R10C07	27-7-10	Hs~Ref:NM_021945.4~uORF:IOH57770	241	53	188
B27R10C08	27-8-10	Hs~Ref:NM_021945.4~uORF:IOH57770	57	62	-5
B27R10C09	27-9-10	Hs~MGC:NM_152329.3~uORF:IOH57797	833	163	670
B27R10C10	27-10-10	Hs~MGC:NM_152329.3~uORF:IOH57797	947	71	876
B27R10C11	27-11-10	GST1	46	44	2
B27R10C12	27-12-10	GST1	49	46	3
B27R10C13	27-13-10	GST2	384	46	338
B27R10C14	27-14-10	GST2	50	45	5
B27R10C15	27-15-10	GST3	56	47	9
B27R10C16	27-16-10	GST3	132	53	79
B27R10C17	27-17-10	GST4	167	51	116
B27R10C18	27-18-10	GST4	2173	135	2038
B27R10C19	27-19-10	Anti-HumanIgA1~N/A	9860	104	9756
B27R10C20	27-20-10	Anti-HumanIgA1~N/A	8809	53	8756
B27R10C21	27-21-10	Anti-HumanIgA2~N/A	15965	54	15911
B27R10C22	27-22-10	Anti-HumanIgA2~N/A	19363	53	19310
B27R11C01	27-1-11	AlexaAntiMouseAb~N/A	24745	47	24698
B27R11C02	27-2-11	AlexaAntiMouseAb~N/A	24970	47	24923
B27R11C03	27-3-11	MAPKAP~N/A	104	49	55
B27R11C04	27-4-11	MAPKAP~N/A	105	48	57
B27R11C05	27-5-11	Buffer	129	44	85
B27R11C06	27-6-11	Buffer	109	45	64
B27R11C07	27-7-11	BSA~N/A	10221	48	10173
B27R11C08	27-8-11	BSA~N/A	10099	51	10048
B27R11C09	27-9-11	Anti-HumanIgG1~N/A	1502	49	1453
B27R11C10	27-10-11	Anti-HumanIgG1~N/A	1692	46	1646
B27R11C11	27-11-11	Anti-HumanIgG2~N/A	2841	46	2795
B27R11C12	27-12-11	Anti-HumanIgG2~N/A	3382	50	3332
B27R11C13	27-13-11	Anti-HumanIgG3~N/A	4941	49	4892
B27R11C14	27-14-11	Anti-HumanIgG3~N/A	5583	49	5534
B27R11C15	27-15-11	Anti-HumanIgG4~N/A	10600	49	10551
B27R11C16	27-16-11	Anti-HumanIgG4~N/A	10988	48	10940
B27R11C17	27-17-11	AntiBiotinAb~N/A	12687	49	12638
B27R11C18	27-18-11	AntiBiotinAb~N/A	12982	56	12926
B27R11C19	27-19-11	Buffer	152	114	38
B27R11C20	27-20-11	Buffer	81	63	18
B27R11C21	27-21-11	Hs~MGC:BC009294.1~uORF:IOH14145	884	50	834
B27R11C22	27-22-11	Hs~MGC:BC009294.1~uORF:IOH14145	846	59	787
B27R12C01	27-1-12	Hs~Ref:NM_000365.2~uORF:IOH7523	547	137	410
B27R12C02	27-2-12	Hs~Ref:NM_000365.2~uORF:IOH7523	610	51	559
B27R12C03	27-3-12	Hs~MGC:BC003129.1~uORF:IOH5111	2564	48	2516
B27R12C04	27-4-12	Hs~MGC:BC003129.1~uORF:IOH5111	2594	48	2546
B27R12C05	27-5-12	Hs~Ref:NM_031268.3~uORF:IOH27406	636	50	586
B27R12C06	27-6-12	Hs~Ref:NM_031268.3~uORF:IOH27406	676	53	623
B27R12C07	27-7-12	Hs~MGC:BC082990.1~uORF:IOH62547	78	56	22
B27R12C08	27-8-12	Hs~MGC:BC082990.1~uORF:IOH62547	44	70	-26
B27R12C09	27-9-12	Hs~MGC:BC065937.1~uORF:IOH61587	110	51	59
B27R12C10	27-10-12	Hs~MGC:BC065937.1~uORF:IOH61587	92	48	44
B27R12C11	27-11-12	Hs~MGC:BC068458.1~uORF:IOH61629	623	248	375
B27R12C12	27-12-12	Hs~MGC:BC068458.1~uORF:IOH61629	565	188	377
B27R12C13	27-13-12	Hs~Ref:BC065826.1~uORF:IOH62458	104	70	34
B27R12C14	27-14-12	Hs~Ref:BC065826.1~uORF:IOH62458	1125	66	1059
B27R12C15	27-15-12	Hs~MGC:BC009739.1~uORF:IOH14525	100	50	50
B27R12C16	27-16-12	Hs~MGC:BC009739.1~uORF:IOH14525	97	50	47
B27R12C17	27-17-12	Hs~Ref:NM_003168.1~uORF:IOH5411	189	152	37
B27R12C18	27-18-12	Hs~Ref:NM_003168.1~uORF:IOH5411	173	53	120
B27R12C19	27-19-12	Hs~MGC:NM_012478.2~uORF:IOH6080	485	131	354
B27R12C20	27-20-12	Hs~MGC:NM_012478.2~uORF:IOH6080	462	116	346
B27R12C21	27-21-12	Hs~Ref:NM_014673.2~uORF:IOH13932	247	52	195
B27R12C22	27-22-12	Hs~Ref:NM_014673.2~uORF:IOH13932	141	49	92
B27R13C01	27-1-13	Hs~Ref:NM_000359.1~uORF:IOH22155	931	51	880
B27R13C02	27-2-13	Hs~Ref:NM_000359.1~uORF:IOH22155	790	57	733
B27R13C03	27-3-13	Hs~Ref:NM_007107.2~uORF:IOH13133	337	51	286
B27R13C04	27-4-13	Hs~Ref:NM_007107.2~uORF:IOH13133	417	51	366
B27R13C05	27-5-13	Hs~MGC:BC002670.2~uORF:IOH5294	505	94	411
B27R13C06	27-6-13	Hs~MGC:BC002670.2~uORF:IOH5294	465	58	407
B27R13C07	27-7-13	Hs~MGC:BC012379.2~uORF:IOH10443	52	75	-23
B27R13C08	27-8-13	Hs~MGC:BC012379.2~uORF:IOH10443	39	62	-23
B27R13C09	27-9-13	Hs~Ref:NM_001005210.1~uORF:IOH37495	68	85	-17
B27R13C10	27-10-13	Hs~Ref:NM_001005210.1~uORF:IOH37495	367	279	88
B27R13C11	27-11-13	Hs~Ref:NM_001010899.1~uORF:IOH57359	2466	64	2402
B27R13C12	27-12-13	Hs~Ref:NM_001010899.1~uORF:IOH57359	2417	57	2360
B27R13C13	27-13-13	Hs~MGC:BC031637.1~uORF:IOH22785	12818	59	12759
B27R13C14	27-14-13	Hs~MGC:BC031637.1~uORF:IOH22785	12703	62	12641
B27R13C15	27-15-13	Hs~Ref:NM_006571.2~uORF:IOH21488	705	60	645
B27R13C16	27-16-13	Hs~Ref:NM_006571.2~uORF:IOH21488	616	62	554
B27R13C17	27-17-13	Hs~MGC:BC015742.1~uORF:IOH12050	914	69	845
B27R13C18	27-18-13	Hs~MGC:BC015742.1~uORF:IOH12050	633	450	183
B27R13C19	27-19-13	Hs~MGC:BC020885.1~uORF:IOH14357	561	71	490
B27R13C20	27-20-13	Hs~MGC:BC020885.1~uORF:IOH14357	618	142	476
B27R13C21	27-21-13	Hs~Ref:NM_014392.1~uORF:IOH4792	530	84	446
B27R13C22	27-22-13	Hs~Ref:NM_014392.1~uORF:IOH4792	375	49	326
B27R14C01	27-1-14	Hs~Ref:NM_001697.1~uORF:IOH13236	441	49	392
B27R14C02	27-2-14	Hs~Ref:NM_001697.1~uORF:IOH13236	350	59	291
B27R14C03	27-3-14	Hs~MGC:BC032663.1~uORF:IOH21987	216	50	166
B27R14C04	27-4-14	Hs~MGC:BC032663.1~uORF:IOH21987	454	62	392
B27R14C05	27-5-14	Hs~MGC:BC040844.1~uORF:IOH26310	730	50	680
B27R14C06	27-6-14	Hs~MGC:BC040844.1~uORF:IOH26310	739	45	694
B27R14C07	27-7-14	Hs~Ref:NM_144685.3~uORF:IOH22267	308	45	263
B27R14C08	27-8-14	Hs~Ref:NM_144685.3~uORF:IOH22267	283	48	235
B27R14C09	27-9-14	Hs~Ref:NM_173571.1~uORF:IOH22557	501	368	133
B27R14C10	27-10-14	Hs~Ref:NM_173571.1~uORF:IOH22557	513	342	171
B27R14C11	27-11-14	Hs~MGC:BC031300.1~uORF:IOH23207	928	419	509
B27R14C12	27-12-14	Hs~MGC:BC031300.1~uORF:IOH23207	55	77	-22
B27R14C13	27-13-14	Hs~MGC:BC033872.1~uORF:IOH21882	628	353	275
B27R14C14	27-14-14	Hs~MGC:BC033872.1~uORF:IOH21882	451	356	95
B27R14C15	27-15-14	Hs~Ref:NM_176869.1~uORF:IOH42167	637	255	382
B27R14C16	27-16-14	Hs~Ref:NM_176869.1~uORF:IOH42167	463	70	393
B27R14C17	27-17-14	Hs~Ref:NM_004231.2~uORF:IOH42330	480	48	432
B27R14C18	27-18-14	Hs~Ref:NM_004231.2~uORF:IOH42330	488	58	430
B27R14C19	27-19-14	Hs~Ref:NM_012179.2~uORF:IOH7010	469	58	411
B27R14C20	27-20-14	Hs~Ref:NM_012179.2~uORF:IOH7010	488	60	428
B27R14C21	27-21-14	Hs~Ref:NM_172236.1~uORF:IOH4155	567	89	478
B27R14C22	27-22-14	Hs~Ref:NM_172236.1~uORF:IOH4155	357	92	265
B27R15C01	27-1-15	Hs~Ref:NM_173561.1~uORF:IOH27333	310	46	264
B27R15C02	27-2-15	Hs~Ref:NM_173561.1~uORF:IOH27333	461	77	384
B27R15C03	27-3-15	Hs~MGC:BC052303.1~uORF:IOH28113	619	63	556
B27R15C04	27-4-15	Hs~MGC:BC052303.1~uORF:IOH28113	560	52	508
B27R15C05	27-5-15	Hs~Ref:NM_003384.1~uORF:IOH41408	682	44	638
B27R15C06	27-6-15	Hs~Ref:NM_003384.1~uORF:IOH41408	680	42	638
B27R15C07	27-7-15	Hs~Ref:NM_198450.1~uORF:IOH42967	516	45	471
B27R15C08	27-8-15	Hs~Ref:NM_198450.1~uORF:IOH42967	563	45	518
B27R15C09	27-9-15	Hs~Ref:NM_213566.1~uORF:IOH41232	166	50	116
B27R15C10	27-10-15	Hs~Ref:NM_213566.1~uORF:IOH41232	155	50	105
B27R15C11	27-11-15	Hs~Ref:NM_182684.1~uORF:IOH44464	456	122	334
B27R15C12	27-12-15	Hs~Ref:NM_182684.1~uORF:IOH44464	552	141	411
B27R15C13	27-13-15	Hs~Ref:NM_002753.2~CAT:PV4563	1120	43	1077
B27R15C14	27-14-15	Hs~Ref:NM_002753.2~CAT:PV4563	1088	42	1046
B27R15C15	27-15-15	Hs~Ref:NM_080823.2~CAT:PV4214	268	95	173
B27R15C16	27-16-15	Hs~Ref:NM_080823.2~CAT:PV4214	224	44	180
B27R15C17	27-17-15	Hs~Ref:NM_001786.2~CAT:PV3292	453	43	410
B27R15C18	27-18-15	Hs~Ref:NM_001786.2~CAT:PV3292	449	43	406
B27R15C19	27-19-15	Hs~Ref:NM_018492.2~CAT:PV4130	335	189	146
B27R15C20	27-20-15	Hs~Ref:NM_018492.2~CAT:PV4130	198	45	153
B27R15C21	27-21-15	Hs~Ref:NM_005813.2~CAT:PV3692	718	69	649
B27R15C22	27-22-15	Hs~Ref:NM_005813.2~CAT:PV3692	419	54	365
B27R16C01	27-1-16	Hs~Ref:NM_004444.2~CAT:PV3251	138	42	96
B27R16C02	27-2-16	Hs~Ref:NM_004444.2~CAT:PV3251	125	45	80
B27R16C03	27-3-16	Hs~Ref:NM_005122.1~CAT:PV4838	258	64	194
B27R16C04	27-4-16	Hs~Ref:NM_005122.1~CAT:PV4838	186	48	138
B27R16C05	27-5-16	Hs~Ref:NM_002647.1~CAT:PV5126	229	43	186
B27R16C06	27-6-16	Hs~Ref:NM_002647.1~CAT:PV5126	190	56	134
B27R16C07	27-7-16	Hs~MGC:BC053557.1~uORF:IOH29019	115	55	60
B27R16C08	27-8-16	Hs~MGC:BC053557.1~uORF:IOH29019	232	45	187
B27R16C09	27-9-16	Hs~MGC:BC057837.1~uORF:IOH29210	328	47	281
B27R16C10	27-10-16	Hs~MGC:BC057837.1~uORF:IOH29210	300	51	249
B27R16C11	27-11-16	Hs~Ref:NM_007194.2~uORF:IOH21145	330	46	284
B27R16C12	27-12-16	Hs~Ref:NM_007194.2~uORF:IOH21145	364	73	291
B27R16C13	27-13-16	Hs~MGC:NM_199334.2~uORF:IOH6734	358	43	315
B27R16C14	27-14-16	Hs~MGC:NM_199334.2~uORF:IOH6734	456	46	410
B27R16C15	27-15-16	Hs~MGC:BC032382.1~uORF:IOH21661	1601	48	1553
B27R16C16	27-16-16	Hs~MGC:BC032382.1~uORF:IOH21661	1648	48	1600
B27R16C17	27-17-16	Hs~Ref:NM_002939.3~uORF:IOH25734	418	47	371
B27R16C18	27-18-16	Hs~Ref:NM_002939.3~uORF:IOH25734	407	44	363
B27R16C19	27-19-16	Hs~Ref:NM_144675.1~uORF:IOH11144	330	44	286
B27R16C20	27-20-16	Hs~Ref:NM_144675.1~uORF:IOH11144	339	45	294
B27R16C21	27-21-16	Hs~Ref:NM_002102.2~uORF:IOH57347	601	68	533
B27R16C22	27-22-16	Hs~Ref:NM_002102.2~uORF:IOH57347	675	101	574
B27R17C01	27-1-17	Hs~MGC:BC015600.1~uORF:IOH12286	324	51	273
B27R17C02	27-2-17	Hs~MGC:BC015600.1~uORF:IOH12286	236	45	191
B27R17C03	27-3-17	Hs~MGC:BC012499.1~uORF:IOH11855	747	45	702
B27R17C04	27-4-17	Hs~MGC:BC012499.1~uORF:IOH11855	719	42	677
B27R17C05	27-5-17	Hs~MGC:BC042482.1~uORF:IOH27444	587	41	546
B27R17C06	27-6-17	Hs~MGC:BC042482.1~uORF:IOH27444	624	42	582
B27R17C07	27-7-17	Hs~Ref:NM_017903.2~uORF:IOH25956	547	43	504
B27R17C08	27-8-17	Hs~Ref:NM_017903.2~uORF:IOH25956	466	43	423
B27R17C09	27-9-17	Hs~Ref:NM_016466.4~uORF:IOH22083	322	50	272
B27R17C10	27-10-17	Hs~Ref:NM_016466.4~uORF:IOH22083	405	196	209
B27R17C11	27-11-17	Hs~Ref:NM_153364.1~uORF:IOH27498	619	51	568
B27R17C12	27-12-17	Hs~Ref:NM_153364.1~uORF:IOH27498	601	45	556
B27R17C13	27-13-17	Hs~MGC:BC007519.2~uORF:IOH6177	527	44	483
B27R17C14	27-14-17	Hs~MGC:BC007519.2~uORF:IOH6177	566	44	522
B27R17C15	27-15-17	Hs~MGC:BC033777.2~uORF:IOH21769	10238	56	10182
B27R17C16	27-16-17	Hs~MGC:BC033777.2~uORF:IOH21769	10206	60	10146
B27R17C17	27-17-17	Hs~Ref:NM_053045.1~uORF:IOH14287	207	43	164
B27R17C18	27-18-17	Hs~Ref:NM_053045.1~uORF:IOH14287	249	56	193
B27R17C19	27-19-17	Hs~Ref:NM_003447.1~uORF:IOH11880	426	47	379
B27R17C20	27-20-17	Hs~Ref:NM_003447.1~uORF:IOH11880	459	46	413
B27R17C21	27-21-17	Hs~MGC:BC010904.1~uORF:IOH12069	533	59	474
B27R17C22	27-22-17	Hs~MGC:BC010904.1~uORF:IOH12069	524	118	406
B27R18C01	27-1-18	Hs~MGC:BC022520.1~uORF:IOH10749	863	47	816
B27R18C02	27-2-18	Hs~MGC:BC022520.1~uORF:IOH10749	755	45	710
B27R18C03	27-3-18	Hs~Ref:NM_031417.1~N/A	517	48	469
B27R18C04	27-4-18	Hs~Ref:NM_031417.1~N/A	538	45	493
B27R18C05	27-5-18	Hs~Ref:NM_020648.3~uORF:IOH10689	473	53	420
B27R18C06	27-6-18	Hs~Ref:NM_020648.3~uORF:IOH10689	461	316	145
B27R18C07	27-7-18	Hs~Ref:NM_013237.1~uORF:IOH4636	530	47	483
B27R18C08	27-8-18	Hs~Ref:NM_013237.1~uORF:IOH4636	472	47	425
B27R18C09	27-9-18	Hs~MGC:BC057787.1~uORF:IOH29198	516	46	470
B27R18C10	27-10-18	Hs~MGC:BC057787.1~uORF:IOH29198	511	47	464
B27R18C11	27-11-18	Hs~Ref:NM_018108.2~uORF:IOH10013	445	288	157
B27R18C12	27-12-18	Hs~Ref:NM_018108.2~uORF:IOH10013	280	54	226
B27R18C13	27-13-18	Hs~Ref:NM_138773.1~uORF:IOH10147	444	47	397
B27R18C14	27-14-18	Hs~Ref:NM_138773.1~uORF:IOH10147	557	76	481
B27R18C15	27-15-18	Hs~MGC:BC025406.1~uORF:IOH11226	1350	64	1286
B27R18C16	27-16-18	Hs~MGC:BC025406.1~uORF:IOH11226	1327	157	1170
B27R18C17	27-17-18	Hs~Ref:NM_152285.1~uORF:IOH21698	854	76	778
B27R18C18	27-18-18	Hs~Ref:NM_152285.1~uORF:IOH21698	750	56	694
B27R18C19	27-19-18	Hs~MGC:BC065266.1~uORF:IOH40484	483	47	436
B27R18C20	27-20-18	Hs~MGC:BC065266.1~uORF:IOH40484	548	50	498
B27R18C21	27-21-18	Hs~MGC:BC009388.1~uORF:IOH29324	168	57	111
B27R18C22	27-22-18	Hs~MGC:BC009388.1~uORF:IOH29324	190	94	96
B27R19C01	27-1-19	Hs~Ref:NM_014266.3~uORF:IOH29342	529	49	480
B27R19C02	27-2-19	Hs~Ref:NM_014266.3~uORF:IOH29342	468	45	423
B27R19C03	27-3-19	Hs~MGC:BC064840.1~uORF:IOH40500	5410	45	5365
B27R19C04	27-4-19	Hs~MGC:BC064840.1~uORF:IOH40500	5378	45	5333
B27R19C05	27-5-19	Hs~Ref:NM_014836.3~uORF:IOH27118	2109	44	2065
B27R19C06	27-6-19	Hs~Ref:NM_014836.3~uORF:IOH27118	2139	46	2093
B27R19C07	27-7-19	Hs~Ref:NM_032318.1~uORF:IOH6525	412	52	360
B27R19C08	27-8-19	Hs~Ref:NM_032318.1~uORF:IOH6525	389	48	341
B27R19C09	27-9-19	Hs~MGC:BC009197.2~uORF:IOH27820	461	47	414
B27R19C10	27-10-19	Hs~MGC:BC009197.2~uORF:IOH27820	468	46	422
B27R19C11	27-11-19	Hs~MGC:BC058027.1~uORF:IOH29431	575	46	529
B27R19C12	27-12-19	Hs~MGC:BC058027.1~uORF:IOH29431	546	44	502
B27R19C13	27-13-19	Hs~MGC:NM_174892.1~uORF:IOH11440	346	166	180
B27R19C14	27-14-19	Hs~MGC:NM_174892.1~uORF:IOH11440	387	98	289
B27R19C15	27-15-19	Hs~MGC:BC017936.1~uORF:IOH13624	306	50	256
B27R19C16	27-16-19	Hs~MGC:BC017936.1~uORF:IOH13624	507	71	436
B27R19C17	27-17-19	Hs~MGC:BC019358.1~uORF:IOH14809	423	59	364
B27R19C18	27-18-19	Hs~MGC:BC019358.1~uORF:IOH14809	458	48	410
B27R19C19	27-19-19	Hs~MGC:BC050563.1~uORF:IOH26951	623	43	580
B27R19C20	27-20-19	Hs~MGC:BC050563.1~uORF:IOH26951	683	44	639
B27R19C21	27-21-19	Hs~MGC:NM_178523.2~uORF:IOH21749	367	48	319
B27R19C22	27-22-19	Hs~MGC:NM_178523.2~uORF:IOH21749	177	46	131
B27R20C01	27-1-20	Hs~Ref:NM_052837.1~uORF:IOH10289	359	152	207
B27R20C02	27-2-20	Hs~Ref:NM_052837.1~uORF:IOH10289	369	105	264
B27R20C03	27-3-20	Hs~MGC:BC022465.1~uORF:IOH11206	108	44	64
B27R20C04	27-4-20	Hs~MGC:BC022465.1~uORF:IOH11206	94	55	39
B27R20C05	27-5-20	Hs~MGC:BC015350.1~uORF:IOH10316	136	42	94
B27R20C06	27-6-20	Hs~MGC:BC015350.1~uORF:IOH10316	146	50	96
B27R20C07	27-7-20	Hs~Ref:NM_001786.2~N/A	153	45	108
B27R20C08	27-8-20	Hs~Ref:NM_001786.2~N/A	287	99	188
B27R20C09	27-9-20	Hs~MGC:BC001662.1~N/A	480	43	437
B27R20C10	27-10-20	Hs~MGC:BC001662.1~N/A	517	43	474
B27R20C11	27-11-20	Hs~MGC:BC007852.1~N/A	495	42	453
B27R20C12	27-12-20	Hs~MGC:BC007852.1~N/A	487	43	444
B27R20C13	27-13-20	Hs~Ref:NM_052849.2~uORF:IOH45899	269	191	78
B27R20C14	27-14-20	Hs~Ref:NM_052849.2~uORF:IOH45899	300	53	247
B27R20C15	27-15-20	Hs~Ref:NM_139352.1~uORF:IOH45505	313	44	269
B27R20C16	27-16-20	Hs~Ref:NM_139352.1~uORF:IOH45505	311	87	224
B27R20C17	27-17-20	Hs~Ref:NM_175052.1~uORF:IOH45486	311	47	264
B27R20C18	27-18-20	Hs~Ref:NM_175052.1~uORF:IOH45486	314	50	264
B27R20C19	27-19-20	Hs~Ref:NM_012173.3~uORF:IOH45912	469	42	427
B27R20C20	27-20-20	Hs~Ref:NM_012173.3~uORF:IOH45912	547	43	504
B27R20C21	27-21-20	Hs~Ref:NM_006053.2~uORF:IOH45518	257	60	197
B27R20C22	27-22-20	Hs~Ref:NM_006053.2~uORF:IOH45518	97	41	56
B27R21C01	27-1-21	Hs~Ref:NM_173847.2~uORF:IOH42995	337	85	252
B27R21C02	27-2-21	Hs~Ref:NM_173847.2~uORF:IOH42995	247	129	118
B27R21C03	27-3-21	Hs~Ref:NM_001080404.2~uORF:IOH43637	352	74	278
B27R21C04	27-4-21	Hs~Ref:NM_001080404.2~uORF:IOH43637	174	43	131
B27R21C05	27-5-21	Hs~Ref:NM_001026.3~uORF:IOH42145	332	42	290
B27R21C06	27-6-21	Hs~Ref:NM_001026.3~uORF:IOH42145	365	48	317
B27R21C07	27-7-21	Hs~Ref:NM_005329.2~uORF:IOH43733	448	42	406
B27R21C08	27-8-21	Hs~Ref:NM_005329.2~uORF:IOH43733	390	41	349
B27R21C09	27-9-21	Hs~Ref:NP_002505.1~CAT_10264-H08B-25	39	38	1
B27R21C10	27-10-21	Hs~Ref:NP_002505.1~CAT_10264-H08B-25	37	38	-1
B27R21C11	27-11-21	Internal_1007209	53	39	14
B27R21C12	27-12-21	Internal_1007209	50	39	11
B27R21C13	27-13-21	Hs~Ref:NP_005009.2~CAT_10377-H08H-25	46	39	7
B27R21C14	27-14-21	Hs~Ref:NP_005009.2~CAT_10377-H08H-25	43	39	4
B27R21C15	27-15-21	Internal_1007209	53	37	16
B27R21C16	27-16-21	Internal_1007209	50	38	12
B27R21C17	27-17-21	Hs~Ref:NP_006496.3~CAT_10109-H08H-25	38	38	0
B27R21C18	27-18-21	Hs~Ref:NP_006496.3~CAT_10109-H08H-25	38	38	0
B27R21C19	27-19-21	Internal_1007209	49	38	11
B27R21C20	27-20-21	Internal_1007209	47	38	9
B27R21C21	27-21-21	Hs~Ref:NP_001450.2~CAT_PHC9415	487	39	448
B27R21C22	27-22-21	Hs~Ref:NP_001450.2~CAT_PHC9415	491	39	452
B27R22C01	27-1-22	ERa~N/A	2295	38	2257
B27R22C02	27-2-22	ERa~N/A	2602	39	2563
B27R22C03	27-3-22	PKCeta~N/A	330	41	289
B27R22C04	27-4-22	PKCeta~N/A	302	41	261
B27R22C05	27-5-22	Calmodulin~N/A	138	40	98
B27R22C06	27-6-22	Calmodulin~N/A	67	39	28
B27R22C07	27-7-22	V5control5~N/A	336	39	297
B27R22C08	27-8-22	V5control5~N/A	363	40	323
B27R22C09	27-9-22	V5control4~N/A	214	48	166
B27R22C10	27-10-22	V5control4~N/A	159	42	117
B27R22C11	27-11-22	V5control3~N/A	127	58	69
B27R22C12	27-12-22	V5control3~N/A	78	40	38
B27R22C13	27-13-22	V5control2~N/A	56	38	18
B27R22C14	27-14-22	V5control2~N/A	45	40	5
B27R22C15	27-15-22	V5control1~N/A	95	42	53
B27R22C16	27-16-22	V5control1~N/A	38	44	-6
B27R22C17	27-17-22	CMK2A~N/A	501	39	462
B27R22C18	27-18-22	CMK2A~N/A	568	38	530
B27R22C19	27-19-22	ERa~N/A	1930	38	1892
B27R22C20	27-20-22	ERa~N/A	1960	39	1921
B27R22C21	27-21-22	AlexaAntiMouseAb~N/A	9844	40	9804
B27R22C22	27-22-22	AlexaAntiMouseAb~N/A	9419	40	9379
B28R01C01	28-1-1	AlexaAntiMouseAb~N/A	33063	42	33021
B28R01C02	28-2-1	AlexaAntiMouseAb~N/A	35644	41	35603
B28R01C03	28-3-1	ERa~N/A	1888	40	1848
B28R01C04	28-4-1	ERa~N/A	1812	40	1772
B28R01C05	28-5-1	HumanIgG1~N/A	897	40	857
B28R01C06	28-6-1	HumanIgG1~N/A	1261	39	1222
B28R01C07	28-7-1	HumanIgG2~N/A	2320	39	2281
B28R01C08	28-8-1	HumanIgG2~N/A	3084	40	3044
B28R01C09	28-9-1	HumanIgG3~N/A	12075	40	12035
B28R01C10	28-10-1	HumanIgG3~N/A	15063	42	15021
B28R01C11	28-11-1	HumanIgG4~N/A	41302	43	41259
B28R01C12	28-12-1	HumanIgG4~N/A	49283	44	49239
B28R01C13	28-13-1	BiotinAb~N/A	285	43	242
B28R01C14	28-14-1	BiotinAb~N/A	294	43	251
B28R01C15	28-15-1	RanBP2deltaFG~N/A	365	44	321
B28R01C16	28-16-1	RanBP2deltaFG~N/A	290	44	246
B28R01C17	28-17-1	hMDM2~N/A	1071	571	500
B28R01C18	28-18-1	hMDM2~N/A	94	52	42
B28R01C19	28-19-1	PKCeta~N/A	426	193	233
B28R01C20	28-20-1	PKCeta~N/A	314	81	233
B28R01C21	28-21-1	AlexaAntiMouseAb~N/A	26821	46	26775
B28R01C22	28-22-1	AlexaAntiMouseAb~N/A	27261	43	27218
B28R02C01	28-1-2	PKCeta~N/A	1331	40	1291
B28R02C02	28-2-2	PKCeta~N/A	1659	41	1618
B28R02C03	28-3-2	Buffer	223	44	179
B28R02C04	28-4-2	Buffer	188	41	147
B28R02C05	28-5-2	HumanIgA~N/A	18212	42	18170
B28R02C06	28-6-2	HumanIgA~N/A	17788	41	17747
B28R02C07	28-7-2	Buffer	81	40	41
B28R02C08	28-8-2	Buffer	189	64	125
B28R02C09	28-9-2	BSA~N/A	11188	45	11143
B28R02C10	28-10-2	BSA~N/A	12052	48	12004
B28R02C11	28-11-2	Hs~MGC:NM_173605.1~uORF:IOH21690	1119	46	1073
B28R02C12	28-12-2	Hs~MGC:NM_173605.1~uORF:IOH21690	1116	43	1073
B28R02C13	28-13-2	Hs~MGC:NM_152732.2~uORF:IOH22555	1217	45	1172
B28R02C14	28-14-2	Hs~MGC:NM_152732.2~uORF:IOH22555	1195	46	1149
B28R02C15	28-15-2	Hs~Ref:NM_032596.3~uORF:IOH11191	1318	46	1272
B28R02C16	28-16-2	Hs~Ref:NM_032596.3~uORF:IOH11191	1413	44	1369
B28R02C17	28-17-2	Hs~Ref:NM_145027.1~uORF:IOH10936	1547	48	1499
B28R02C18	28-18-2	Hs~Ref:NM_145027.1~uORF:IOH10936	1550	54	1496
B28R02C19	28-19-2	Hs~MGC:BC030815.1~uORF:IOH23044	749	61	688
B28R02C20	28-20-2	Hs~MGC:BC030815.1~uORF:IOH23044	854	427	427
B28R02C21	28-21-2	Hs~Ref:NM_014047.1~uORF:IOH11187	979	51	928
B28R02C22	28-22-2	Hs~Ref:NM_014047.1~uORF:IOH11187	897	41	856
B28R03C01	28-1-3	Hs~Ref:NM_002629.2~uORF:IOH13682	780	41	739
B28R03C02	28-2-3	Hs~Ref:NM_002629.2~uORF:IOH13682	789	42	747
B28R03C03	28-3-3	Hs~Ref:NM_004779.4~uORF:IOH27767	455	46	409
B28R03C04	28-4-3	Hs~Ref:NM_004779.4~uORF:IOH27767	452	44	408
B28R03C05	28-5-3	Hs~Ref:NM_015621.2~uORF:IOH43603	2035	42	1993
B28R03C06	28-6-3	Hs~Ref:NM_015621.2~uORF:IOH43603	2036	41	1995
B28R03C07	28-7-3	Hs~Ref:NM_181689.1~uORF:IOH41368	330	41	289
B28R03C08	28-8-3	Hs~Ref:NM_181689.1~uORF:IOH41368	312	44	268
B28R03C09	28-9-3	Hs~Ref:NM_005678.3~uORF:IOH45840	990	48	942
B28R03C10	28-10-3	Hs~Ref:NM_005678.3~uORF:IOH45840	994	50	944
B28R03C11	28-11-3	Hs~Ref:NM_001003799.1~uORF:IOH45702	394	45	349
B28R03C12	28-12-3	Hs~Ref:NM_001003799.1~uORF:IOH45702	382	42	340
B28R03C13	28-13-3	Hs~Ref:NM_201377.1~uORF:IOH43396	428	45	383
B28R03C14	28-14-3	Hs~Ref:NM_201377.1~uORF:IOH43396	436	46	390
B28R03C15	28-15-3	Hs~Ref:NM_033137.1~uORF:IOH43469	490	43	447
B28R03C16	28-16-3	Hs~Ref:NM_033137.1~uORF:IOH43469	478	43	435
B28R03C17	28-17-3	Hs~Ref:NM_004116.2~uORF:IOH43717	304	98	206
B28R03C18	28-18-3	Hs~Ref:NM_004116.2~uORF:IOH43717	282	59	223
B28R03C19	28-19-3	Hs~Ref:NM_153477.1~uORF:IOH41013	90	60	30
B28R03C20	28-20-3	Hs~Ref:NM_153477.1~uORF:IOH41013	56	66	-10
B28R03C21	28-21-3	Hs~Ref:NM_138412.1~uORF:IOH12664	765	299	466
B28R03C22	28-22-3	Hs~Ref:NM_138412.1~uORF:IOH12664	538	42	496
B28R04C01	28-1-4	Hs~MGC:BC001244.1~uORF:IOH3256	401	43	358
B28R04C02	28-2-4	Hs~MGC:BC001244.1~uORF:IOH3256	401	46	355
B28R04C03	28-3-4	Hs~MGC:NM_152667.1~uORF:IOH10850	339	142	197
B28R04C04	28-4-4	Hs~MGC:NM_152667.1~uORF:IOH10850	350	47	303
B28R04C05	28-5-4	Hs~Ref:NM_031227.1~uORF:IOH3028	453	43	410
B28R04C06	28-6-4	Hs~Ref:NM_031227.1~uORF:IOH3028	453	40	413
B28R04C07	28-7-4	Hs~MGC:BC034146.1~uORF:IOH23168	65535	43	65492
B28R04C08	28-8-4	Hs~MGC:BC034146.1~uORF:IOH23168	65535	46	65489
B28R04C09	28-9-4	Hs~MGC:BC020619.1~uORF:IOH12054	446	48	398
B28R04C10	28-10-4	Hs~MGC:BC020619.1~uORF:IOH12054	430	49	381
B28R04C11	28-11-4	Hs~Ref:NM_004216.2~uORF:IOH14789	500	44	456
B28R04C12	28-12-4	Hs~Ref:NM_004216.2~uORF:IOH14789	514	42	472
B28R04C13	28-13-4	Hs~MGC:BC010537.1~uORF:IOH10170	1127	45	1082
B28R04C14	28-14-4	Hs~MGC:BC010537.1~uORF:IOH10170	1216	46	1170
B28R04C15	28-15-4	Hs~Ref:NM_002578.1~N/A	455	43	412
B28R04C16	28-16-4	Hs~Ref:NM_002578.1~N/A	487	43	444
B28R04C17	28-17-4	Hs~Ref:NM_052987.1~N/A	46	47	-1
B28R04C18	28-18-4	Hs~Ref:NM_052987.1~N/A	84	43	41
B28R04C19	28-19-4	Hs~MGC:BC011454.1~uORF:IOH9647	2106	49	2057
B28R04C20	28-20-4	Hs~MGC:BC011454.1~uORF:IOH9647	2211	65	2146
B28R04C21	28-21-4	Hs~MGC:BC011460.1~uORF:IOH9675	66	57	9
B28R04C22	28-22-4	Hs~MGC:BC011460.1~uORF:IOH9675	43	53	-10
B28R05C01	28-1-5	Hs~Ref:XM_096642.1~uORF:IOH43292	305	44	261
B28R05C02	28-2-5	Hs~Ref:XM_096642.1~uORF:IOH43292	312	45	267
B28R05C03	28-3-5	Hs~Ref:NM_007030.1~uORF:IOH43477	834	46	788
B28R05C04	28-4-5	Hs~Ref:NM_007030.1~uORF:IOH43477	793	45	748
B28R05C05	28-5-5	Hs~Ref:NM_174902.2~uORF:IOH43203	257	45	212
B28R05C06	28-6-5	Hs~Ref:NM_174902.2~uORF:IOH43203	227	44	183
B28R05C07	28-7-5	Hs~Ref:XM_375359.1~uORF:IOH43383	174	47	127
B28R05C08	28-8-5	Hs~Ref:XM_375359.1~uORF:IOH43383	169	49	120
B28R05C09	28-9-5	Hs~Ref:NM_015532.2~uORF:IOH12446	1451	47	1404
B28R05C10	28-10-5	Hs~Ref:NM_015532.2~uORF:IOH12446	1433	46	1387
B28R05C11	28-11-5	Hs~MGC:BC029811.1~uORF:IOH22776	304	43	261
B28R05C12	28-12-5	Hs~MGC:BC029811.1~uORF:IOH22776	287	43	244
B28R05C13	28-13-5	Hs~Ref:NM_004302.3~uORF:IOH4418	303	47	256
B28R05C14	28-14-5	Hs~Ref:NM_004302.3~uORF:IOH4418	335	52	283
B28R05C15	28-15-5	Hs~MGC:BC034145.1~uORF:IOH23165	321	46	275
B28R05C16	28-16-5	Hs~MGC:BC034145.1~uORF:IOH23165	294	45	249
B28R05C17	28-17-5	Hs~Ref:NM_031282.1~uORF:IOH35897	140	44	96
B28R05C18	28-18-5	Hs~Ref:NM_031282.1~uORF:IOH35897	146	43	103
B28R05C19	28-19-5	Hs~Ref:NM_145872.1~uORF:IOH35588	167	44	123
B28R05C20	28-20-5	Hs~Ref:NM_145872.1~uORF:IOH35588	166	45	121
B28R05C21	28-21-5	Hs~Ref:NM_004262.1~uORF:IOH35723	190	45	145
B28R05C22	28-22-5	Hs~Ref:NM_004262.1~uORF:IOH35723	63	47	16
B28R06C01	28-1-6	Hs~Ref:NM_203286.1~uORF:IOH35592	308	45	263
B28R06C02	28-2-6	Hs~Ref:NM_203286.1~uORF:IOH35592	290	46	244
B28R06C03	28-3-6	Hs~Ref:NM_003332.1~uORF:IOH10176	273	49	224
B28R06C04	28-4-6	Hs~Ref:NM_003332.1~uORF:IOH10176	213	51	162
B28R06C05	28-5-6	Hs~Ref:NM_001010934.1~uORF:IOH54778	314	45	269
B28R06C06	28-6-6	Hs~Ref:NM_001010934.1~uORF:IOH54778	315	46	269
B28R06C07	28-7-6	Hs~Ref:NM_001938.1~uORF:IOH5390	251	84	167
B28R06C08	28-8-6	Hs~Ref:NM_001938.1~uORF:IOH5390	94	49	45
B28R06C09	28-9-6	Hs~MGC:BC056143.1~uORF:IOH29073	70	42	28
B28R06C10	28-10-6	Hs~MGC:BC056143.1~uORF:IOH29073	43	40	3
B28R06C11	28-11-6	Hs~Ref:NM_024331.1~uORF:IOH3905	391	42	349
B28R06C12	28-12-6	Hs~Ref:NM_024331.1~uORF:IOH3905	385	44	341
B28R06C13	28-13-6	Hs~Ref:NM_144716.1~uORF:IOH13356	1098	47	1051
B28R06C14	28-14-6	Hs~Ref:NM_144716.1~uORF:IOH13356	1131	46	1085
B28R06C15	28-15-6	Hs~Ref:NM_144646.1~uORF:IOH12964	501	44	457
B28R06C16	28-16-6	Hs~Ref:NM_144646.1~uORF:IOH12964	486	44	442
B28R06C17	28-17-6	Hs~MGC:BC017054.1~uORF:IOH10366	1891	44	1847
B28R06C18	28-18-6	Hs~MGC:BC017054.1~uORF:IOH10366	1913	49	1864
B28R06C19	28-19-6	Hs~MGC:BC098400.1~uORF:IOH62654	388	234	154
B28R06C20	28-20-6	Hs~MGC:BC098400.1~uORF:IOH62654	261	50	211
B28R06C21	28-21-6	Hs~MGC:BC092474.1~uORF:IOH62679	1792	49	1743
B28R06C22	28-22-6	Hs~MGC:BC092474.1~uORF:IOH62679	1779	46	1733
B28R07C01	28-1-7	Hs~MGC:BC096303.1~uORF:IOH63248	921	43	878
B28R07C02	28-2-7	Hs~MGC:BC096303.1~uORF:IOH63248	921	45	876
B28R07C03	28-3-7	Hs~MGC:BC096205.2~uORF:IOH63218	288	44	244
B28R07C04	28-4-7	Hs~MGC:BC096205.2~uORF:IOH63218	277	43	234
B28R07C05	28-5-7	Hs~Ref:NM_004664.2~uORF:IOH42498	259	44	215
B28R07C06	28-6-7	Hs~Ref:NM_004664.2~uORF:IOH42498	296	54	242
B28R07C07	28-7-7	Hs~Ref:XM_379587.2~uORF:IOH41521	395	121	274
B28R07C08	28-8-7	Hs~Ref:XM_379587.2~uORF:IOH41521	359	65	294
B28R07C09	28-9-7	Hs~Ref:NM_021637.1~uORF:IOH41185	337	45	292
B28R07C10	28-10-7	Hs~Ref:NM_021637.1~uORF:IOH41185	304	41	263
B28R07C11	28-11-7	Hs~Ref:NM_002938.2~uORF:IOH41414	311	48	263
B28R07C12	28-12-7	Hs~Ref:NM_002938.2~uORF:IOH41414	287	53	234
B28R07C13	28-13-7	Hs~Ref:NM_023030.1~N/A	193	62	131
B28R07C14	28-14-7	Hs~Ref:NM_023030.1~N/A	103	45	58
B28R07C15	28-15-7	Hs~MGC:BC024013.2~uORF:IOH10901	77	46	31
B28R07C16	28-16-7	Hs~MGC:BC024013.2~uORF:IOH10901	114	61	53
B28R07C17	28-17-7	Hs~MGC:BC022958.1~uORF:IOH11908	249	48	201
B28R07C18	28-18-7	Hs~MGC:BC022958.1~uORF:IOH11908	208	51	157
B28R07C19	28-19-7	Hs~MGC:BC033775.1~uORF:IOH21766	261	134	127
B28R07C20	28-20-7	Hs~MGC:BC033775.1~uORF:IOH21766	54	59	-5
B28R07C21	28-21-7	Hs~Ref:NM_139022.2~uORF:IOH59366	61	55	6
B28R07C22	28-22-7	Hs~Ref:NM_139022.2~uORF:IOH59366	60	53	7
B28R08C01	28-1-8	Hs~Ref:NM_001002269.1~uORF:IOH59989	1102	42	1060
B28R08C02	28-2-8	Hs~Ref:NM_001002269.1~uORF:IOH59989	1171	42	1129
B28R08C03	28-3-8	Hs~Ref:NM_013978.1~uORF:IOH59665	370	43	327
B28R08C04	28-4-8	Hs~Ref:NM_013978.1~uORF:IOH59665	312	43	269
B28R08C05	28-5-8	Hs~Ref:NM_013269.2~uORF:IOH59655	379	46	333
B28R08C06	28-6-8	Hs~Ref:NM_013269.2~uORF:IOH59655	363	50	313
B28R08C07	28-7-8	Hs~Ref:NM_005371.2~uORF:IOH4172	7375	60	7315
B28R08C08	28-8-8	Hs~Ref:NM_005371.2~uORF:IOH4172	7377	58	7319
B28R08C09	28-9-8	Hs~MGC:BC017025.1~uORF:IOH9960	394	43	351
B28R08C10	28-10-8	Hs~MGC:BC017025.1~uORF:IOH9960	356	43	313
B28R08C11	28-11-8	Hs~Ref:NM_002810.1~uORF:IOH3462	276	162	114
B28R08C12	28-12-8	Hs~Ref:NM_002810.1~uORF:IOH3462	358	83	275
B28R08C13	28-13-8	Hs~MGC:BC004122.1~uORF:IOH22910	298	57	241
B28R08C14	28-14-8	Hs~MGC:BC004122.1~uORF:IOH22910	270	63	207
B28R08C15	28-15-8	Hs~MGC:NM_153645.1~uORF:IOH11663	4694	48	4646
B28R08C16	28-16-8	Hs~MGC:NM_153645.1~uORF:IOH11663	4844	46	4798
B28R08C17	28-17-8	Hs~Ref:NM_002621.1~uORF:IOH12225	422	44	378
B28R08C18	28-18-8	Hs~Ref:NM_002621.1~uORF:IOH12225	442	45	397
B28R08C19	28-19-8	Hs~MGC:BC012303.1~uORF:IOH11142	522	47	475
B28R08C20	28-20-8	Hs~MGC:BC012303.1~uORF:IOH11142	606	48	558
B28R08C21	28-21-8	Hs~Ref:NM_024561.1~uORF:IOH11647	555	54	501
B28R08C22	28-22-8	Hs~Ref:NM_024561.1~uORF:IOH11647	143	57	86
B28R09C01	28-1-9	Hs~MGC:BC018918.2~uORF:IOH40607	700	129	571
B28R09C02	28-2-9	Hs~MGC:BC018918.2~uORF:IOH40607	399	44	355
B28R09C03	28-3-9	Hs~Ref:NM_021010.1~uORF:IOH40358	250	44	206
B28R09C04	28-4-9	Hs~Ref:NM_021010.1~uORF:IOH40358	239	44	195
B28R09C05	28-5-9	Hs~MGC:BC065525.1~uORF:IOH40477	559	47	512
B28R09C06	28-6-9	Hs~MGC:BC065525.1~uORF:IOH40477	548	50	498
B28R09C07	28-7-9	Hs~Ref:NM_007190.2~uORF:IOH40514	460	50	410
B28R09C08	28-8-9	Hs~Ref:NM_007190.2~uORF:IOH40514	410	87	323
B28R09C09	28-9-9	Hs~Ref:NM_005572.1~uORF:IOH3580	554	44	510
B28R09C10	28-10-9	Hs~Ref:NM_005572.1~uORF:IOH3580	540	43	497
B28R09C11	28-11-9	Hs~Ref:NM_002140.2~uORF:IOH3670	405	44	361
B28R09C12	28-12-9	Hs~Ref:NM_002140.2~uORF:IOH3670	379	44	335
B28R09C13	28-13-9	Hs~Ref:NM_001970.2~uORF:IOH3811	282	44	238
B28R09C14	28-14-9	Hs~Ref:NM_001970.2~uORF:IOH3811	319	45	274
B28R09C15	28-15-9	Hs~MGC:BC047393.1~uORF:IOH26537	368	42	326
B28R09C16	28-16-9	Hs~MGC:BC047393.1~uORF:IOH26537	349	42	307
B28R09C17	28-17-9	Hs~MGC:BC020658.1~uORF:IOH12831	649	44	605
B28R09C18	28-18-9	Hs~MGC:BC020658.1~uORF:IOH12831	666	43	623
B28R09C19	28-19-9	Hs~MGC:NM_005702.1~uORF:IOH13346	785	45	740
B28R09C20	28-20-9	Hs~MGC:NM_005702.1~uORF:IOH13346	800	50	750
B28R09C21	28-21-9	Hs~MGC:BC010993.2~uORF:IOH12098	432	67	365
B28R09C22	28-22-9	Hs~MGC:BC010993.2~uORF:IOH12098	371	88	283
B28R10C01	28-1-10	Hs~Ref:NM_004929.2~uORF:IOH1903	936	87	849
B28R10C02	28-2-10	Hs~Ref:NM_004929.2~uORF:IOH1903	1035	70	965
B28R10C03	28-3-10	Hs~MGC:BC059411.1~uORF:IOH29280	746	54	692
B28R10C04	28-4-10	Hs~MGC:BC059411.1~uORF:IOH29280	909	80	829
B28R10C05	28-5-10	Hs~MGC:BC059393.1~uORF:IOH29208	531	57	474
B28R10C06	28-6-10	Hs~MGC:BC059393.1~uORF:IOH29208	483	60	423
B28R10C07	28-7-10	Hs~MGC:BC053733.1~uORF:IOH28787	559	318	241
B28R10C08	28-8-10	Hs~MGC:BC053733.1~uORF:IOH28787	369	61	308
B28R10C09	28-9-10	Hs~MGC:BC041638.1~uORF:IOH28004	445	60	385
B28R10C10	28-10-10	Hs~MGC:BC041638.1~uORF:IOH28004	451	52	399
B28R10C11	28-11-10	GST1	47	44	3
B28R10C12	28-12-10	GST1	43	41	2
B28R10C13	28-13-10	GST2	44	40	4
B28R10C14	28-14-10	GST2	43	40	3
B28R10C15	28-15-10	GST3	58	41	17
B28R10C16	28-16-10	GST3	50	41	9
B28R10C17	28-17-10	GST4	70	40	30
B28R10C18	28-18-10	GST4	58	41	17
B28R10C19	28-19-10	Anti-HumanIgA1~N/A	6231	43	6188
B28R10C20	28-20-10	Anti-HumanIgA1~N/A	7679	44	7635
B28R10C21	28-21-10	Anti-HumanIgA2~N/A	11521	49	11472
B28R10C22	28-22-10	Anti-HumanIgA2~N/A	12878	46	12832
B28R11C01	28-1-11	AlexaAntiMouseAb~N/A	27369	66	27303
B28R11C02	28-2-11	AlexaAntiMouseAb~N/A	26019	71	25948
B28R11C03	28-3-11	MAPKAP~N/A	156	71	85
B28R11C04	28-4-11	MAPKAP~N/A	91	60	31
B28R11C05	28-5-11	Buffer	106	57	49
B28R11C06	28-6-11	Buffer	114	54	60
B28R11C07	28-7-11	BSA~N/A	6307	57	6250
B28R11C08	28-8-11	BSA~N/A	6606	54	6552
B28R11C09	28-9-11	Anti-HumanIgG1~N/A	1260	56	1204
B28R11C10	28-10-11	Anti-HumanIgG1~N/A	1403	53	1350
B28R11C11	28-11-11	Anti-HumanIgG2~N/A	1938	50	1888
B28R11C12	28-12-11	Anti-HumanIgG2~N/A	2325	51	2274
B28R11C13	28-13-11	Anti-HumanIgG3~N/A	3144	45	3099
B28R11C14	28-14-11	Anti-HumanIgG3~N/A	3982	42	3940
B28R11C15	28-15-11	Anti-HumanIgG4~N/A	7963	43	7920
B28R11C16	28-16-11	Anti-HumanIgG4~N/A	9056	44	9012
B28R11C17	28-17-11	AntiBiotinAb~N/A	10166	43	10123
B28R11C18	28-18-11	AntiBiotinAb~N/A	10196	43	10153
B28R11C19	28-19-11	Buffer	79	47	32
B28R11C20	28-20-11	Buffer	50	46	4
B28R11C21	28-21-11	Hs~MGC:BC022357.1~uORF:IOH14149	203	54	149
B28R11C22	28-22-11	Hs~MGC:BC022357.1~uORF:IOH14149	181	46	135
B28R12C01	28-1-12	Hs~MGC:BC044593.1~uORF:IOH26878	223	48	175
B28R12C02	28-2-12	Hs~MGC:BC044593.1~uORF:IOH26878	261	60	201
B28R12C03	28-3-12	Hs~MGC:BC050375.1~uORF:IOH26654	130	62	68
B28R12C04	28-4-12	Hs~MGC:BC050375.1~uORF:IOH26654	119	58	61
B28R12C05	28-5-12	Hs~MGC:BC050623.1~uORF:IOH27007	665	58	607
B28R12C06	28-6-12	Hs~MGC:BC050623.1~uORF:IOH27007	647	58	589
B28R12C07	28-7-12	Hs~MGC:BC011761.2~uORF:IOH13919	366	76	290
B28R12C08	28-8-12	Hs~MGC:BC011761.2~uORF:IOH13919	339	54	285
B28R12C09	28-9-12	Hs~Ref:NM_004240.2~uORF:IOH12722	496	63	433
B28R12C10	28-10-12	Hs~Ref:NM_004240.2~uORF:IOH12722	443	52	391
B28R12C11	28-11-12	Hs~Ref:NM_016451.3~uORF:IOH27122	671	109	562
B28R12C12	28-12-12	Hs~Ref:NM_016451.3~uORF:IOH27122	497	60	437
B28R12C13	28-13-12	Hs~Ref:NM_153332.2~uORF:IOH27323	186	55	131
B28R12C14	28-14-12	Hs~Ref:NM_153332.2~uORF:IOH27323	228	50	178
B28R12C15	28-15-12	Hs~MGC:BC101007.1~uORF:IOH63458	344	52	292
B28R12C16	28-16-12	Hs~MGC:BC101007.1~uORF:IOH63458	329	54	275
B28R12C17	28-17-12	Hs~MGC:BC096336.1~uORF:IOH63244	203	56	147
B28R12C18	28-18-12	Hs~MGC:BC096336.1~uORF:IOH63244	193	57	136
B28R12C19	28-19-12	Hs~MGC:BC024241.2~uORF:IOH11711	291	63	228
B28R12C20	28-20-12	Hs~MGC:BC024241.2~uORF:IOH11711	279	60	219
B28R12C21	28-21-12	Hs~MGC:BC103921.1~uORF:IOH63385	168	51	117
B28R12C22	28-22-12	Hs~MGC:BC103921.1~uORF:IOH63385	149	50	99
B28R13C01	28-1-13	Hs~Ref:NM_019592.5~uORF:IOH42829	46	47	-1
B28R13C02	28-2-13	Hs~Ref:NM_019592.5~uORF:IOH42829	394	183	211
B28R13C03	28-3-13	Hs~Ref:NM_139181.1~uORF:IOH42674	333	192	141
B28R13C04	28-4-13	Hs~Ref:NM_139181.1~uORF:IOH42674	243	58	185
B28R13C05	28-5-13	Hs~Ref:NM_033360.2~uORF:IOH44611	220	83	137
B28R13C06	28-6-13	Hs~Ref:NM_033360.2~uORF:IOH44611	143	52	91
B28R13C07	28-7-13	Hs~Ref:NM_018052.3~uORF:IOH41847	324	75	249
B28R13C08	28-8-13	Hs~Ref:NM_018052.3~uORF:IOH41847	273	77	196
B28R13C09	28-9-13	Hs~Ref:NM_002688.2~uORF:IOH12490	297	68	229
B28R13C10	28-10-13	Hs~Ref:NM_002688.2~uORF:IOH12490	169	124	45
B28R13C11	28-11-13	Hs~MGC:BC047620.1~uORF:IOH28815	309	62	247
B28R13C12	28-12-13	Hs~MGC:BC047620.1~uORF:IOH28815	240	66	174
B28R13C13	28-13-13	Hs~MGC:BC064945.1~uORF:IOH39953	343	58	285
B28R13C14	28-14-13	Hs~MGC:BC064945.1~uORF:IOH39953	282	58	224
B28R13C15	28-15-13	Hs~Ref:NM_172213.1~uORF:IOH35341	428	89	339
B28R13C16	28-16-13	Hs~Ref:NM_172213.1~uORF:IOH35341	195	62	133
B28R13C17	28-17-13	Hs~Ref:NM_006272.1~uORF:IOH4935	748	82	666
B28R13C18	28-18-13	Hs~Ref:NM_006272.1~uORF:IOH4935	626	65	561
B28R13C19	28-19-13	Hs~MGC:BC010369.1~uORF:IOH13610	324	68	256
B28R13C20	28-20-13	Hs~MGC:BC010369.1~uORF:IOH13610	693	148	545
B28R13C21	28-21-13	Hs~Ref:NM_138801.1~uORF:IOH10118	585	106	479
B28R13C22	28-22-13	Hs~Ref:NM_138801.1~uORF:IOH10118	164	53	111
B28R14C01	28-1-14	Hs~MGC:BC029520.1~uORF:IOH22574	222	43	179
B28R14C02	28-2-14	Hs~MGC:BC029520.1~uORF:IOH22574	176	51	125
B28R14C03	28-3-14	Hs~Ref:NM_138316.2~uORF:IOH59336	710	525	185
B28R14C04	28-4-14	Hs~Ref:NM_138316.2~uORF:IOH59336	676	77	599
B28R14C05	28-5-14	Hs~Ref:NM_001678.3~uORF:IOH59230	219	53	166
B28R14C06	28-6-14	Hs~Ref:NM_001678.3~uORF:IOH59230	196	50	146
B28R14C07	28-7-14	Hs~Ref:NM_003926.5~uORF:IOH59233	771	56	715
B28R14C08	28-8-14	Hs~Ref:NM_003926.5~uORF:IOH59233	635	91	544
B28R14C09	28-9-14	Hs~Ref:NM_004300.2~uORF:IOH54659	861	54	807
B28R14C10	28-10-14	Hs~Ref:NM_004300.2~uORF:IOH54659	781	52	729
B28R14C11	28-11-14	Hs~Ref:NM_178818.2~uORF:IOH36816	374	74	300
B28R14C12	28-12-14	Hs~Ref:NM_178818.2~uORF:IOH36816	144	47	97
B28R14C13	28-13-14	Hs~MGC:BC014225.2~uORF:IOH12178	248	49	199
B28R14C14	28-14-14	Hs~MGC:BC014225.2~uORF:IOH12178	126	58	68
B28R14C15	28-15-14	Hs~Ref:NM_001153.2~uORF:IOH4387	664	85	579
B28R14C16	28-16-14	Hs~Ref:NM_001153.2~uORF:IOH4387	616	118	498
B28R14C17	28-17-14	Hs~MGC:BC022368.1~uORF:IOH14722	99	52	47
B28R14C18	28-18-14	Hs~MGC:BC022368.1~uORF:IOH14722	101	56	45
B28R14C19	28-19-14	Hs~MGC:BC102021.1~uORF:IOH63591	584	61	523
B28R14C20	28-20-14	Hs~MGC:BC102021.1~uORF:IOH63591	564	178	386
B28R14C21	28-21-14	Hs~Ref:NM_001838.2~uORF:IOH60847	1376	56	1320
B28R14C22	28-22-14	Hs~Ref:NM_001838.2~uORF:IOH60847	1477	49	1428
B28R15C01	28-1-15	Hs~Ref:NM_153758.1~uORF:IOH35292	362	43	319
B28R15C02	28-2-15	Hs~Ref:NM_153758.1~uORF:IOH35292	378	42	336
B28R15C03	28-3-15	Hs~Ref:NM_001037293.1~uORF:IOH60135	192	46	146
B28R15C04	28-4-15	Hs~Ref:NM_001037293.1~uORF:IOH60135	182	48	134
B28R15C05	28-5-15	Hs~Ref:NM_006579.1~uORF:IOH11243	549	43	506
B28R15C06	28-6-15	Hs~Ref:NM_006579.1~uORF:IOH11243	555	42	513
B28R15C07	28-7-15	Hs~MGC:BC015468.1~uORF:IOH11236	211	42	169
B28R15C08	28-8-15	Hs~MGC:BC015468.1~uORF:IOH11236	185	44	141
B28R15C09	28-9-15	Hs~MGC:BC039244.1~uORF:IOH27185	547	69	478
B28R15C10	28-10-15	Hs~MGC:BC039244.1~uORF:IOH27185	438	49	389
B28R15C11	28-11-15	Hs~MGC:BC038422.1~uORF:IOH27448	499	69	430
B28R15C12	28-12-15	Hs~MGC:BC038422.1~uORF:IOH27448	533	61	472
B28R15C13	28-13-15	Hs~Ref:NM_005975.2~CAT:PV3291	45	44	1
B28R15C14	28-14-15	Hs~Ref:NM_005975.2~CAT:PV3291	35	43	-8
B28R15C15	28-15-15	Hs~Ref:NM_016457.3~CAT:PV3758	246	46	200
B28R15C16	28-16-15	Hs~Ref:NM_016457.3~CAT:PV3758	64	47	17
B28R15C17	28-17-15	Hs~Ref:NM_001014831.1~CAT:PV4212	185	43	142
B28R15C18	28-18-15	Hs~Ref:NM_001014831.1~CAT:PV4212	95	50	45
B28R15C19	28-19-15	Hs~Ref:NM_003845.1~CAT:PV3871	424	54	370
B28R15C20	28-20-15	Hs~Ref:NM_003845.1~CAT:PV3871	243	47	196
B28R15C21	28-21-15	Hs~Ref:NM_001006944.1~CAT:PV3782	503	52	451
B28R15C22	28-22-15	Hs~Ref:NM_001006944.1~CAT:PV3782	390	48	342
B28R16C01	28-1-16	Hs~Ref:NM_000589.2~CAT_PHC0045	232	43	189
B28R16C02	28-2-16	Hs~Ref:NM_000589.2~CAT_PHC0045	233	46	187
B28R16C03	28-3-16	Hs~Ref:NM_004302~CAT_PHC9285	65535	44	65491
B28R16C04	28-4-16	Hs~Ref:NM_004302~CAT_PHC9285	65535	43	65492
B28R16C05	28-5-16	Hs~Ref:NM_002989.2~CAT_PHC1475	902	41	861
B28R16C06	28-6-16	Hs~Ref:NM_002989.2~CAT_PHC1475	1016	40	976
B28R16C07	28-7-16	Hs~MGC:BC026229.1~uORF:IOH12750	131	53	78
B28R16C08	28-8-16	Hs~MGC:BC026229.1~uORF:IOH12750	121	60	61
B28R16C09	28-9-16	Hs~Ref:NM_024805.1~uORF:IOH13501	215	51	164
B28R16C10	28-10-16	Hs~Ref:NM_024805.1~uORF:IOH13501	166	87	79
B28R16C11	28-11-16	Hs~MGC:BC009478.1~uORF:IOH12273	273	73	200
B28R16C12	28-12-16	Hs~MGC:BC009478.1~uORF:IOH12273	217	95	122
B28R16C13	28-13-16	Hs~MGC:BC014774.1~uORF:IOH10280	458	43	415
B28R16C14	28-14-16	Hs~MGC:BC014774.1~uORF:IOH10280	459	44	415
B28R16C15	28-15-16	Hs~Ref:NM_001002255.1~uORF:IOH50186	513	44	469
B28R16C16	28-16-16	Hs~Ref:NM_001002255.1~uORF:IOH50186	467	43	424
B28R16C17	28-17-16	Hs~Ref:NM_001011540.1~uORF:IOH57331	593	43	550
B28R16C18	28-18-16	Hs~Ref:NM_001011540.1~uORF:IOH57331	583	45	538
B28R16C19	28-19-16	Hs~Ref:NM_001014439.1~uORF:IOH57350	643	45	598
B28R16C20	28-20-16	Hs~Ref:NM_001014439.1~uORF:IOH57350	707	47	660
B28R16C21	28-21-16	Hs~Ref:NM_006105.3~uORF:IOH11287	2039	49	1990
B28R16C22	28-22-16	Hs~Ref:NM_006105.3~uORF:IOH11287	1840	45	1795
B28R17C01	28-1-17	Hs~MGC:NM_152682.1~uORF:IOH10053	419	44	375
B28R17C02	28-2-17	Hs~MGC:NM_152682.1~uORF:IOH10053	440	42	398
B28R17C03	28-3-17	Hs~Ref:NM_138394.2~uORF:IOH14812	158	43	115
B28R17C04	28-4-17	Hs~Ref:NM_138394.2~uORF:IOH14812	166	43	123
B28R17C05	28-5-17	Hs~Ref:NM_006937.2~uORF:IOH13961	296	42	254
B28R17C06	28-6-17	Hs~Ref:NM_006937.2~uORF:IOH13961	289	42	247
B28R17C07	28-7-17	Hs~MGC:BC009313.1~uORF:IOH14080	127	51	76
B28R17C08	28-8-17	Hs~MGC:BC009313.1~uORF:IOH14080	97	46	51
B28R17C09	28-9-17	Hs~MGC:BC067221.1~uORF:IOH40763	207	41	166
B28R17C10	28-10-17	Hs~MGC:BC067221.1~uORF:IOH40763	154	43	111
B28R17C11	28-11-17	Hs~Ref:NM_013442.1~uORF:IOH5037	211	48	163
B28R17C12	28-12-17	Hs~Ref:NM_013442.1~uORF:IOH5037	154	50	104
B28R17C13	28-13-17	Hs~Ref:NM_207168.1~uORF:IOH40772	318	55	263
B28R17C14	28-14-17	Hs~Ref:NM_207168.1~uORF:IOH40772	163	43	120
B28R17C15	28-15-17	Hs~Ref:NM_152997.2~uORF:IOH40712	197	46	151
B28R17C16	28-16-17	Hs~Ref:NM_152997.2~uORF:IOH40712	121	53	68
B28R17C17	28-17-17	Hs~Ref:XM_379430.1~uORF:IOH43976	375	45	330
B28R17C18	28-18-17	Hs~Ref:XM_379430.1~uORF:IOH43976	363	46	317
B28R17C19	28-19-17	Hs~Ref:NM_004032.2~uORF:IOH43554	437	43	394
B28R17C20	28-20-17	Hs~Ref:NM_004032.2~uORF:IOH43554	461	46	415
B28R17C21	28-21-17	Hs~Ref:NM_057157.1~uORF:IOH41398	477	44	433
B28R17C22	28-22-17	Hs~Ref:NM_057157.1~uORF:IOH41398	462	107	355
B28R18C01	28-1-18	Hs~Ref:NM_004922.2~uORF:IOH38664	882	60	822
B28R18C02	28-2-18	Hs~Ref:NM_004922.2~uORF:IOH38664	825	44	781
B28R18C03	28-3-18	Hs~Ref:NM_030981.1~uORF:IOH29640	327	105	222
B28R18C04	28-4-18	Hs~Ref:NM_030981.1~uORF:IOH29640	180	46	134
B28R18C05	28-5-18	Hs~MGC:BC053578.1~uORF:IOH28934	400	45	355
B28R18C06	28-6-18	Hs~MGC:BC053578.1~uORF:IOH28934	368	43	325
B28R18C07	28-7-18	Hs~Ref:NM_000773.2~uORF:IOH29616	173	46	127
B28R18C08	28-8-18	Hs~Ref:NM_000773.2~uORF:IOH29616	194	42	152
B28R18C09	28-9-18	Hs~Ref:NM_003224.1~uORF:IOH29617	170	44	126
B28R18C10	28-10-18	Hs~Ref:NM_003224.1~uORF:IOH29617	88	59	29
B28R18C11	28-11-18	Hs~MGC:BC064391.1~uORF:IOH61736	565	44	521
B28R18C12	28-12-18	Hs~MGC:BC064391.1~uORF:IOH61736	579	44	535
B28R18C13	28-13-18	Hs~MGC:BC066343.1~uORF:IOH62507	42636	44	42592
B28R18C14	28-14-18	Hs~MGC:BC066343.1~uORF:IOH62507	44306	47	44259
B28R18C15	28-15-18	Hs~MGC:BC015546.1~uORF:IOH61714	335	162	173
B28R18C16	28-16-18	Hs~MGC:BC015546.1~uORF:IOH61714	304	130	174
B28R18C17	28-17-18	Hs~MGC:BC071563.1~uORF:IOH61664	307	60	247
B28R18C18	28-18-18	Hs~MGC:BC071563.1~uORF:IOH61664	246	56	190
B28R18C19	28-19-18	Hs~MGC:BC028415.1~uORF:IOH62097	436	55	381
B28R18C20	28-20-18	Hs~MGC:BC028415.1~uORF:IOH62097	411	54	357
B28R18C21	28-21-18	Hs~Ref:NM_000799.2~uORF:IOH61961	313	47	266
B28R18C22	28-22-18	Hs~Ref:NM_000799.2~uORF:IOH61961	292	43	249
B28R19C01	28-1-19	Hs~MGC:BC017012.1~uORF:IOH11877	488	78	410
B28R19C02	28-2-19	Hs~MGC:BC017012.1~uORF:IOH11877	443	46	397
B28R19C03	28-3-19	Hs~MGC:BC047741.1~uORF:IOH26659	386	45	341
B28R19C04	28-4-19	Hs~MGC:BC047741.1~uORF:IOH26659	402	42	360
B28R19C05	28-5-19	Hs~Ref:NM_005613.2~uORF:IOH4771	404	44	360
B28R19C06	28-6-19	Hs~Ref:NM_005613.2~uORF:IOH4771	424	44	380
B28R19C07	28-7-19	Hs~MGC:BC000784.1~uORF:IOH4711	299	45	254
B28R19C08	28-8-19	Hs~MGC:BC000784.1~uORF:IOH4711	329	46	283
B28R19C09	28-9-19	Hs~MGC:BC047486.1~uORF:IOH62402	140	43	97
B28R19C10	28-10-19	Hs~MGC:BC047486.1~uORF:IOH62402	63	48	15
B28R19C11	28-11-19	Hs~MGC:BC071591.1~uORF:IOH61669	314	80	234
B28R19C12	28-12-19	Hs~MGC:BC071591.1~uORF:IOH61669	177	43	134
B28R19C13	28-13-19	Hs~Ref:NM_023934.2~uORF:IOH40818	422	42	380
B28R19C14	28-14-19	Hs~Ref:NM_023934.2~uORF:IOH40818	420	43	377
B28R19C15	28-15-19	Hs~Ref:NM_024928.3~uORF:IOH12386	395	64	331
B28R19C16	28-16-19	Hs~Ref:NM_024928.3~uORF:IOH12386	411	258	153
B28R19C17	28-17-19	Hs~Ref:NM_017952.4~uORF:IOH40917	478	46	432
B28R19C18	28-18-19	Hs~Ref:NM_017952.4~uORF:IOH40917	394	48	346
B28R19C19	28-19-19	Hs~MGC:BC032866.2~uORF:IOH27132	312	80	232
B28R19C20	28-20-19	Hs~MGC:BC032866.2~uORF:IOH27132	367	130	237
B28R19C21	28-21-19	Hs~Ref:NM_080651.1~uORF:IOH3372	71	52	19
B28R19C22	28-22-19	Hs~Ref:NM_080651.1~uORF:IOH3372	117	47	70
B28R20C01	28-1-20	Hs~Ref:NM_138390.1~uORF:IOH3301	363	116	247
B28R20C02	28-2-20	Hs~Ref:NM_138390.1~uORF:IOH3301	312	104	208
B28R20C03	28-3-20	Hs~MGC:BC008253.1~uORF:IOH3366	211	48	163
B28R20C04	28-4-20	Hs~MGC:BC008253.1~uORF:IOH3366	279	71	208
B28R20C05	28-5-20	Hs~Ref:NM_004146.3~uORF:IOH4112	363	46	317
B28R20C06	28-6-20	Hs~Ref:NM_004146.3~uORF:IOH4112	383	45	338
B28R20C07	28-7-20	Hs~Ref:NM_181900.2~uORF:IOH40592	589	46	543
B28R20C08	28-8-20	Hs~Ref:NM_181900.2~uORF:IOH40592	554	45	509
B28R20C09	28-9-20	Hs~Ref:NM_022171.1~uORF:IOH40573	530	42	488
B28R20C10	28-10-20	Hs~Ref:NM_022171.1~uORF:IOH40573	539	41	498
B28R20C11	28-11-20	Hs~MGC:BC007811.2~uORF:IOH40618	40	40	0
B28R20C12	28-12-20	Hs~MGC:BC007811.2~uORF:IOH40618	40	39	1
B28R20C13	28-13-20	Hs~Ref:NM_015289.2~uORF:IOH40537	799	40	759
B28R20C14	28-14-20	Hs~Ref:NM_015289.2~uORF:IOH40537	772	40	732
B28R20C15	28-15-20	Hs~Ref:NM_001001482.1~uORF:IOH50094	814	43	771
B28R20C16	28-16-20	Hs~Ref:NM_001001482.1~uORF:IOH50094	788	44	744
B28R20C17	28-17-20	Hs~Ref:ENST00000400477~uORF:IOH50169	1020	42	978
B28R20C18	28-18-20	Hs~Ref:ENST00000400477~uORF:IOH50169	1004	45	959
B28R20C19	28-19-20	Hs~Ref:NM_178341.1~uORF:IOH50137	821	47	774
B28R20C20	28-20-20	Hs~Ref:NM_178341.1~uORF:IOH50137	801	46	755
B28R20C21	28-21-20	Hs~Ref:NM_016326.2~uORF:IOH50105	828	42	786
B28R20C22	28-22-20	Hs~Ref:NM_016326.2~uORF:IOH50105	1370	53	1317
B28R21C01	28-1-21	Hs~Ref:NM_001005732.1~uORF:IOH50122	1338	55	1283
B28R21C02	28-2-21	Hs~Ref:NM_001005732.1~uORF:IOH50122	1234	47	1187
B28R21C03	28-3-21	Hs~Ref:NM_014056.1~uORF:IOH50180	699	40	659
B28R21C04	28-4-21	Hs~Ref:NM_014056.1~uORF:IOH50180	705	42	663
B28R21C05	28-5-21	Hs~Ref:NM_181283.1~uORF:IOH50098	789	41	748
B28R21C06	28-6-21	Hs~Ref:NM_181283.1~uORF:IOH50098	860	41	819
B28R21C07	28-7-21	Hs~Ref:NM_001024.3~uORF:IOH50144	845	40	805
B28R21C08	28-8-21	Hs~Ref:NM_001024.3~uORF:IOH50144	879	40	839
B28R21C09	28-9-21	Hs~Ref:P20023-1~CAT_10811-H08H-25	36	39	-3
B28R21C10	28-10-21	Hs~Ref:P20023-1~CAT_10811-H08H-25	36	38	-2
B28R21C11	28-11-21	Internal_1007209	181	50	131
B28R21C12	28-12-21	Internal_1007209	75	40	35
B28R21C13	28-13-21	Hs~Ref:NP_055154.3~CAT_10895-H08H-25	237	40	197
B28R21C14	28-14-21	Hs~Ref:NP_055154.3~CAT_10895-H08H-25	225	40	185
B28R21C15	28-15-21	Internal_1007209	610	68	542
B28R21C16	28-16-21	Internal_1007209	551	51	500
B28R21C17	28-17-21	Hs~Ref:NP_061113.1~CAT_10511-H03H-25	1311	39	1272
B28R21C18	28-18-21	Hs~Ref:NP_061113.1~CAT_10511-H03H-25	1560	44	1516
B28R21C19	28-19-21	Internal_1007209	162	47	115
B28R21C20	28-20-21	Internal_1007209	42	41	1
B28R21C21	28-21-21	Internal_1007209	118	40	78
B28R21C22	28-22-21	Internal_1007209	55	55	0
B28R22C01	28-1-22	ERa~N/A	2741	60	2681
B28R22C02	28-2-22	ERa~N/A	2609	46	2563
B28R22C03	28-3-22	PKCeta~N/A	375	41	334
B28R22C04	28-4-22	PKCeta~N/A	430	40	390
B28R22C05	28-5-22	Calmodulin~N/A	699	39	660
B28R22C06	28-6-22	Calmodulin~N/A	930	38	892
B28R22C07	28-7-22	V5control5~N/A	8259	38	8221
B28R22C08	28-8-22	V5control5~N/A	8634	39	8595
B28R22C09	28-9-22	V5control4~N/A	324	40	284
B28R22C10	28-10-22	V5control4~N/A	922	48	874
B28R22C11	28-11-22	V5control3~N/A	598	62	536
B28R22C12	28-12-22	V5control3~N/A	58	43	15
B28R22C13	28-13-22	V5control2~N/A	195	48	147
B28R22C14	28-14-22	V5control2~N/A	74	43	31
B28R22C15	28-15-22	V5control1~N/A	197	53	144
B28R22C16	28-16-22	V5control1~N/A	92	48	44
B28R22C17	28-17-22	CMK2A~N/A	758	43	715
B28R22C18	28-18-22	CMK2A~N/A	633	43	590
B28R22C19	28-19-22	ERa~N/A	1762	44	1718
B28R22C20	28-20-22	ERa~N/A	1755	43	1712
B28R22C21	28-21-22	AlexaAntiMouseAb~N/A	7448	43	7405
B28R22C22	28-22-22	AlexaAntiMouseAb~N/A	8925	48	8877
B29R01C01	29-1-1	AlexaAntiMouseAb~N/A	30392	40	30352
B29R01C02	29-2-1	AlexaAntiMouseAb~N/A	31558	38	31520
B29R01C03	29-3-1	ERa~N/A	1787	37	1750
B29R01C04	29-4-1	ERa~N/A	1623	37	1586
B29R01C05	29-5-1	HumanIgG1~N/A	1156	36	1120
B29R01C06	29-6-1	HumanIgG1~N/A	1165	37	1128
B29R01C07	29-7-1	HumanIgG2~N/A	2532	37	2495
B29R01C08	29-8-1	HumanIgG2~N/A	2482	37	2445
B29R01C09	29-9-1	HumanIgG3~N/A	11088	39	11049
B29R01C10	29-10-1	HumanIgG3~N/A	11955	39	11916
B29R01C11	29-11-1	HumanIgG4~N/A	34559	41	34518
B29R01C12	29-12-1	HumanIgG4~N/A	35435	37	35398
B29R01C13	29-13-1	BiotinAb~N/A	336	36	300
B29R01C14	29-14-1	BiotinAb~N/A	346	35	311
B29R01C15	29-15-1	RanBP2deltaFG~N/A	330	34	296
B29R01C16	29-16-1	RanBP2deltaFG~N/A	317	35	282
B29R01C17	29-17-1	hMDM2~N/A	746	35	711
B29R01C18	29-18-1	hMDM2~N/A	720	36	684
B29R01C19	29-19-1	PKCeta~N/A	389	40	349
B29R01C20	29-20-1	PKCeta~N/A	389	42	347
B29R01C21	29-21-1	AlexaAntiMouseAb~N/A	31044	40	31004
B29R01C22	29-22-1	AlexaAntiMouseAb~N/A	33503	40	33463
B29R02C01	29-1-2	PKCeta~N/A	1203	38	1165
B29R02C02	29-2-2	PKCeta~N/A	1124	41	1083
B29R02C03	29-3-2	Buffer	341	37	304
B29R02C04	29-4-2	Buffer	372	44	328
B29R02C05	29-5-2	HumanIgA~N/A	17673	37	17636
B29R02C06	29-6-2	HumanIgA~N/A	18764	36	18728
B29R02C07	29-7-2	Buffer	115	38	77
B29R02C08	29-8-2	Buffer	112	37	75
B29R02C09	29-9-2	BSA~N/A	11037	40	10997
B29R02C10	29-10-2	BSA~N/A	10645	43	10602
B29R02C11	29-11-2	Hs~Ref:NM_152333.1~uORF:IOH41357	307	43	264
B29R02C12	29-12-2	Hs~Ref:NM_152333.1~uORF:IOH41357	400	39	361
B29R02C13	29-13-2	Hs~Ref:NM_017563.1~uORF:IOH43886	332	37	295
B29R02C14	29-14-2	Hs~Ref:NM_017563.1~uORF:IOH43886	296	37	259
B29R02C15	29-15-2	Hs~Ref:NM_014065.2~uORF:IOH43942	384	35	349
B29R02C16	29-16-2	Hs~Ref:NM_014065.2~uORF:IOH43942	373	36	337
B29R02C17	29-17-2	Hs~MGC:BC013883.1~uORF:IOH40593	253	42	211
B29R02C18	29-18-2	Hs~MGC:BC013883.1~uORF:IOH40593	277	56	221
B29R02C19	29-19-2	Hs~Ref:NM_016816.1~uORF:IOH41283	3119	41	3078
B29R02C20	29-20-2	Hs~Ref:NM_016816.1~uORF:IOH41283	3104	43	3061
B29R02C21	29-21-2	Hs~Ref:XM_209489.2~uORF:IOH44775	313	45	268
B29R02C22	29-22-2	Hs~Ref:XM_209489.2~uORF:IOH44775	340	39	301
B29R03C01	29-1-3	Hs~Ref:XM_211345.2~uORF:IOH41606	60	41	19
B29R03C02	29-2-3	Hs~Ref:XM_211345.2~uORF:IOH41606	287	56	231
B29R03C03	29-3-3	Hs~Ref:XM_378449.1~uORF:IOH42926	54	95	-41
B29R03C04	29-4-3	Hs~Ref:XM_378449.1~uORF:IOH42926	38	42	-4
B29R03C05	29-5-3	Hs~MGC:BC009182.1~uORF:IOH13497	98	42	56
B29R03C06	29-6-3	Hs~MGC:BC009182.1~uORF:IOH13497	124	42	82
B29R03C07	29-7-3	Hs~MGC:BC015323.1~uORF:IOH11084	539	44	495
B29R03C08	29-8-3	Hs~MGC:BC015323.1~uORF:IOH11084	573	169	404
B29R03C09	29-9-3	Hs~Ref:NM_017612.1~uORF:IOH11180	428	157	271
B29R03C10	29-10-3	Hs~Ref:NM_017612.1~uORF:IOH11180	395	267	128
B29R03C11	29-11-3	Hs~MGC:BC012945.1~uORF:IOH25802	311	266	45
B29R03C12	29-12-3	Hs~MGC:BC012945.1~uORF:IOH25802	344	48	296
B29R03C13	29-13-3	Hs~Ref:NM_031427.1~uORF:IOH7274	430	35	395
B29R03C14	29-14-3	Hs~Ref:NM_031427.1~uORF:IOH7274	431	36	395
B29R03C15	29-15-3	Hs~MGC:BC027866.1~uORF:IOH12025	1095	36	1059
B29R03C16	29-16-3	Hs~MGC:BC027866.1~uORF:IOH12025	1077	37	1040
B29R03C17	29-17-3	Hs~Ref:NM_007362.2~uORF:IOH3243	1824	38	1786
B29R03C18	29-18-3	Hs~Ref:NM_007362.2~uORF:IOH3243	1855	37	1818
B29R03C19	29-19-3	Hs~MGC:BC010900.1~uORF:IOH12898	377	37	340
B29R03C20	29-20-3	Hs~MGC:BC010900.1~uORF:IOH12898	394	38	356
B29R03C21	29-21-3	Hs~Ref:NM_005979.1~uORF:IOH1589	437	38	399
B29R03C22	29-22-3	Hs~Ref:NM_005979.1~uORF:IOH1589	426	35	391
B29R04C01	29-1-4	Hs~Ref:NM_001997.2~uORF:IOH1655	813	56	757
B29R04C02	29-2-4	Hs~Ref:NM_001997.2~uORF:IOH1655	673	93	580
B29R04C03	29-3-4	Hs~Ref:NM_001662.2~uORF:IOH1744	368	158	210
B29R04C04	29-4-4	Hs~Ref:NM_001662.2~uORF:IOH1744	140	75	65
B29R04C05	29-5-4	Hs~Ref:NM_001321.1~uORF:IOH1779	1734	41	1693
B29R04C06	29-6-4	Hs~Ref:NM_001321.1~uORF:IOH1779	1524	40	1484
B29R04C07	29-7-4	Hs~Ref:NM_004837.2~uORF:IOH7323	507	42	465
B29R04C08	29-8-4	Hs~Ref:NM_004837.2~uORF:IOH7323	503	42	461
B29R04C09	29-9-4	Hs~MGC:BC018995.2~uORF:IOH14243	133	38	95
B29R04C10	29-10-4	Hs~MGC:BC018995.2~uORF:IOH14243	437	88	349
B29R04C11	29-11-4	Hs~Ref:NM_013443.2~uORF:IOH6716	400	41	359
B29R04C12	29-12-4	Hs~Ref:NM_013443.2~uORF:IOH6716	397	42	355
B29R04C13	29-13-4	Hs~MGC:BC016308.1~uORF:IOH12905	128	35	93
B29R04C14	29-14-4	Hs~MGC:BC016308.1~uORF:IOH12905	198	58	140
B29R04C15	29-15-4	Hs~Ref:NM_012191.1~uORF:IOH5628	1382	40	1342
B29R04C16	29-16-4	Hs~Ref:NM_012191.1~uORF:IOH5628	1386	37	1349
B29R04C17	29-17-4	Hs~Ref:NM_001799.2~uORF:IOH3121	436	34	402
B29R04C18	29-18-4	Hs~Ref:NM_001799.2~uORF:IOH3121	446	34	412
B29R04C19	29-19-4	Hs~Ref:NM_014734.2~uORF:IOH39813	290	38	252
B29R04C20	29-20-4	Hs~Ref:NM_014734.2~uORF:IOH39813	269	109	160
B29R04C21	29-21-4	Hs~Ref:NM_016074.1~uORF:IOH39867	430	37	393
B29R04C22	29-22-4	Hs~Ref:NM_016074.1~uORF:IOH39867	402	35	367
B29R05C01	29-1-5	Hs~MGC:BC014532.1~uORF:IOH12798	3860	66	3794
B29R05C02	29-2-5	Hs~MGC:BC014532.1~uORF:IOH12798	3834	48	3786
B29R05C03	29-3-5	Hs~Ref:NM_016487.1~uORF:IOH12876	851	40	811
B29R05C04	29-4-5	Hs~Ref:NM_016487.1~uORF:IOH12876	850	36	814
B29R05C05	29-5-5	Hs~Ref:NM_005368.1~uORF:IOH12916	184	40	144
B29R05C06	29-6-5	Hs~Ref:NM_005368.1~uORF:IOH12916	170	41	129
B29R05C07	29-7-5	Hs~Ref:NM_014596.3~uORF:IOH12855	974	39	935
B29R05C08	29-8-5	Hs~Ref:NM_014596.3~uORF:IOH12855	898	39	859
B29R05C09	29-9-5	Hs~MGC:BC051688.1~uORF:IOH26513	63	49	14
B29R05C10	29-10-5	Hs~MGC:BC051688.1~uORF:IOH26513	219	74	145
B29R05C11	29-11-5	Hs~MGC:BC050645.1~uORF:IOH27032	861	38	823
B29R05C12	29-12-5	Hs~MGC:BC050645.1~uORF:IOH27032	828	36	792
B29R05C13	29-13-5	Hs~MGC:BC043391.1~uORF:IOH26414	3886	35	3851
B29R05C14	29-14-5	Hs~MGC:BC043391.1~uORF:IOH26414	3786	38	3748
B29R05C15	29-15-5	Hs~MGC:BC041158.1~uORF:IOH26191	245	40	205
B29R05C16	29-16-5	Hs~MGC:BC041158.1~uORF:IOH26191	266	55	211
B29R05C17	29-17-5	Hs~MGC:BC001108.1~uORF:IOH3845	723	35	688
B29R05C18	29-18-5	Hs~MGC:BC001108.1~uORF:IOH3845	758	35	723
B29R05C19	29-19-5	Hs~MGC:BC001697.1~uORF:IOH3864	450	36	414
B29R05C20	29-20-5	Hs~MGC:BC001697.1~uORF:IOH3864	450	38	412
B29R05C21	29-21-5	Hs~MGC:BC021093.1~uORF:IOH13303	221	49	172
B29R05C22	29-22-5	Hs~MGC:BC021093.1~uORF:IOH13303	273	41	232
B29R06C01	29-1-6	Hs~MGC:BC021927.1~uORF:IOH13479	1260	37	1223
B29R06C02	29-2-6	Hs~MGC:BC021927.1~uORF:IOH13479	1254	37	1217
B29R06C03	29-3-6	Hs~Ref:NM_147162.1~uORF:IOH45830	216	40	176
B29R06C04	29-4-6	Hs~Ref:NM_147162.1~uORF:IOH45830	107	35	72
B29R06C05	29-5-6	Hs~Ref:NM_024307.1~uORF:IOH45847	142	36	106
B29R06C06	29-6-6	Hs~Ref:NM_024307.1~uORF:IOH45847	135	38	97
B29R06C07	29-7-6	Hs~Ref:NM_198041.1~uORF:IOH45807	160	37	123
B29R06C08	29-8-6	Hs~Ref:NM_198041.1~uORF:IOH45807	151	37	114
B29R06C09	29-9-6	Hs~Ref:NM_182776.1~uORF:IOH45809	375	66	309
B29R06C10	29-10-6	Hs~Ref:NM_182776.1~uORF:IOH45809	100	36	64
B29R06C11	29-11-6	Hs~MGC:BC020726.1~uORF:IOH12969	2923	37	2886
B29R06C12	29-12-6	Hs~MGC:BC020726.1~uORF:IOH12969	3107	36	3071
B29R06C13	29-13-6	Hs~Ref:NM_005046.2~uORF:IOH22164	420	38	382
B29R06C14	29-14-6	Hs~Ref:NM_005046.2~uORF:IOH22164	374	38	336
B29R06C15	29-15-6	Hs~MGC:BC034696.1~uORF:IOH22151	472	37	435
B29R06C16	29-16-6	Hs~MGC:BC034696.1~uORF:IOH22151	472	37	435
B29R06C17	29-17-6	Hs~Ref:NM_005887.1~uORF:IOH45761	210	103	107
B29R06C18	29-18-6	Hs~Ref:NM_005887.1~uORF:IOH45761	182	132	50
B29R06C19	29-19-6	Hs~Ref:NM_152618.2~uORF:IOH55646	139	47	92
B29R06C20	29-20-6	Hs~Ref:NM_152618.2~uORF:IOH55646	72	37	35
B29R06C21	29-21-6	Hs~Ref:NM_181575.2~uORF:IOH56238	314	51	263
B29R06C22	29-22-6	Hs~Ref:NM_181575.2~uORF:IOH56238	182	63	119
B29R07C01	29-1-7	Hs~Ref:NM_001888.2~uORF:IOH56006	66	37	29
B29R07C02	29-2-7	Hs~Ref:NM_001888.2~uORF:IOH56006	60	38	22
B29R07C03	29-3-7	Hs~Ref:NM_002601.2~uORF:IOH56967	126	47	79
B29R07C04	29-4-7	Hs~Ref:NM_002601.2~uORF:IOH56967	111	41	70
B29R07C05	29-5-7	Hs~Ref:NM_024779.2~uORF:IOH11402	252	38	214
B29R07C06	29-6-7	Hs~Ref:NM_024779.2~uORF:IOH11402	238	41	197
B29R07C07	29-7-7	Hs~MGC:BC021278.1~uORF:IOH14591	130	41	89
B29R07C08	29-8-7	Hs~MGC:BC021278.1~uORF:IOH14591	111	40	71
B29R07C09	29-9-7	Hs~Ref:NM_144624.1~uORF:IOH14193	139	38	101
B29R07C10	29-10-7	Hs~Ref:NM_144624.1~uORF:IOH14193	201	73	128
B29R07C11	29-11-7	Hs~Ref:NM_002110.1~uORF:IOH21123	257	81	176
B29R07C12	29-12-7	Hs~Ref:NM_002110.1~uORF:IOH21123	104	38	66
B29R07C13	29-13-7	Hs~MGC:BC036327.1~uORF:IOH27334	364	40	324
B29R07C14	29-14-7	Hs~MGC:BC036327.1~uORF:IOH27334	385	39	346
B29R07C15	29-15-7	Hs~Ref:NM_152255.1~uORF:IOH39607	285	38	247
B29R07C16	29-16-7	Hs~Ref:NM_152255.1~uORF:IOH39607	283	41	242
B29R07C17	29-17-7	Hs~Ref:NM_006931.1~uORF:IOH25795	248	59	189
B29R07C18	29-18-7	Hs~Ref:NM_006931.1~uORF:IOH25795	318	57	261
B29R07C19	29-19-7	Hs~Ref:NM_004512.3~uORF:IOH39599	269	37	232
B29R07C20	29-20-7	Hs~Ref:NM_004512.3~uORF:IOH39599	271	107	164
B29R07C21	29-21-7	Hs~Ref:NM_004442.3~N/A	421	39	382
B29R07C22	29-22-7	Hs~Ref:NM_004442.3~N/A	374	37	337
B29R08C01	29-1-8	Hs~Ref:NM_004443.2~N/A	550	38	512
B29R08C02	29-2-8	Hs~Ref:NM_004443.2~N/A	515	37	478
B29R08C03	29-3-8	Hs~Ref:NM_004560.2~N/A	1003	40	963
B29R08C04	29-4-8	Hs~Ref:NM_004560.2~N/A	1023	38	985
B29R08C05	29-5-8	Hs~Ref:NM_001106.2~N/A	2186	39	2147
B29R08C06	29-6-8	Hs~Ref:NM_001106.2~N/A	2168	40	2128
B29R08C07	29-7-8	Hs~MGC:BC036098.1~uORF:IOH27221	103	44	59
B29R08C08	29-8-8	Hs~MGC:BC036098.1~uORF:IOH27221	105	43	62
B29R08C09	29-9-8	Hs~MGC:BC037547.1~uORF:IOH27538	340	41	299
B29R08C10	29-10-8	Hs~MGC:BC037547.1~uORF:IOH27538	432	39	393
B29R08C11	29-11-8	Hs~Ref:NM_018441.2~uORF:IOH4050	897	39	858
B29R08C12	29-12-8	Hs~Ref:NM_018441.2~uORF:IOH4050	793	41	752
B29R08C13	29-13-8	Hs~Ref:NM_006429.1~uORF:IOH14430	319	40	279
B29R08C14	29-14-8	Hs~Ref:NM_006429.1~uORF:IOH14430	300	40	260
B29R08C15	29-15-8	Hs~Ref:NM_001890.1~uORF:IOH44412	459	38	421
B29R08C16	29-16-8	Hs~Ref:NM_001890.1~uORF:IOH44412	478	37	441
B29R08C17	29-17-8	Hs~Ref:NM_007221.1~uORF:IOH45646	478	37	441
B29R08C18	29-18-8	Hs~Ref:NM_007221.1~uORF:IOH45646	466	38	428
B29R08C19	29-19-8	Hs~Ref:NM_203429.1~uORF:IOH44588	503	38	465
B29R08C20	29-20-8	Hs~Ref:NM_203429.1~uORF:IOH44588	509	43	466
B29R08C21	29-21-8	Hs~Ref:NM_181339.1~uORF:IOH45583	476	89	387
B29R08C22	29-22-8	Hs~Ref:NM_181339.1~uORF:IOH45583	434	45	389
B29R09C01	29-1-9	Hs~MGC:BC004818.2~uORF:IOH3016	224	163	61
B29R09C02	29-2-9	Hs~MGC:BC004818.2~uORF:IOH3016	198	37	161
B29R09C03	29-3-9	Hs~MGC:BC011951.1~uORF:IOH10439	124	36	88
B29R09C04	29-4-9	Hs~MGC:BC011951.1~uORF:IOH10439	133	36	97
B29R09C05	29-5-9	Hs~Ref:NM_000403.3~uORF:IOH3262	306	38	268
B29R09C06	29-6-9	Hs~Ref:NM_000403.3~uORF:IOH3262	293	38	255
B29R09C07	29-7-9	Hs~MGC:BC031870.2~uORF:IOH22046	351	162	189
B29R09C08	29-8-9	Hs~MGC:BC031870.2~uORF:IOH22046	355	152	203
B29R09C09	29-9-9	Hs~Ref:NM_016576.2~uORF:IOH6998	235	39	196
B29R09C10	29-10-9	Hs~Ref:NM_016576.2~uORF:IOH6998	295	44	251
B29R09C11	29-11-9	Hs~Ref:NM_014066.2~uORF:IOH4943	224	95	129
B29R09C12	29-12-9	Hs~Ref:NM_014066.2~uORF:IOH4943	252	160	92
B29R09C13	29-13-9	Hs~MGC:BC006470.1~uORF:IOH6015	271	111	160
B29R09C14	29-14-9	Hs~MGC:BC006470.1~uORF:IOH6015	386	90	296
B29R09C15	29-15-9	Hs~MGC:BC040276.1~uORF:IOH27380	229	37	192
B29R09C16	29-16-9	Hs~MGC:BC040276.1~uORF:IOH27380	248	45	203
B29R09C17	29-17-9	Hs~MGC:BC001121.2~uORF:IOH46072	179	88	91
B29R09C18	29-18-9	Hs~MGC:BC001121.2~uORF:IOH46072	216	51	165
B29R09C19	29-19-9	Hs~Ref:NM_001005910.1~uORF:IOH46074	251	59	192
B29R09C20	29-20-9	Hs~Ref:NM_001005910.1~uORF:IOH46074	150	41	109
B29R09C21	29-21-9	Hs~MGC:BC019039.2~uORF:IOH46089	2884	58	2826
B29R09C22	29-22-9	Hs~MGC:BC019039.2~uORF:IOH46089	2768	43	2725
B29R10C01	29-1-10	Hs~MGC:BC022199.2~uORF:IOH46088	177	36	141
B29R10C02	29-2-10	Hs~MGC:BC022199.2~uORF:IOH46088	164	37	127
B29R10C03	29-3-10	Hs~Ref:NM_014613.1~uORF:IOH40633	202	37	165
B29R10C04	29-4-10	Hs~Ref:NM_014613.1~uORF:IOH40633	197	38	159
B29R10C05	29-5-10	Hs~Ref:NM_002297.2~uORF:IOH40729	99	37	62
B29R10C06	29-6-10	Hs~Ref:NM_002297.2~uORF:IOH40729	101	41	60
B29R10C07	29-7-10	Hs~MGC:BC064512.1~uORF:IOH40668	412	44	368
B29R10C08	29-8-10	Hs~MGC:BC064512.1~uORF:IOH40668	513	269	244
B29R10C09	29-9-10	Hs~Ref:NM_153694.3~uORF:IOH40756	307	39	268
B29R10C10	29-10-10	Hs~Ref:NM_153694.3~uORF:IOH40756	408	67	341
B29R10C11	29-11-10	GST1	39	38	1
B29R10C12	29-12-10	GST1	37	39	-2
B29R10C13	29-13-10	GST2	40	36	4
B29R10C14	29-14-10	GST2	41	35	6
B29R10C15	29-15-10	GST3	44	36	8
B29R10C16	29-16-10	GST3	44	39	5
B29R10C17	29-17-10	GST4	62	37	25
B29R10C18	29-18-10	GST4	55	37	18
B29R10C19	29-19-10	Anti-HumanIgA1~N/A	8240	37	8203
B29R10C20	29-20-10	Anti-HumanIgA1~N/A	8177	41	8136
B29R10C21	29-21-10	Anti-HumanIgA2~N/A	15386	53	15333
B29R10C22	29-22-10	Anti-HumanIgA2~N/A	14579	45	14534
B29R11C01	29-1-11	AlexaAntiMouseAb~N/A	20651	41	20610
B29R11C02	29-2-11	AlexaAntiMouseAb~N/A	19609	38	19571
B29R11C03	29-3-11	MAPKAP~N/A	64	36	28
B29R11C04	29-4-11	MAPKAP~N/A	59	36	23
B29R11C05	29-5-11	Buffer	1553	36	1517
B29R11C06	29-6-11	Buffer	1553	38	1515
B29R11C07	29-7-11	BSA~N/A	7099	40	7059
B29R11C08	29-8-11	BSA~N/A	7094	41	7053
B29R11C09	29-9-11	Anti-HumanIgG1~N/A	1486	40	1446
B29R11C10	29-10-11	Anti-HumanIgG1~N/A	1485	41	1444
B29R11C11	29-11-11	Anti-HumanIgG2~N/A	2767	44	2723
B29R11C12	29-12-11	Anti-HumanIgG2~N/A	2673	45	2628
B29R11C13	29-13-11	Anti-HumanIgG3~N/A	5115	39	5076
B29R11C14	29-14-11	Anti-HumanIgG3~N/A	5024	36	4988
B29R11C15	29-15-11	Anti-HumanIgG4~N/A	9616	37	9579
B29R11C16	29-16-11	Anti-HumanIgG4~N/A	9696	41	9655
B29R11C17	29-17-11	AntiBiotinAb~N/A	11736	44	11692
B29R11C18	29-18-11	AntiBiotinAb~N/A	11337	41	11296
B29R11C19	29-19-11	Buffer	62	35	27
B29R11C20	29-20-11	Buffer	55	38	17
B29R11C21	29-21-11	Hs~Ref:NM_014038.1~uORF:IOH7437	330	64	266
B29R11C22	29-22-11	Hs~Ref:NM_014038.1~uORF:IOH7437	309	150	159
B29R12C01	29-1-12	Hs~MGC:BC005359.1~uORF:IOH7294	148	46	102
B29R12C02	29-2-12	Hs~MGC:BC005359.1~uORF:IOH7294	152	44	108
B29R12C03	29-3-12	Hs~MGC:BC007460.1~uORF:IOH7350	74	43	31
B29R12C04	29-4-12	Hs~MGC:BC007460.1~uORF:IOH7350	120	36	84
B29R12C05	29-5-12	Hs~MGC:BC033728.1~uORF:IOH21800	179	36	143
B29R12C06	29-6-12	Hs~MGC:BC033728.1~uORF:IOH21800	176	38	138
B29R12C07	29-7-12	Hs~Ref:NM_004567.2~uORF:IOH10913	823	38	785
B29R12C08	29-8-12	Hs~Ref:NM_004567.2~uORF:IOH10913	833	42	791
B29R12C09	29-9-12	Hs~Ref:NM_002197.1~uORF:IOH11817	296	45	251
B29R12C10	29-10-12	Hs~Ref:NM_002197.1~uORF:IOH11817	307	43	264
B29R12C11	29-11-12	Hs~MGC:NM_152576.1~uORF:IOH23047	186	54	132
B29R12C12	29-12-12	Hs~MGC:NM_152576.1~uORF:IOH23047	174	56	118
B29R12C13	29-13-12	Hs~Ref:NM_006831.1~uORF:IOH3500	526	52	474
B29R12C14	29-14-12	Hs~Ref:NM_006831.1~uORF:IOH3500	523	44	479
B29R12C15	29-15-12	Hs~Ref:NM_001003938.2~uORF:IOH45603	730	37	693
B29R12C16	29-16-12	Hs~Ref:NM_001003938.2~uORF:IOH45603	777	40	737
B29R12C17	29-17-12	Hs~Ref:NM_017592.1~uORF:IOH44564	6303	48	6255
B29R12C18	29-18-12	Hs~Ref:NM_017592.1~uORF:IOH44564	6488	45	6443
B29R12C19	29-19-12	Hs~Ref:NM_001001653.1~uORF:IOH45566	354	39	315
B29R12C20	29-20-12	Hs~Ref:NM_001001653.1~uORF:IOH45566	344	39	305
B29R12C21	29-21-12	Hs~Ref:NM_032385.1~uORF:IOH45875	761	39	722
B29R12C22	29-22-12	Hs~Ref:NM_032385.1~uORF:IOH45875	690	37	653
B29R13C01	29-1-13	Hs~Ref:NM_005651.1~uORF:IOH7291	699	39	660
B29R13C02	29-2-13	Hs~Ref:NM_005651.1~uORF:IOH7291	616	43	573
B29R13C03	29-3-13	Hs~MGC:BC012616.1~uORF:IOH13744	594	75	519
B29R13C04	29-4-13	Hs~MGC:BC012616.1~uORF:IOH13744	488	43	445
B29R13C05	29-5-13	Hs~MGC:BC005065.1~uORF:IOH6560	275	43	232
B29R13C06	29-6-13	Hs~MGC:BC005065.1~uORF:IOH6560	563	69	494
B29R13C07	29-7-13	Hs~MGC:BC034014.1~uORF:IOH22132	57	41	16
B29R13C08	29-8-13	Hs~MGC:BC034014.1~uORF:IOH22132	104	46	58
B29R13C09	29-9-13	Hs~Ref:NM_020468.2~uORF:IOH45873	337	235	102
B29R13C10	29-10-13	Hs~Ref:NM_020468.2~uORF:IOH45873	281	64	217
B29R13C11	29-11-13	Hs~Ref:NM_020417.1~uORF:IOH46271	503	223	280
B29R13C12	29-12-13	Hs~Ref:NM_020417.1~uORF:IOH46271	464	57	407
B29R13C13	29-13-13	Hs~Ref:NM_000475.3~uORF:IOH12506	493	71	422
B29R13C14	29-14-13	Hs~Ref:NM_000475.3~uORF:IOH12506	485	54	431
B29R13C15	29-15-13	Hs~Ref:NM_002863.3~uORF:IOH61143	380	40	340
B29R13C16	29-16-13	Hs~Ref:NM_002863.3~uORF:IOH61143	402	39	363
B29R13C17	29-17-13	Hs~Ref:NM_001646.1~uORF:IOH14363	439	39	400
B29R13C18	29-18-13	Hs~Ref:NM_001646.1~uORF:IOH14363	452	38	414
B29R13C19	29-19-13	Hs~MGC:BC007514.1~uORF:IOH6107	313	46	267
B29R13C20	29-20-13	Hs~MGC:BC007514.1~uORF:IOH6107	311	152	159
B29R13C21	29-21-13	Hs~Ref:NM_002647.1~uORF:IOH21022	436	41	395
B29R13C22	29-22-13	Hs~Ref:NM_002647.1~uORF:IOH21022	408	40	368
B29R14C01	29-1-14	Hs~Ref:NM_006496.1~uORF:IOH14567	268	37	231
B29R14C02	29-2-14	Hs~Ref:NM_006496.1~uORF:IOH14567	555	143	412
B29R14C03	29-3-14	Hs~Ref:NM_139049.1~uORF:IOH53990	162	39	123
B29R14C04	29-4-14	Hs~Ref:NM_139049.1~uORF:IOH53990	182	38	144
B29R14C05	29-5-14	Hs~Ref:NM_002121.4~uORF:IOH53875	124	38	86
B29R14C06	29-6-14	Hs~Ref:NM_002121.4~uORF:IOH53875	114	40	74
B29R14C07	29-7-14	Hs~Ref:NM_000893.2~uORF:IOH53988	184	96	88
B29R14C08	29-8-14	Hs~Ref:NM_000893.2~uORF:IOH53988	110	39	71
B29R14C09	29-9-14	Hs~Ref:NM_005870.3~uORF:IOH53845	746	42	704
B29R14C10	29-10-14	Hs~Ref:NM_005870.3~uORF:IOH53845	768	39	729
B29R14C11	29-11-14	Hs~Ref:NM_006570.2~uORF:IOH6617	426	37	389
B29R14C12	29-12-14	Hs~Ref:NM_006570.2~uORF:IOH6617	434	38	396
B29R14C13	29-13-14	Hs~MGC:BC009012.1~uORF:IOH3329	709	39	670
B29R14C14	29-14-14	Hs~MGC:BC009012.1~uORF:IOH3329	669	36	633
B29R14C15	29-15-14	Hs~Ref:NM_018184.1~uORF:IOH11083	1801	36	1765
B29R14C16	29-16-14	Hs~Ref:NM_018184.1~uORF:IOH11083	1628	36	1592
B29R14C17	29-17-14	Hs~Ref:NM_024619.2~uORF:IOH6899	201	43	158
B29R14C18	29-18-14	Hs~Ref:NM_024619.2~uORF:IOH6899	275	40	235
B29R14C19	29-19-14	Hs~MGC:BC012760.2~uORF:IOH62834	1139	41	1098
B29R14C20	29-20-14	Hs~MGC:BC012760.2~uORF:IOH62834	1133	40	1093
B29R14C21	29-21-14	Hs~MGC:BC066642.1~uORF:IOH62938	60049	40	60009
B29R14C22	29-22-14	Hs~MGC:BC066642.1~uORF:IOH62938	58238	37	58201
B29R15C01	29-1-15	Hs~MGC:BC068536.1~uORF:IOH61685	40	41	-1
B29R15C02	29-2-15	Hs~MGC:BC068536.1~uORF:IOH61685	56	44	12
B29R15C03	29-3-15	Hs~MGC:BC074501.1~uORF:IOH61735	170	39	131
B29R15C04	29-4-15	Hs~MGC:BC074501.1~uORF:IOH61735	147	40	107
B29R15C05	29-5-15	Hs~MGC:BC058833.1~uORF:IOH29475	130	37	93
B29R15C06	29-6-15	Hs~MGC:BC058833.1~uORF:IOH29475	38	49	-11
B29R15C07	29-7-15	Hs~MGC:BC059396.1~uORF:IOH29258	119	41	78
B29R15C08	29-8-15	Hs~MGC:BC059396.1~uORF:IOH29258	119	42	77
B29R15C09	29-9-15	Hs~MGC:BC046449.1~uORF:IOH28670	243	175	68
B29R15C10	29-10-15	Hs~MGC:BC046449.1~uORF:IOH28670	125	40	85
B29R15C11	29-11-15	Hs~MGC:BC054023.1~uORF:IOH29482	82	56	26
B29R15C12	29-12-15	Hs~MGC:BC054023.1~uORF:IOH29482	163	75	88
B29R15C13	29-13-15	Hs~IVGN:PM_2147~Ext:dsDNA_genomic~N/A	40	38	2
B29R15C14	29-14-15	Hs~IVGN:PM_2147~Ext:dsDNA_genomic~N/A	40	36	4
B29R15C15	29-15-15	Hs~Ref:NM_001260.1~CAT:PV4402	581	36	545
B29R15C16	29-16-15	Hs~Ref:NM_001260.1~CAT:PV4402	583	36	547
B29R15C17	29-17-15	Hs~Ref:NM_000222.1~CAT:PV3869	370	36	334
B29R15C18	29-18-15	Hs~Ref:NM_000222.1~CAT:PV3869	359	35	324
B29R15C19	29-19-15	Hs~MGC:NM_014215.1~CAT:PV3808	135	94	41
B29R15C20	29-20-15	Hs~MGC:NM_014215.1~CAT:PV3808	174	117	57
B29R15C21	29-21-15	Hs~Ref:NM_005246.1~CAT:PV3806	221	57	164
B29R15C22	29-22-15	Hs~Ref:NM_005246.1~CAT:PV3806	179	49	130
B29R16C01	29-1-16	Hs~Ref:NM_005157.2~CAT:PV3864	168	40	128
B29R16C02	29-2-16	Hs~Ref:NM_005157.2~CAT:PV3864	164	40	124
B29R16C03	29-3-16	Hs~IVGN:NM_003867~CAT_PHG0224~N/A	51	42	9
B29R16C04	29-4-16	Hs~IVGN:NM_003867~CAT_PHG0224~N/A	120	40	80
B29R16C05	29-5-16	Hs~Ref:NM_000020.1~CAT:PV4883	340	39	301
B29R16C06	29-6-16	Hs~Ref:NM_000020.1~CAT:PV4883	79	41	38
B29R16C07	29-7-16	Hs~MGC:BC050543.1~uORF:IOH26964	498	39	459
B29R16C08	29-8-16	Hs~MGC:BC050543.1~uORF:IOH26964	491	38	453
B29R16C09	29-9-16	Hs~MGC:BC099905.1~uORF:IOH62630	653	40	613
B29R16C10	29-10-16	Hs~MGC:BC099905.1~uORF:IOH62630	673	38	635
B29R16C11	29-11-16	Hs~MGC:BC071703.1~uORF:IOH61781	311	40	271
B29R16C12	29-12-16	Hs~MGC:BC071703.1~uORF:IOH61781	274	38	236
B29R16C13	29-13-16	Hs~MGC:BC063439.1~uORF:IOH61534	136	42	94
B29R16C14	29-14-16	Hs~MGC:BC063439.1~uORF:IOH61534	215	134	81
B29R16C15	29-15-16	Hs~Ref:NM_139208.1~uORF:IOH29573	326	50	276
B29R16C16	29-16-16	Hs~Ref:NM_139208.1~uORF:IOH29573	391	42	349
B29R16C17	29-17-16	Hs~Ref:NM_016563.1~uORF:IOH29600	1157	37	1120
B29R16C18	29-18-16	Hs~Ref:NM_016563.1~uORF:IOH29600	1178	36	1142
B29R16C19	29-19-16	Hs~MGC:BC054501.1~uORF:IOH28879	868	37	831
B29R16C20	29-20-16	Hs~MGC:BC054501.1~uORF:IOH28879	815	41	774
B29R16C21	29-21-16	Hs~Ref:NM_003955.2~uORF:IOH29563	18488	64	18424
B29R16C22	29-22-16	Hs~Ref:NM_003955.2~uORF:IOH29563	18181	43	18138
B29R17C01	29-1-17	Hs~Ref:NM_002443.2~uORF:IOH7298	757	453	304
B29R17C02	29-2-17	Hs~Ref:NM_002443.2~uORF:IOH7298	1154	45	1109
B29R17C03	29-3-17	Hs~Ref:NM_144706.1~uORF:IOH12734	663	42	621
B29R17C04	29-4-17	Hs~Ref:NM_144706.1~uORF:IOH12734	515	48	467
B29R17C05	29-5-17	Hs~MGC:BC022483.1~uORF:IOH11130	1042	107	935
B29R17C06	29-6-17	Hs~MGC:BC022483.1~uORF:IOH11130	913	40	873
B29R17C07	29-7-17	Hs~MGC:NM_005533.2~uORF:IOH3930	683	38	645
B29R17C08	29-8-17	Hs~MGC:NM_005533.2~uORF:IOH3930	753	36	717
B29R17C09	29-9-17	Hs~Ref:NM_000978.2~uORF:IOH13951	102	36	66
B29R17C10	29-10-17	Hs~Ref:NM_000978.2~uORF:IOH13951	112	36	76
B29R17C11	29-11-17	Hs~Ref:NM_031286.1~uORF:IOH22976	104	35	69
B29R17C12	29-12-17	Hs~Ref:NM_031286.1~uORF:IOH22976	123	66	57
B29R17C13	29-13-17	Hs~MGC:BC007815.1~uORF:IOH6757	92	40	52
B29R17C14	29-14-17	Hs~MGC:BC007815.1~uORF:IOH6757	132	51	81
B29R17C15	29-15-17	Hs~Ref:NM_002013.2~uORF:IOH14109	402	49	353
B29R17C16	29-16-17	Hs~Ref:NM_002013.2~uORF:IOH14109	411	46	365
B29R17C17	29-17-17	Hs~Ref:NM_024348.2~uORF:IOH3523	277	40	237
B29R17C18	29-18-17	Hs~Ref:NM_024348.2~uORF:IOH3523	324	38	286
B29R17C19	29-19-17	Hs~MGC:BC000884.1~uORF:IOH3230	311	44	267
B29R17C20	29-20-17	Hs~MGC:BC000884.1~uORF:IOH3230	307	44	263
B29R17C21	29-21-17	Hs~MGC:BC001426.1~uORF:IOH4083	326	167	159
B29R17C22	29-22-17	Hs~MGC:BC001426.1~uORF:IOH4083	291	43	248
B29R18C01	29-1-18	Hs~MGC:BC016582.1~uORF:IOH9793	178	50	128
B29R18C02	29-2-18	Hs~MGC:BC016582.1~uORF:IOH9793	264	57	207
B29R18C03	29-3-18	Hs~Ref:NM_006232.2~uORF:IOH4626	289	91	198
B29R18C04	29-4-18	Hs~Ref:NM_006232.2~uORF:IOH4626	290	43	247
B29R18C05	29-5-18	Hs~MGC:NM_152715.1~uORF:IOH21462	323	42	281
B29R18C06	29-6-18	Hs~MGC:NM_152715.1~uORF:IOH21462	323	41	282
B29R18C07	29-7-18	Hs~MGC:BC016486.1~uORF:IOH21471	593	41	552
B29R18C08	29-8-18	Hs~MGC:BC016486.1~uORF:IOH21471	611	40	571
B29R18C09	29-9-18	Hs~MGC:BC001671.1~uORF:IOH3723	339	39	300
B29R18C10	29-10-18	Hs~MGC:BC001671.1~uORF:IOH3723	293	41	252
B29R18C11	29-11-18	Hs~MGC:BC056147.1~uORF:IOH29115	336	35	301
B29R18C12	29-12-18	Hs~MGC:BC056147.1~uORF:IOH29115	374	38	336
B29R18C13	29-13-18	Hs~Ref:NM_181714.1~uORF:IOH26433	921	37	884
B29R18C14	29-14-18	Hs~Ref:NM_181714.1~uORF:IOH26433	881	37	844
B29R18C15	29-15-18	Hs~MGC:BC056911.1~uORF:IOH29120	3833	43	3790
B29R18C16	29-16-18	Hs~MGC:BC056911.1~uORF:IOH29120	3784	45	3739
B29R18C17	29-17-18	Hs~Ref:NM_001715.2~uORF:IOH57009	516	42	474
B29R18C18	29-18-18	Hs~Ref:NM_001715.2~uORF:IOH57009	520	38	482
B29R18C19	29-19-18	Hs~Ref:NM_022156.3~uORF:IOH39856	951	37	914
B29R18C20	29-20-18	Hs~Ref:NM_022156.3~uORF:IOH39856	921	38	883
B29R18C21	29-21-18	Hs~Ref:NM_080388.1~uORF:IOH10271	506	41	465
B29R18C22	29-22-18	Hs~Ref:NM_080388.1~uORF:IOH10271	463	36	427
B29R19C01	29-1-19	Hs~MGC:BC031262.1~uORF:IOH21607	1851	49	1802
B29R19C02	29-2-19	Hs~MGC:BC031262.1~uORF:IOH21607	1826	45	1781
B29R19C03	29-3-19	Hs~Ref:NM_003981.2~uORF:IOH5138	58	37	21
B29R19C04	29-4-19	Hs~Ref:NM_003981.2~uORF:IOH5138	35	36	-1
B29R19C05	29-5-19	Hs~Ref:NM_032301.1~uORF:IOH5507	367	38	329
B29R19C06	29-6-19	Hs~Ref:NM_032301.1~uORF:IOH5507	613	238	375
B29R19C07	29-7-19	Hs~Ref:NM_000910.1~uORF:IOH28389	503	46	457
B29R19C08	29-8-19	Hs~Ref:NM_000910.1~uORF:IOH28389	287	38	249
B29R19C09	29-9-19	Hs~Ref:NM_052819.1~uORF:IOH3124	352	41	311
B29R19C10	29-10-19	Hs~Ref:NM_052819.1~uORF:IOH3124	431	40	391
B29R19C11	29-11-19	Hs~Ref:NM_022788.2~uORF:IOH12543	477	35	442
B29R19C12	29-12-19	Hs~Ref:NM_022788.2~uORF:IOH12543	446	35	411
B29R19C13	29-13-19	Hs~MGC:BC002510.2~uORF:IOH3936	386	35	351
B29R19C14	29-14-19	Hs~MGC:BC002510.2~uORF:IOH3936	402	38	364
B29R19C15	29-15-19	Hs~MGC:BC036364.1~uORF:IOH45976	381	47	334
B29R19C16	29-16-19	Hs~MGC:BC036364.1~uORF:IOH45976	391	54	337
B29R19C17	29-17-19	Hs~Ref:NM_018132.3~uORF:IOH45979	611	48	563
B29R19C18	29-18-19	Hs~Ref:NM_018132.3~uORF:IOH45979	577	41	536
B29R19C19	29-19-19	Hs~Ref:NM_018276.2~uORF:IOH43518	360	36	324
B29R19C20	29-20-19	Hs~Ref:NM_018276.2~uORF:IOH43518	349	36	313
B29R19C21	29-21-19	Hs~Ref:NM_004545.1~uORF:IOH9964	5851	37	5814
B29R19C22	29-22-19	Hs~Ref:NM_004545.1~uORF:IOH9964	5760	35	5725
B29R20C01	29-1-20	Hs~MGC:BC008624.1~uORF:IOH9639	8595	42	8553
B29R20C02	29-2-20	Hs~MGC:BC008624.1~uORF:IOH9639	8513	39	8474
B29R20C03	29-3-20	Hs~MGC:BC010498.1~uORF:IOH10180	278	39	239
B29R20C04	29-4-20	Hs~MGC:BC010498.1~uORF:IOH10180	395	63	332
B29R20C05	29-5-20	Hs~MGC:BC016464.1~uORF:IOH10216	435	40	395
B29R20C06	29-6-20	Hs~MGC:BC016464.1~uORF:IOH10216	736	44	692
B29R20C07	29-7-20	Hs~Ref:NM_012394.2~uORF:IOH10683	207	36	171
B29R20C08	29-8-20	Hs~Ref:NM_012394.2~uORF:IOH10683	186	38	148
B29R20C09	29-9-20	Hs~Ref:NM_032353.1~uORF:IOH6304	243	41	202
B29R20C10	29-10-20	Hs~Ref:NM_032353.1~uORF:IOH6304	225	40	185
B29R20C11	29-11-20	Hs~Ref:NM_013230.1~uORF:IOH5911	1304	34	1270
B29R20C12	29-12-20	Hs~Ref:NM_013230.1~uORF:IOH5911	1283	34	1249
B29R20C13	29-13-20	Hs~MGC:BC015207.1~uORF:IOH11738	2922	34	2888
B29R20C14	29-14-20	Hs~MGC:BC015207.1~uORF:IOH11738	3022	34	2988
B29R20C15	29-15-20	Hs~Ref:NM_014626.1~uORF:IOH28367	352	39	313
B29R20C16	29-16-20	Hs~Ref:NM_014626.1~uORF:IOH28367	398	42	356
B29R20C17	29-17-20	Hs~MGC:BC035797.1~uORF:IOH28751	489	46	443
B29R20C18	29-18-20	Hs~MGC:BC035797.1~uORF:IOH28751	461	41	420
B29R20C19	29-19-20	Hs~MGC:BC017200.1~uORF:IOH27779	274	36	238
B29R20C20	29-20-20	Hs~MGC:BC017200.1~uORF:IOH27779	347	78	269
B29R20C21	29-21-20	Hs~MGC:BC010015.1~uORF:IOH14385	406	63	343
B29R20C22	29-22-20	Hs~MGC:BC010015.1~uORF:IOH14385	449	45	404
B29R21C01	29-1-21	Hs~Ref:NM_006581.2~uORF:IOH27236	81	35	46
B29R21C02	29-2-21	Hs~Ref:NM_006581.2~uORF:IOH27236	91	36	55
B29R21C03	29-3-21	Hs~Ref:NM_152447.2~uORF:IOH25841	82	36	46
B29R21C04	29-4-21	Hs~Ref:NM_152447.2~uORF:IOH25841	97	37	60
B29R21C05	29-5-21	Hs~Ref:NM_024726.3~uORF:IOH26335	140	36	104
B29R21C06	29-6-21	Hs~Ref:NM_024726.3~uORF:IOH26335	337	41	296
B29R21C07	29-7-21	Hs~MGC:BC052800.1~uORF:IOH29366	180	35	145
B29R21C08	29-8-21	Hs~MGC:BC052800.1~uORF:IOH29366	105	52	53
B29R21C09	29-9-21	Hs~Ref:NP_000556.1~CAT_10398-H08H-25	138	37	101
B29R21C10	29-10-21	Hs~Ref:NP_000556.1~CAT_10398-H08H-25	51	39	12
B29R21C11	29-11-21	Internal_1007209	36	34	2
B29R21C12	29-12-21	Internal_1007209	37	33	4
B29R21C13	29-13-21	Hs~Ref:Q5ZPR3-1~CAT_11188-H08H-25	34	33	1
B29R21C14	29-14-21	Hs~Ref:Q5ZPR3-1~CAT_11188-H08H-25	34	33	1
B29R21C15	29-15-21	Internal_1007209	42	34	8
B29R21C16	29-16-21	Internal_1007209	43	34	9
B29R21C17	29-17-21	Hs~Ref:NP_000582.1~CAT_10073-H01H-25	11390	38	11352
B29R21C18	29-18-21	Hs~Ref:NP_000582.1~CAT_10073-H01H-25	12969	36	12933
B29R21C19	29-19-21	Internal_1007209	41	34	7
B29R21C20	29-20-21	Internal_1007209	41	35	6
B29R21C21	29-21-21	Hs~Ref:NP_000600.1~CAT_PHC1361	43838	44	43794
B29R21C22	29-22-21	Hs~Ref:NP_000600.1~CAT_PHC1361	44468	40	44428
B29R22C01	29-1-22	ERa~N/A	2477	36	2441
B29R22C02	29-2-22	ERa~N/A	2474	36	2438
B29R22C03	29-3-22	PKCeta~N/A	50	39	11
B29R22C04	29-4-22	PKCeta~N/A	35	37	-2
B29R22C05	29-5-22	Calmodulin~N/A	249	106	143
B29R22C06	29-6-22	Calmodulin~N/A	142	38	104
B29R22C07	29-7-22	V5control5~N/A	1225	36	1189
B29R22C08	29-8-22	V5control5~N/A	1247	37	1210
B29R22C09	29-9-22	V5control4~N/A	98	36	62
B29R22C10	29-10-22	V5control4~N/A	121	43	78
B29R22C11	29-11-22	V5control3~N/A	153	49	104
B29R22C12	29-12-22	V5control3~N/A	59	36	23
B29R22C13	29-13-22	V5control2~N/A	66	42	24
B29R22C14	29-14-22	V5control2~N/A	67	38	29
B29R22C15	29-15-22	V5control1~N/A	40	35	5
B29R22C16	29-16-22	V5control1~N/A	40	34	6
B29R22C17	29-17-22	CMK2A~N/A	552	34	518
B29R22C18	29-18-22	CMK2A~N/A	551	33	518
B29R22C19	29-19-22	ERa~N/A	1944	33	1911
B29R22C20	29-20-22	ERa~N/A	1967	34	1933
B29R22C21	29-21-22	AlexaAntiMouseAb~N/A	8913	36	8877
B29R22C22	29-22-22	AlexaAntiMouseAb~N/A	9364	37	9327
B30R01C01	30-1-1	AlexaAntiMouseAb~N/A	31418	37	31381
B30R01C02	30-2-1	AlexaAntiMouseAb~N/A	34497	37	34460
B30R01C03	30-3-1	ERa~N/A	1818	36	1782
B30R01C04	30-4-1	ERa~N/A	1859	38	1821
B30R01C05	30-5-1	HumanIgG1~N/A	918	51	867
B30R01C06	30-6-1	HumanIgG1~N/A	1594	53	1541
B30R01C07	30-7-1	HumanIgG2~N/A	3985	52	3933
B30R01C08	30-8-1	HumanIgG2~N/A	3655	50	3605
B30R01C09	30-9-1	HumanIgG3~N/A	18505	49	18456
B30R01C10	30-10-1	HumanIgG3~N/A	18282	48	18234
B30R01C11	30-11-1	HumanIgG4~N/A	52202	52	52150
B30R01C12	30-12-1	HumanIgG4~N/A	50402	60	50342
B30R01C13	30-13-1	BiotinAb~N/A	403	57	346
B30R01C14	30-14-1	BiotinAb~N/A	453	48	405
B30R01C15	30-15-1	RanBP2deltaFG~N/A	354	45	309
B30R01C16	30-16-1	RanBP2deltaFG~N/A	344	45	299
B30R01C17	30-17-1	hMDM2~N/A	860	42	818
B30R01C18	30-18-1	hMDM2~N/A	846	42	804
B30R01C19	30-19-1	PKCeta~N/A	510	47	463
B30R01C20	30-20-1	PKCeta~N/A	518	48	470
B30R01C21	30-21-1	AlexaAntiMouseAb~N/A	34858	46	34812
B30R01C22	30-22-1	AlexaAntiMouseAb~N/A	37448	47	37401
B30R02C01	30-1-2	PKCeta~N/A	1574	38	1536
B30R02C02	30-2-2	PKCeta~N/A	1595	38	1557
B30R02C03	30-3-2	Buffer	377	37	340
B30R02C04	30-4-2	Buffer	370	226	144
B30R02C05	30-5-2	HumanIgA~N/A	23928	51	23877
B30R02C06	30-6-2	HumanIgA~N/A	25429	55	25374
B30R02C07	30-7-2	Buffer	568	65	503
B30R02C08	30-8-2	Buffer	140	51	89
B30R02C09	30-9-2	BSA~N/A	14260	48	14212
B30R02C10	30-10-2	BSA~N/A	14058	46	14012
B30R02C11	30-11-2	Hs~MGC:BC004242.1~uORF:IOH5508	1332	51	1281
B30R02C12	30-12-2	Hs~MGC:BC004242.1~uORF:IOH5508	1433	60	1373
B30R02C13	30-13-2	Hs~MGC:BC013795.1~uORF:IOH11405	820	60	760
B30R02C14	30-14-2	Hs~MGC:BC013795.1~uORF:IOH11405	773	52	721
B30R02C15	30-15-2	Hs~MGC:NM_174942.1~uORF:IOH26291	1459	46	1413
B30R02C16	30-16-2	Hs~MGC:NM_174942.1~uORF:IOH26291	1358	45	1313
B30R02C17	30-17-2	Hs~MGC:BC025714.1~uORF:IOH11342	731	44	687
B30R02C18	30-18-2	Hs~MGC:BC025714.1~uORF:IOH11342	723	47	676
B30R02C19	30-19-2	Hs~MGC:BC011563.1~uORF:IOH12467	149	132	17
B30R02C20	30-20-2	Hs~MGC:BC011563.1~uORF:IOH12467	345	65	280
B30R02C21	30-21-2	Hs~Ref:NM_004214.3~uORF:IOH2103	592	52	540
B30R02C22	30-22-2	Hs~Ref:NM_004214.3~uORF:IOH2103	545	50	495
B30R03C01	30-1-3	Hs~Ref:NM_006463.2~uORF:IOH2225	640	37	603
B30R03C02	30-2-3	Hs~Ref:NM_006463.2~uORF:IOH2225	635	43	592
B30R03C03	30-3-3	Hs~MGC:BC020647.1~uORF:IOH12765	439	52	387
B30R03C04	30-4-3	Hs~MGC:BC020647.1~uORF:IOH12765	345	54	291
B30R03C05	30-5-3	Hs~Ref:NM_032602.1~uORF:IOH35940	187	56	131
B30R03C06	30-6-3	Hs~Ref:NM_032602.1~uORF:IOH35940	391	59	332
B30R03C07	30-7-3	Hs~Ref:NM_030911.1~uORF:IOH41011	283	54	229
B30R03C08	30-8-3	Hs~Ref:NM_030911.1~uORF:IOH41011	362	106	256
B30R03C09	30-9-3	Hs~Ref:NM_020662.1~uORF:IOH37719	187	49	138
B30R03C10	30-10-3	Hs~Ref:NM_020662.1~uORF:IOH37719	160	48	112
B30R03C11	30-11-3	Hs~Ref:NM_000879.2~uORF:IOH40150	128	54	74
B30R03C12	30-12-3	Hs~Ref:NM_000879.2~uORF:IOH40150	136	59	77
B30R03C13	30-13-3	Hs~Ref:NM_021947.1~uORF:IOH41603	573	81	492
B30R03C14	30-14-3	Hs~Ref:NM_021947.1~uORF:IOH41603	479	61	418
B30R03C15	30-15-3	Hs~Ref:NM_006902.3~uORF:IOH36664	558	46	512
B30R03C16	30-16-3	Hs~Ref:NM_006902.3~uORF:IOH36664	582	47	535
B30R03C17	30-17-3	Hs~Ref:NM_207035.1~uORF:IOH41684	679	46	633
B30R03C18	30-18-3	Hs~Ref:NM_207035.1~uORF:IOH41684	689	45	644
B30R03C19	30-19-3	Hs~Ref:NM_201613.1~uORF:IOH45918	700	51	649
B30R03C20	30-20-3	Hs~Ref:NM_201613.1~uORF:IOH45918	677	54	623
B30R03C21	30-21-3	Hs~MGC:BC020962.1~uORF:IOH10372	370	52	318
B30R03C22	30-22-3	Hs~MGC:BC020962.1~uORF:IOH10372	460	172	288
B30R04C01	30-1-4	Hs~Ref:NM_020424.2~uORF:IOH10391	561	38	523
B30R04C02	30-2-4	Hs~Ref:NM_020424.2~uORF:IOH10391	554	41	513
B30R04C03	30-3-4	Hs~Ref:NM_014061.3~uORF:IOH10824	3055	52	3003
B30R04C04	30-4-4	Hs~Ref:NM_014061.3~uORF:IOH10824	2746	62	2684
B30R04C05	30-5-4	Hs~MGC:BC016395.1~uORF:IOH11318	572	74	498
B30R04C06	30-6-4	Hs~MGC:BC016395.1~uORF:IOH11318	603	60	543
B30R04C07	30-7-4	Hs~MGC:BC017227.1~uORF:IOH12094	1124	59	1065
B30R04C08	30-8-4	Hs~MGC:BC017227.1~uORF:IOH12094	1134	62	1072
B30R04C09	30-9-4	Hs~MGC:BC014665.1~uORF:IOH14248	523	88	435
B30R04C10	30-10-4	Hs~MGC:BC014665.1~uORF:IOH14248	465	74	391
B30R04C11	30-11-4	Hs~MGC:NM_172341.1~uORF:IOH14527	361	166	195
B30R04C12	30-12-4	Hs~MGC:NM_172341.1~uORF:IOH14527	476	57	419
B30R04C13	30-13-4	Hs~MGC:BC010504.1~uORF:IOH10186	251	67	184
B30R04C14	30-14-4	Hs~MGC:BC010504.1~uORF:IOH10186	288	73	215
B30R04C15	30-15-4	Hs~Ref:NM_133265.2~uORF:IOH38152	2254	49	2205
B30R04C16	30-16-4	Hs~Ref:NM_133265.2~uORF:IOH38152	2091	48	2043
B30R04C17	30-17-4	Hs~Ref:NM_004398.2~uORF:IOH38427	404	54	350
B30R04C18	30-18-4	Hs~Ref:NM_004398.2~uORF:IOH38427	453	49	404
B30R04C19	30-19-4	Hs~MGC:BC058836.1~uORF:IOH29500	347	54	293
B30R04C20	30-20-4	Hs~MGC:BC058836.1~uORF:IOH29500	549	187	362
B30R04C21	30-21-4	Hs~Ref:NM_004798.2~uORF:IOH38253	996	54	942
B30R04C22	30-22-4	Hs~Ref:NM_004798.2~uORF:IOH38253	1090	46	1044
B30R05C01	30-1-5	Hs~MGC:BC020688.1~uORF:IOH12152	438	38	400
B30R05C02	30-2-5	Hs~MGC:BC020688.1~uORF:IOH12152	482	42	440
B30R05C03	30-3-5	Hs~Ref:NM_138818.1~uORF:IOH13380	494	42	452
B30R05C04	30-4-5	Hs~Ref:NM_138818.1~uORF:IOH13380	617	48	569
B30R05C05	30-5-5	Hs~MGC:BC017873.1~uORF:IOH12434	973	62	911
B30R05C06	30-6-5	Hs~MGC:BC017873.1~uORF:IOH12434	986	62	924
B30R05C07	30-7-5	Hs~Ref:NM_005797.2~uORF:IOH12078	657	101	556
B30R05C08	30-8-5	Hs~Ref:NM_005797.2~uORF:IOH12078	433	67	366
B30R05C09	30-9-5	Hs~Ref:NM_003607.1~N/A	233	67	166
B30R05C10	30-10-5	Hs~Ref:NM_003607.1~N/A	267	147	120
B30R05C11	30-11-5	Hs~Ref:NM_018650.1~N/A	599	335	264
B30R05C12	30-12-5	Hs~Ref:NM_018650.1~N/A	502	58	444
B30R05C13	30-13-5	Hs~Ref:NM_004954.2~N/A	712	67	645
B30R05C14	30-14-5	Hs~Ref:NM_004954.2~N/A	670	58	612
B30R05C15	30-15-5	Hs~Ref:NM_006281.1~N/A	519	48	471
B30R05C16	30-16-5	Hs~Ref:NM_006281.1~N/A	575	47	528
B30R05C17	30-17-5	Hs~Ref:NM_003865.1~uORF:IOH40237	1080	46	1034
B30R05C18	30-18-5	Hs~Ref:NM_003865.1~uORF:IOH40237	943	45	898
B30R05C19	30-19-5	Hs~MGC:BC068446.1~uORF:IOH40110	700	47	653
B30R05C20	30-20-5	Hs~MGC:BC068446.1~uORF:IOH40110	819	57	762
B30R05C21	30-21-5	Hs~Ref:NM_018402.1~uORF:IOH40165	637	68	569
B30R05C22	30-22-5	Hs~Ref:NM_018402.1~uORF:IOH40165	671	45	626
B30R06C01	30-1-6	Hs~Ref:NM_018724.3~uORF:IOH40238	653	36	617
B30R06C02	30-2-6	Hs~Ref:NM_018724.3~uORF:IOH40238	704	40	664
B30R06C03	30-3-6	Hs~MGC:BC033794.1~uORF:IOH21798	854	42	812
B30R06C04	30-4-6	Hs~MGC:BC033794.1~uORF:IOH21798	911	47	864
B30R06C05	30-5-6	Hs~MGC:NM_173470.1~uORF:IOH21527	3642	58	3584
B30R06C06	30-6-6	Hs~MGC:NM_173470.1~uORF:IOH21527	3447	71	3376
B30R06C07	30-7-6	Hs~MGC:BC018782.1~uORF:IOH23121	701	163	538
B30R06C08	30-8-6	Hs~MGC:BC018782.1~uORF:IOH23121	794	108	686
B30R06C09	30-9-6	Hs~Ref:NM_138448.2~uORF:IOH10544	774	58	716
B30R06C10	30-10-6	Hs~Ref:NM_138448.2~uORF:IOH10544	809	58	751
B30R06C11	30-11-6	Hs~Ref:NM_003274.3~uORF:IOH53207	215	131	84
B30R06C12	30-12-6	Hs~Ref:NM_003274.3~uORF:IOH53207	176	59	117
B30R06C13	30-13-6	Hs~Ref:NM_003820.2~uORF:IOH59060	737	67	670
B30R06C14	30-14-6	Hs~Ref:NM_003820.2~uORF:IOH59060	676	62	614
B30R06C15	30-15-6	Hs~Ref:NM_001024732.1~uORF:IOH54967	390	80	310
B30R06C16	30-16-6	Hs~Ref:NM_001024732.1~uORF:IOH54967	320	53	267
B30R06C17	30-17-6	Hs~Ref:NM_001001391.1~uORF:IOH53593	215	46	169
B30R06C18	30-18-6	Hs~Ref:NM_001001391.1~uORF:IOH53593	276	47	229
B30R06C19	30-19-6	Hs~Ref:NM_001746.2~uORF:IOH4977	338	50	288
B30R06C20	30-20-6	Hs~Ref:NM_001746.2~uORF:IOH4977	238	66	172
B30R06C21	30-21-6	Hs~Ref:NM_017704.2~uORF:IOH12866	633	187	446
B30R06C22	30-22-6	Hs~Ref:NM_017704.2~uORF:IOH12866	664	50	614
B30R07C01	30-1-7	Hs~Ref:NM_014406.4~uORF:IOH21813	379	37	342
B30R07C02	30-2-7	Hs~Ref:NM_014406.4~uORF:IOH21813	403	40	363
B30R07C03	30-3-7	Hs~Ref:NM_032036.2~uORF:IOH21906	379	41	338
B30R07C04	30-4-7	Hs~Ref:NM_032036.2~uORF:IOH21906	529	49	480
B30R07C05	30-5-7	Hs~MGC:BC004897.1~uORF:IOH5182	274	59	215
B30R07C06	30-6-7	Hs~MGC:BC004897.1~uORF:IOH5182	356	92	264
B30R07C07	30-7-7	Hs~Ref:NM_003250.2~uORF:IOH5349	672	188	484
B30R07C08	30-8-7	Hs~Ref:NM_003250.2~uORF:IOH5349	604	473	131
B30R07C09	30-9-7	Hs~Ref:NM_001628.1~uORF:IOH4505	496	83	413
B30R07C10	30-10-7	Hs~Ref:NM_001628.1~uORF:IOH4505	475	335	140
B30R07C11	30-11-7	Hs~MGC:NM_152329.3~uORF:IOH23002	204	125	79
B30R07C12	30-12-7	Hs~MGC:NM_152329.3~uORF:IOH23002	172	60	112
B30R07C13	30-13-7	Hs~Ref:NM_005813.2~N/A	559	72	487
B30R07C14	30-14-7	Hs~Ref:NM_005813.2~N/A	430	68	362
B30R07C15	30-15-7	Hs~Ref:NM_004938.1~N/A	615	51	564
B30R07C16	30-16-7	Hs~Ref:NM_004938.1~N/A	599	51	548
B30R07C17	30-17-7	Hs~MGC:BC008708.1~uORF:IOH6868	513	112	401
B30R07C18	30-18-7	Hs~MGC:BC008708.1~uORF:IOH6868	199	162	37
B30R07C19	30-19-7	Hs~Ref:NM_014039.2~uORF:IOH9689	426	50	376
B30R07C20	30-20-7	Hs~Ref:NM_014039.2~uORF:IOH9689	534	66	468
B30R07C21	30-21-7	Hs~Ref:NM_014774.1~uORF:IOH4054	445	251	194
B30R07C22	30-22-7	Hs~Ref:NM_014774.1~uORF:IOH4054	467	202	265
B30R08C01	30-1-8	Hs~Ref:NM_031465.2~uORF:IOH6623	420	38	382
B30R08C02	30-2-8	Hs~Ref:NM_031465.2~uORF:IOH6623	472	42	430
B30R08C03	30-3-8	Hs~Ref:NM_006779.2~uORF:IOH14061	358	42	316
B30R08C04	30-4-8	Hs~Ref:NM_006779.2~uORF:IOH14061	539	52	487
B30R08C05	30-5-8	Hs~MGC:BC000807.1~uORF:IOH3072	295	138	157
B30R08C06	30-6-8	Hs~MGC:BC000807.1~uORF:IOH3072	214	57	157
B30R08C07	30-7-8	Hs~Ref:NM_032673.1~uORF:IOH5517	400	53	347
B30R08C08	30-8-8	Hs~Ref:NM_032673.1~uORF:IOH5517	392	57	335
B30R08C09	30-9-8	Hs~MGC:BC003555.1~uORF:IOH4980	296	62	234
B30R08C10	30-10-8	Hs~MGC:BC003555.1~uORF:IOH4980	298	57	241
B30R08C11	30-11-8	Hs~Ref:NM_032873.3~uORF:IOH6812	475	52	423
B30R08C12	30-12-8	Hs~Ref:NM_032873.3~uORF:IOH6812	463	52	411
B30R08C13	30-13-8	Hs~MGC:BC033233.1~uORF:IOH23273	692	70	622
B30R08C14	30-14-8	Hs~MGC:BC033233.1~uORF:IOH23273	646	67	579
B30R08C15	30-15-8	Hs~Ref:NM_017523.2~uORF:IOH45706	709	52	657
B30R08C16	30-16-8	Hs~Ref:NM_017523.2~uORF:IOH45706	721	46	675
B30R08C17	30-17-8	Hs~MGC:NM_175609.1~uORF:IOH11575	4760	47	4713
B30R08C18	30-18-8	Hs~MGC:NM_175609.1~uORF:IOH11575	4439	46	4393
B30R08C19	30-19-8	Hs~MGC:BC035359.1~uORF:IOH27405	620	46	574
B30R08C20	30-20-8	Hs~MGC:BC035359.1~uORF:IOH27405	676	51	625
B30R08C21	30-21-8	Hs~MGC:BC042608.1~uORF:IOH27462	1948	61	1887
B30R08C22	30-22-8	Hs~MGC:BC042608.1~uORF:IOH27462	1244	45	1199
B30R09C01	30-1-9	Hs~Ref:NM_145008.1~uORF:IOH58718	454	39	415
B30R09C02	30-2-9	Hs~Ref:NM_145008.1~uORF:IOH58718	459	41	418
B30R09C03	30-3-9	Hs~Ref:NM_000755.2~uORF:IOH52480	510	43	467
B30R09C04	30-4-9	Hs~Ref:NM_000755.2~uORF:IOH52480	632	49	583
B30R09C05	30-5-9	Hs~MGC:NM_000483.3~uORF:IOH54561	131	56	75
B30R09C06	30-6-9	Hs~MGC:NM_000483.3~uORF:IOH54561	130	57	73
B30R09C07	30-7-9	Hs~Ref:NM_005022.2~uORF:IOH58967	2494	53	2441
B30R09C08	30-8-9	Hs~Ref:NM_005022.2~uORF:IOH58967	2382	53	2329
B30R09C09	30-9-9	Hs~MGC:BC007501.2~uORF:IOH56901	438	143	295
B30R09C10	30-10-9	Hs~MGC:BC007501.2~uORF:IOH56901	337	54	283
B30R09C11	30-11-9	Hs~MGC:BC006558.2~uORF:IOH57072	180	64	116
B30R09C12	30-12-9	Hs~MGC:BC006558.2~uORF:IOH57072	140	51	89
B30R09C13	30-13-9	Hs~Ref:NM_006998.3~uORF:IOH56717	264	105	159
B30R09C14	30-14-9	Hs~Ref:NM_006998.3~uORF:IOH56717	395	100	295
B30R09C15	30-15-9	Hs~Ref:NM_012468.3~uORF:IOH57266	260	58	202
B30R09C16	30-16-9	Hs~Ref:NM_012468.3~uORF:IOH57266	232	60	172
B30R09C17	30-17-9	Hs~Ref:NM_003583.2~uORF:IOH2412	980	45	935
B30R09C18	30-18-9	Hs~Ref:NM_003583.2~uORF:IOH2412	1077	46	1031
B30R09C19	30-19-9	Hs~MGC:BC000566.1~uORF:IOH4164	169	56	113
B30R09C20	30-20-9	Hs~MGC:BC000566.1~uORF:IOH4164	230	94	136
B30R09C21	30-21-9	Hs~MGC:BC018942.1~uORF:IOH12834	607	59	548
B30R09C22	30-22-9	Hs~MGC:BC018942.1~uORF:IOH12834	562	178	384
B30R10C01	30-1-10	Hs~MGC:BC022454.2~uORF:IOH10977	283	40	243
B30R10C02	30-2-10	Hs~MGC:BC022454.2~uORF:IOH10977	171	41	130
B30R10C03	30-3-10	Hs~Ref:NM_016404.1~uORF:IOH12070	529	42	487
B30R10C04	30-4-10	Hs~Ref:NM_016404.1~uORF:IOH12070	458	49	409
B30R10C05	30-5-10	Hs~MGC:BC013200.1~uORF:IOH11874	725	57	668
B30R10C06	30-6-10	Hs~MGC:BC013200.1~uORF:IOH11874	595	54	541
B30R10C07	30-7-10	Hs~Ref:NM_006251.4~uORF:IOH27141	812	50	762
B30R10C08	30-8-10	Hs~Ref:NM_006251.4~uORF:IOH27141	790	50	740
B30R10C09	30-9-10	Hs~MGC:BC015497.1~uORF:IOH11495	940	57	883
B30R10C10	30-10-10	Hs~MGC:BC015497.1~uORF:IOH11495	723	51	672
B30R10C11	30-11-10	GST1	50	44	6
B30R10C12	30-12-10	GST1	47	45	2
B30R10C13	30-13-10	GST2	52	58	-6
B30R10C14	30-14-10	GST2	78	68	10
B30R10C15	30-15-10	GST3	61	53	8
B30R10C16	30-16-10	GST3	53	48	5
B30R10C17	30-17-10	GST4	69	45	24
B30R10C18	30-18-10	GST4	62	44	18
B30R10C19	30-19-10	Anti-HumanIgA1~N/A	9609	46	9563
B30R10C20	30-20-10	Anti-HumanIgA1~N/A	10238	48	10190
B30R10C21	30-21-10	Anti-HumanIgA2~N/A	15785	48	15737
B30R10C22	30-22-10	Anti-HumanIgA2~N/A	16037	44	15993
B30R11C01	30-1-11	AlexaAntiMouseAb~N/A	21512	37	21475
B30R11C02	30-2-11	AlexaAntiMouseAb~N/A	22353	43	22310
B30R11C03	30-3-11	MAPKAP~N/A	85	50	35
B30R11C04	30-4-11	MAPKAP~N/A	87	56	31
B30R11C05	30-5-11	Buffer	2449	51	2398
B30R11C06	30-6-11	Buffer	2722	50	2672
B30R11C07	30-7-11	BSA~N/A	11156	50	11106
B30R11C08	30-8-11	BSA~N/A	11732	49	11683
B30R11C09	30-9-11	Anti-HumanIgG1~N/A	1992	52	1940
B30R11C10	30-10-11	Anti-HumanIgG1~N/A	2009	51	1958
B30R11C11	30-11-11	Anti-HumanIgG2~N/A	3574	46	3528
B30R11C12	30-12-11	Anti-HumanIgG2~N/A	3867	48	3819
B30R11C13	30-13-11	Anti-HumanIgG3~N/A	6342	62	6280
B30R11C14	30-14-11	Anti-HumanIgG3~N/A	6976	71	6905
B30R11C15	30-15-11	Anti-HumanIgG4~N/A	12378	63	12315
B30R11C16	30-16-11	Anti-HumanIgG4~N/A	12267	60	12207
B30R11C17	30-17-11	AntiBiotinAb~N/A	14030	64	13966
B30R11C18	30-18-11	AntiBiotinAb~N/A	13557	55	13502
B30R11C19	30-19-11	Buffer	71	43	28
B30R11C20	30-20-11	Buffer	71	43	28
B30R11C21	30-21-11	Hs~Ref:NM_005165.1~uORF:IOH3879	564	51	513
B30R11C22	30-22-11	Hs~Ref:NM_005165.1~uORF:IOH3879	610	44	566
B30R12C01	30-1-12	Hs~Ref:NM_016146.1~uORF:IOH9822	430	39	391
B30R12C02	30-2-12	Hs~Ref:NM_016146.1~uORF:IOH9822	467	52	415
B30R12C03	30-3-12	Hs~MGC:BC000504.1~uORF:IOH3510	445	74	371
B30R12C04	30-4-12	Hs~MGC:BC000504.1~uORF:IOH3510	241	69	172
B30R12C05	30-5-12	Hs~Ref:NM_001930.2~uORF:IOH3570	917	57	860
B30R12C06	30-6-12	Hs~Ref:NM_001930.2~uORF:IOH3570	940	53	887
B30R12C07	30-7-12	Hs~Ref:NM_018423.1~N/A	824	55	769
B30R12C08	30-8-12	Hs~Ref:NM_018423.1~N/A	782	54	728
B30R12C09	30-9-12	Hs~Ref:NM_001084.2~uORF:IOH12981	793	53	740
B30R12C10	30-10-12	Hs~Ref:NM_001084.2~uORF:IOH12981	779	55	724
B30R12C11	30-11-12	Hs~MGC:NM_178858.3~uORF:IOH13450	325	54	271
B30R12C12	30-12-12	Hs~MGC:NM_178858.3~uORF:IOH13450	658	53	605
B30R12C13	30-13-12	Hs~MGC:BC014658.1~uORF:IOH13361	262	159	103
B30R12C14	30-14-12	Hs~MGC:BC014658.1~uORF:IOH13361	328	249	79
B30R12C15	30-15-12	Hs~Ref:NM_014548.2~uORF:IOH39971	519	105	414
B30R12C16	30-16-12	Hs~Ref:NM_014548.2~uORF:IOH39971	488	64	424
B30R12C17	30-17-12	Hs~MGC:BC067120.1~uORF:IOH40451	581	176	405
B30R12C18	30-18-12	Hs~MGC:BC067120.1~uORF:IOH40451	543	74	469
B30R12C19	30-19-12	Hs~Ref:NM_138458.1~uORF:IOH39984	129	46	83
B30R12C20	30-20-12	Hs~Ref:NM_138458.1~uORF:IOH39984	189	79	110
B30R12C21	30-21-12	Hs~Ref:NM_032368.3~uORF:IOH39898	416	70	346
B30R12C22	30-22-12	Hs~Ref:NM_032368.3~uORF:IOH39898	455	277	178
B30R13C01	30-1-13	Hs~Ref:NM_030755.1~uORF:IOH22397	524	40	484
B30R13C02	30-2-13	Hs~Ref:NM_030755.1~uORF:IOH22397	458	48	410
B30R13C03	30-3-13	Hs~MGC:BC030711.2~uORF:IOH22414	597	167	430
B30R13C04	30-4-13	Hs~MGC:BC030711.2~uORF:IOH22414	435	59	376
B30R13C05	30-5-13	Hs~MGC:NM_153224.2~uORF:IOH22434	358	94	264
B30R13C06	30-6-13	Hs~MGC:NM_153224.2~uORF:IOH22434	256	60	196
B30R13C07	30-7-13	Hs~MGC:BC036540.2~uORF:IOH22457	485	73	412
B30R13C08	30-8-13	Hs~MGC:BC036540.2~uORF:IOH22457	525	75	450
B30R13C09	30-9-13	Hs~Ref:NM_080876.2~uORF:IOH27172	443	78	365
B30R13C10	30-10-13	Hs~Ref:NM_080876.2~uORF:IOH27172	315	162	153
B30R13C11	30-11-13	Hs~Ref:NM_031954.2~uORF:IOH25947	1113	59	1054
B30R13C12	30-12-13	Hs~Ref:NM_031954.2~uORF:IOH25947	1066	50	1016
B30R13C13	30-13-13	Hs~MGC:BC040183.2~uORF:IOH27627	425	57	368
B30R13C14	30-14-13	Hs~MGC:BC040183.2~uORF:IOH27627	361	68	293
B30R13C15	30-15-13	Hs~MGC:BC029495.1~uORF:IOH22527	1269	71	1198
B30R13C16	30-16-13	Hs~MGC:BC029495.1~uORF:IOH22527	1227	57	1170
B30R13C17	30-17-13	Hs~MGC:BC025787.1~uORF:IOH12000	811	51	760
B30R13C18	30-18-13	Hs~MGC:BC025787.1~uORF:IOH12000	700	50	650
B30R13C19	30-19-13	Hs~MGC:BC053347.1~uORF:IOH28937	366	78	288
B30R13C20	30-20-13	Hs~MGC:BC053347.1~uORF:IOH28937	204	50	154
B30R13C21	30-21-13	Hs~MGC:BC001048.1~uORF:IOH4605	336	53	283
B30R13C22	30-22-13	Hs~MGC:BC001048.1~uORF:IOH4605	464	49	415
B30R14C01	30-1-14	Hs~Ref:NM_003073.1~uORF:IOH29630	445	40	405
B30R14C02	30-2-14	Hs~Ref:NM_003073.1~uORF:IOH29630	95	52	43
B30R14C03	30-3-14	Hs~Ref:NM_032361.1~uORF:IOH3160	892	81	811
B30R14C04	30-4-14	Hs~Ref:NM_032361.1~uORF:IOH3160	473	58	415
B30R14C05	30-5-14	Hs~Ref:NM_004552.1~uORF:IOH4963	761	62	699
B30R14C06	30-6-14	Hs~Ref:NM_004552.1~uORF:IOH4963	683	63	620
B30R14C07	30-7-14	Hs~Ref:NM_004016.1~uORF:IOH11698	444	129	315
B30R14C08	30-8-14	Hs~Ref:NM_004016.1~uORF:IOH11698	395	137	258
B30R14C09	30-9-14	Hs~Ref:NM_001896.2~uORF:IOH6369	2760	98	2662
B30R14C10	30-10-14	Hs~Ref:NM_001896.2~uORF:IOH6369	2857	88	2769
B30R14C11	30-11-14	Hs~Ref:NM_207506.1~uORF:IOH59695	293	71	222
B30R14C12	30-12-14	Hs~Ref:NM_207506.1~uORF:IOH59695	304	78	226
B30R14C13	30-13-14	Hs~Ref:NM_005042.2~uORF:IOH53437	258	99	159
B30R14C14	30-14-14	Hs~Ref:NM_005042.2~uORF:IOH53437	276	79	197
B30R14C15	30-15-14	Hs~Ref:NM_001001487.1~uORF:IOH53561	272	162	110
B30R14C16	30-16-14	Hs~Ref:NM_001001487.1~uORF:IOH53561	642	86	556
B30R14C17	30-17-14	Hs~Ref:NM_015966.1~uORF:IOH13352	172	47	125
B30R14C18	30-18-14	Hs~Ref:NM_015966.1~uORF:IOH13352	222	64	158
B30R14C19	30-19-14	Hs~MGC:BC058904.1~uORF:IOH29071	216	47	169
B30R14C20	30-20-14	Hs~MGC:BC058904.1~uORF:IOH29071	313	51	262
B30R14C21	30-21-14	Hs~MGC:BC054888.1~uORF:IOH29471	256	63	193
B30R14C22	30-22-14	Hs~MGC:BC054888.1~uORF:IOH29471	276	57	219
B30R15C01	30-1-15	Hs~MGC:BC052806.1~uORF:IOH28971	634	39	595
B30R15C02	30-2-15	Hs~MGC:BC052806.1~uORF:IOH28971	337	54	283
B30R15C03	30-3-15	Hs~MGC:BC056246.1~uORF:IOH29419	597	109	488
B30R15C04	30-4-15	Hs~MGC:BC056246.1~uORF:IOH29419	203	56	147
B30R15C05	30-5-15	Hs~Ref:NM_018216.1~uORF:IOH26341	1499	58	1441
B30R15C06	30-6-15	Hs~Ref:NM_018216.1~uORF:IOH26341	1428	58	1370
B30R15C07	30-7-15	Hs~MGC:BC061514.1~uORF:IOH29303	401	126	275
B30R15C08	30-8-15	Hs~MGC:BC061514.1~uORF:IOH29303	314	52	262
B30R15C09	30-9-15	Hs~MGC:BC060828.1~uORF:IOH29183	1238	106	1132
B30R15C10	30-10-15	Hs~MGC:BC060828.1~uORF:IOH29183	262	80	182
B30R15C11	30-11-15	Hs~Ref:NM_014805.2~uORF:IOH39814	743	76	667
B30R15C12	30-12-15	Hs~Ref:NM_014805.2~uORF:IOH39814	806	59	747
B30R15C13	30-13-15	Hs~IVGN:PM_2140~Ext:TopoI~N/A	752	52	700
B30R15C14	30-14-15	Hs~IVGN:PM_2140~Ext:TopoI~N/A	712	56	656
B30R15C15	30-15-15	Hs~Ref:NM_006256.1~CAT:PV3879	1932	67	1865
B30R15C16	30-16-15	Hs~Ref:NM_006256.1~CAT:PV3879	1786	54	1732
B30R15C17	30-17-15	Hs~Ref:NM_003177.3~CAT:PV3857	317	154	163
B30R15C18	30-18-15	Hs~Ref:NM_003177.3~CAT:PV3857	230	44	186
B30R15C19	30-19-15	Hs~Ref:NM_006622.1~CAT:PV4204	479	122	357
B30R15C20	30-20-15	Hs~Ref:NM_006622.1~CAT:PV4204	432	48	384
B30R15C21	30-21-15	Hs~Ref:NM_004442.3~CAT:PV3625	444	45	399
B30R15C22	30-22-15	Hs~Ref:NM_004442.3~CAT:PV3625	415	41	374
B30R16C01	30-1-16	Hs~Ref:NM_001894.2~CAT:PV3500	2534	40	2494
B30R16C02	30-2-16	Hs~Ref:NM_001894.2~CAT:PV3500	2727	57	2670
B30R16C03	30-3-16	Hs~Ref:NM_004071.1~CAT:PV3315	127	55	72
B30R16C04	30-4-16	Hs~Ref:NM_004071.1~CAT:PV3315	128	47	81
B30R16C05	30-5-16	Hs~Ref:NM_002006.3~CAT_PHG0266	87	47	40
B30R16C06	30-6-16	Hs~Ref:NM_002006.3~CAT_PHG0266	293	54	239
B30R16C07	30-7-16	Hs~Ref:NM_001004286.1~uORF:IOH58640	845	53	792
B30R16C08	30-8-16	Hs~Ref:NM_001004286.1~uORF:IOH58640	810	51	759
B30R16C09	30-9-16	Hs~Ref:XM_936115.1~uORF:IOH3340	178	55	123
B30R16C10	30-10-16	Hs~Ref:XM_936115.1~uORF:IOH3340	212	129	83
B30R16C11	30-11-16	Hs~MGC:BC045756.1~uORF:IOH62354	562	132	430
B30R16C12	30-12-16	Hs~MGC:BC045756.1~uORF:IOH62354	617	51	566
B30R16C13	30-13-16	Hs~MGC:BC092453.1~uORF:IOH63167	11503	48	11455
B30R16C14	30-14-16	Hs~MGC:BC092453.1~uORF:IOH63167	11269	52	11217
B30R16C15	30-15-16	Hs~Ref:NM_014281.3~uORF:IOH57033	1948	61	1887
B30R16C16	30-16-16	Hs~Ref:NM_014281.3~uORF:IOH57033	1885	56	1829
B30R16C17	30-17-16	Hs~Ref:NM_012086.1~uORF:IOH55731	3657	46	3611
B30R16C18	30-18-16	Hs~Ref:NM_012086.1~uORF:IOH55731	3358	44	3314
B30R16C19	30-19-16	Hs~Ref:NM_000156.4~uORF:IOH57091	343	46	297
B30R16C20	30-20-16	Hs~Ref:NM_000156.4~uORF:IOH57091	286	73	213
B30R16C21	30-21-16	Hs~MGC:BC018906.2~uORF:IOH57152	1585	46	1539
B30R16C22	30-22-16	Hs~MGC:BC018906.2~uORF:IOH57152	1642	39	1603
B30R17C01	30-1-17	Hs~Ref:NM_001493.1~uORF:IOH3509	556	87	469
B30R17C02	30-2-17	Hs~Ref:NM_001493.1~uORF:IOH3509	181	97	84
B30R17C03	30-3-17	Hs~Ref:NM_000122.1~uORF:IOH6320	1715	646	1069
B30R17C04	30-4-17	Hs~Ref:NM_000122.1~uORF:IOH6320	1354	51	1303
B30R17C05	30-5-17	Hs~Ref:NM_032259.1~uORF:IOH6995	667	154	513
B30R17C06	30-6-17	Hs~Ref:NM_032259.1~uORF:IOH6995	624	48	576
B30R17C07	30-7-17	Hs~MGC:BC026083.1~uORF:IOH62071	176	55	121
B30R17C08	30-8-17	Hs~MGC:BC026083.1~uORF:IOH62071	201	114	87
B30R17C09	30-9-17	Hs~Ref:NM_024786.1~uORF:IOH22166	459	247	212
B30R17C10	30-10-17	Hs~Ref:NM_024786.1~uORF:IOH22166	389	116	273
B30R17C11	30-11-17	Hs~Ref:NM_006681.1~uORF:IOH10556	653	260	393
B30R17C12	30-12-17	Hs~Ref:NM_006681.1~uORF:IOH10556	436	59	377
B30R17C13	30-13-17	Hs~MGC:BC006393.1~uORF:IOH6460	425	55	370
B30R17C14	30-14-17	Hs~MGC:BC006393.1~uORF:IOH6460	498	69	429
B30R17C15	30-15-17	Hs~Ref:NM_005040.1~uORF:IOH13548	398	178	220
B30R17C16	30-16-17	Hs~Ref:NM_005040.1~uORF:IOH13548	301	66	235
B30R17C17	30-17-17	Hs~Ref:NM_023946.1~uORF:IOH45530	352	160	192
B30R17C18	30-18-17	Hs~Ref:NM_023946.1~uORF:IOH45530	197	46	151
B30R17C19	30-19-17	Hs~Ref:NM_022039.3~uORF:IOH39881	286	72	214
B30R17C20	30-20-17	Hs~Ref:NM_022039.3~uORF:IOH39881	239	141	98
B30R17C21	30-21-17	Hs~Ref:NM_000410.2~uORF:IOH35337	430	45	385
B30R17C22	30-22-17	Hs~Ref:NM_000410.2~uORF:IOH35337	456	40	416
B30R18C01	30-1-18	Hs~MGC:BC058899.1~uORF:IOH29087	789	440	349
B30R18C02	30-2-18	Hs~MGC:BC058899.1~uORF:IOH29087	554	65	489
B30R18C03	30-3-18	Hs~Ref:NM_173623.1~uORF:IOH27653	1828	118	1710
B30R18C04	30-4-18	Hs~Ref:NM_173623.1~uORF:IOH27653	630	53	577
B30R18C05	30-5-18	Hs~MGC:BC001380.2~uORF:IOH3984	42	67	-25
B30R18C06	30-6-18	Hs~MGC:BC001380.2~uORF:IOH3984	235	63	172
B30R18C07	30-7-18	Hs~MGC:BC020748.1~uORF:IOH13116	256	58	198
B30R18C08	30-8-18	Hs~MGC:BC020748.1~uORF:IOH13116	272	76	196
B30R18C09	30-9-18	Hs~MGC:BC007218.1~uORF:IOH6864	160	57	103
B30R18C10	30-10-18	Hs~MGC:BC007218.1~uORF:IOH6864	121	57	64
B30R18C11	30-11-18	Hs~MGC:BC040075.1~uORF:IOH28765	363	56	307
B30R18C12	30-12-18	Hs~MGC:BC040075.1~uORF:IOH28765	289	63	226
B30R18C13	30-13-18	Hs~MGC:BC047368.1~uORF:IOH26503	735	50	685
B30R18C14	30-14-18	Hs~MGC:BC047368.1~uORF:IOH26503	654	49	605
B30R18C15	30-15-18	Hs~MGC:BC055088.1~uORF:IOH29459	292	56	236
B30R18C16	30-16-18	Hs~MGC:BC055088.1~uORF:IOH29459	482	215	267
B30R18C17	30-17-18	Hs~MGC:BC035975.1~uORF:IOH27963	472	47	425
B30R18C18	30-18-18	Hs~MGC:BC035975.1~uORF:IOH27963	383	45	338
B30R18C19	30-19-18	Hs~MGC:BC010464.1~uORF:IOH9638	562	51	511
B30R18C20	30-20-18	Hs~MGC:BC010464.1~uORF:IOH9638	727	65	662
B30R18C21	30-21-18	Hs~MGC:BC008383.1~uORF:IOH7227	451	45	406
B30R18C22	30-22-18	Hs~MGC:BC008383.1~uORF:IOH7227	443	43	400
B30R19C01	30-1-19	Hs~Ref:NM_020750.1~uORF:IOH40446	215	43	172
B30R19C02	30-2-19	Hs~Ref:NM_020750.1~uORF:IOH40446	516	100	416
B30R19C03	30-3-19	Hs~MGC:BC063275.1~uORF:IOH40423	687	157	530
B30R19C04	30-4-19	Hs~MGC:BC063275.1~uORF:IOH40423	766	63	703
B30R19C05	30-5-19	Hs~MGC:BC021143.1~uORF:IOH23118	433	61	372
B30R19C06	30-6-19	Hs~MGC:BC021143.1~uORF:IOH23118	399	49	350
B30R19C07	30-7-19	Hs~Ref:NM_004119.1~N/A	439	52	387
B30R19C08	30-8-19	Hs~Ref:NM_004119.1~N/A	413	70	343
B30R19C09	30-9-19	Hs~Ref:NM_080719.1~uORF:IOH14144	171	69	102
B30R19C10	30-10-19	Hs~Ref:NM_080719.1~uORF:IOH14144	96	64	32
B30R19C11	30-11-19	Hs~MGC:BC014037.1~N/A	814	58	756
B30R19C12	30-12-19	Hs~MGC:BC014037.1~N/A	108	49	59
B30R19C13	30-13-19	Hs~MGC:BC066917.1~uORF:IOH61482	249	65	184
B30R19C14	30-14-19	Hs~MGC:BC066917.1~uORF:IOH61482	288	62	226
B30R19C15	30-15-19	Hs~MGC:BC084559.1~uORF:IOH63117	160	52	108
B30R19C16	30-16-19	Hs~MGC:BC084559.1~uORF:IOH63117	169	55	114
B30R19C17	30-17-19	Hs~Ref:NM_001025248.1~uORF:IOH62874	226	45	181
B30R19C18	30-18-19	Hs~Ref:NM_001025248.1~uORF:IOH62874	181	99	82
B30R19C19	30-19-19	Hs~MGC:BC070374.1~uORF:IOH62870	353	100	253
B30R19C20	30-20-19	Hs~MGC:BC070374.1~uORF:IOH62870	246	47	199
B30R19C21	30-21-19	Hs~Ref:NM_002538.2~uORF:IOH59115	548	41	507
B30R19C22	30-22-19	Hs~Ref:NM_002538.2~uORF:IOH59115	572	41	531
B30R20C01	30-1-20	Hs~Ref:NM_201267.1~uORF:IOH53618	38	41	-3
B30R20C02	30-2-20	Hs~Ref:NM_201267.1~uORF:IOH53618	417	50	367
B30R20C03	30-3-20	Hs~Ref:NM_001007534.1~uORF:IOH59764	49	63	-14
B30R20C04	30-4-20	Hs~Ref:NM_001007534.1~uORF:IOH59764	44	48	-4
B30R20C05	30-5-20	Hs~Ref:NM_005917.2~uORF:IOH59077	44	45	-1
B30R20C06	30-6-20	Hs~Ref:NM_005917.2~uORF:IOH59077	43	45	-2
B30R20C07	30-7-20	Hs~Ref:NM_032797.4~uORF:IOH56964	598	50	548
B30R20C08	30-8-20	Hs~Ref:NM_032797.4~uORF:IOH56964	676	55	621
B30R20C09	30-9-20	Hs~Ref:NM_001005158.1~uORF:IOH57124	632	95	537
B30R20C10	30-10-20	Hs~Ref:NM_001005158.1~uORF:IOH57124	704	132	572
B30R20C11	30-11-20	Hs~Ref:NM_002907.2~uORF:IOH55572	936	52	884
B30R20C12	30-12-20	Hs~Ref:NM_002907.2~uORF:IOH55572	230	48	182
B30R20C13	30-13-20	Hs~Ref:NM_005985.2~uORF:IOH56124	417	46	371
B30R20C14	30-14-20	Hs~Ref:NM_005985.2~uORF:IOH56124	389	47	342
B30R20C15	30-15-20	Hs~Ref:NM_005983.2~uORF:IOH41200	359	84	275
B30R20C16	30-16-20	Hs~Ref:NM_005983.2~uORF:IOH41200	258	78	180
B30R20C17	30-17-20	Hs~MGC:BC033092.1~uORF:IOH23238	375	43	332
B30R20C18	30-18-20	Hs~MGC:BC033092.1~uORF:IOH23238	412	43	369
B30R20C19	30-19-20	Hs~Ref:NM_014217.2~uORF:IOH36685	381	53	328
B30R20C20	30-20-20	Hs~Ref:NM_014217.2~uORF:IOH36685	240	44	196
B30R20C21	30-21-20	Hs~MGC:BC034001.1~uORF:IOH23250	562	41	521
B30R20C22	30-22-20	Hs~MGC:BC034001.1~uORF:IOH23250	584	40	544
B30R21C01	30-1-21	Hs~Ref:NM_024902.2~uORF:IOH23269	90	50	40
B30R21C02	30-2-21	Hs~Ref:NM_024902.2~uORF:IOH23269	399	88	311
B30R21C03	30-3-21	Hs~Ref:NM_014349.2~uORF:IOH42368	510	102	408
B30R21C04	30-4-21	Hs~Ref:NM_014349.2~uORF:IOH42368	206	62	144
B30R21C05	30-5-21	Hs~Ref:NM_144600.1~uORF:IOH12362	796	46	750
B30R21C06	30-6-21	Hs~Ref:NM_144600.1~uORF:IOH12362	756	44	712
B30R21C07	30-7-21	Hs~MGC:BC033204.1~uORF:IOH23252	76	48	28
B30R21C08	30-8-21	Hs~MGC:BC033204.1~uORF:IOH23252	71	50	21
B30R21C09	30-9-21	Hs~Ref:NP_000205.1~CAT_11648-H02H-25	40103	52	40051
B30R21C10	30-10-21	Hs~Ref:NP_000205.1~CAT_11648-H02H-25	39460	51	39409
B30R21C11	30-11-21	Internal_1007209	55	46	9
B30R21C12	30-12-21	Internal_1007209	45	42	3
B30R21C13	30-13-21	Hs~Ref:Q86YW5-1~CAT_11934-H08H-25	44	42	2
B30R21C14	30-14-21	Hs~Ref:Q86YW5-1~CAT_11934-H08H-25	47	41	6
B30R21C15	30-15-21	Internal_1007209	77	45	32
B30R21C16	30-16-21	Internal_1007209	69	50	19
B30R21C17	30-17-21	Hs~Ref:NP_002956.1~CAT_11145-H08B-25	45	42	3
B30R21C18	30-18-21	Hs~Ref:NP_002956.1~CAT_11145-H08B-25	43	39	4
B30R21C19	30-19-21	Internal_1007209	64	41	23
B30R21C20	30-20-21	Internal_1007209	59	41	18
B30R21C21	30-21-21	Internal_1007209	372	44	328
B30R21C22	30-22-21	Internal_1007209	382	110	272
B30R22C01	30-1-22	ERa~N/A	2100	51	2049
B30R22C02	30-2-22	ERa~N/A	1587	92	1495
B30R22C03	30-3-22	PKCeta~N/A	372	80	292
B30R22C04	30-4-22	PKCeta~N/A	675	154	521
B30R22C05	30-5-22	Calmodulin~N/A	219	47	172
B30R22C06	30-6-22	Calmodulin~N/A	118	43	75
B30R22C07	30-7-22	V5control5~N/A	476	45	431
B30R22C08	30-8-22	V5control5~N/A	398	47	351
B30R22C09	30-9-22	V5control4~N/A	139	48	91
B30R22C10	30-10-22	V5control4~N/A	137	48	89
B30R22C11	30-11-22	V5control3~N/A	116	49	67
B30R22C12	30-12-22	V5control3~N/A	112	62	50
B30R22C13	30-13-22	V5control2~N/A	74	42	32
B30R22C14	30-14-22	V5control2~N/A	80	46	34
B30R22C15	30-15-22	V5control1~N/A	115	50	65
B30R22C16	30-16-22	V5control1~N/A	71	47	24
B30R22C17	30-17-22	CMK2A~N/A	570	43	527
B30R22C18	30-18-22	CMK2A~N/A	542	38	504
B30R22C19	30-19-22	ERa~N/A	1801	39	1762
B30R22C20	30-20-22	ERa~N/A	1932	38	1894
B30R22C21	30-21-22	AlexaAntiMouseAb~N/A	9274	38	9236
B30R22C22	30-22-22	AlexaAntiMouseAb~N/A	11270	38	11232
B31R01C01	31-1-1	AlexaAntiMouseAb~N/A	34763	40	34723
B31R01C02	31-2-1	AlexaAntiMouseAb~N/A	35501	40	35461
B31R01C03	31-3-1	ERa~N/A	1925	39	1886
B31R01C04	31-4-1	ERa~N/A	1764	40	1724
B31R01C05	31-5-1	HumanIgG1~N/A	1358	40	1318
B31R01C06	31-6-1	HumanIgG1~N/A	1349	40	1309
B31R01C07	31-7-1	HumanIgG2~N/A	3695	40	3655
B31R01C08	31-8-1	HumanIgG2~N/A	3297	41	3256
B31R01C09	31-9-1	HumanIgG3~N/A	14949	40	14909
B31R01C10	31-10-1	HumanIgG3~N/A	13166	41	13125
B31R01C11	31-11-1	HumanIgG4~N/A	39020	43	38977
B31R01C12	31-12-1	HumanIgG4~N/A	39735	44	39691
B31R01C13	31-13-1	BiotinAb~N/A	284	42	242
B31R01C14	31-14-1	BiotinAb~N/A	325	50	275
B31R01C15	31-15-1	RanBP2deltaFG~N/A	303	46	257
B31R01C16	31-16-1	RanBP2deltaFG~N/A	294	49	245
B31R01C17	31-17-1	hMDM2~N/A	746	44	702
B31R01C18	31-18-1	hMDM2~N/A	837	44	793
B31R01C19	31-19-1	PKCeta~N/A	317	42	275
B31R01C20	31-20-1	PKCeta~N/A	314	42	272
B31R01C21	31-21-1	AlexaAntiMouseAb~N/A	32722	42	32680
B31R01C22	31-22-1	AlexaAntiMouseAb~N/A	34156	42	34114
B31R02C01	31-1-2	PKCeta~N/A	1392	40	1352
B31R02C02	31-2-2	PKCeta~N/A	1303	38	1265
B31R02C03	31-3-2	Buffer	388	39	349
B31R02C04	31-4-2	Buffer	431	38	393
B31R02C05	31-5-2	HumanIgA~N/A	19655	41	19614
B31R02C06	31-6-2	HumanIgA~N/A	20312	43	20269
B31R02C07	31-7-2	Buffer	94	41	53
B31R02C08	31-8-2	Buffer	141	54	87
B31R02C09	31-9-2	BSA~N/A	12590	43	12547
B31R02C10	31-10-2	BSA~N/A	12053	43	12010
B31R02C11	31-11-2	Hs~MGC:BC066294.1~uORF:IOH40058	284	45	239
B31R02C12	31-12-2	Hs~MGC:BC066294.1~uORF:IOH40058	249	46	203
B31R02C13	31-13-2	Hs~Ref:NM_031463.3~uORF:IOH43565	241	44	197
B31R02C14	31-14-2	Hs~Ref:NM_031463.3~uORF:IOH43565	161	45	116
B31R02C15	31-15-2	Hs~Ref:NM_015002.2~uORF:IOH42260	670	49	621
B31R02C16	31-16-2	Hs~Ref:NM_015002.2~uORF:IOH42260	674	52	622
B31R02C17	31-17-2	Hs~Ref:NM_002925.3~uORF:IOH41439	249	61	188
B31R02C18	31-18-2	Hs~Ref:NM_002925.3~uORF:IOH41439	166	54	112
B31R02C19	31-19-2	Hs~Ref:NM_000713.1~uORF:IOH41586	673	45	628
B31R02C20	31-20-2	Hs~Ref:NM_000713.1~uORF:IOH41586	692	43	649
B31R02C21	31-21-2	Hs~Ref:NM_021571.2~uORF:IOH42984	403	43	360
B31R02C22	31-22-2	Hs~Ref:NM_021571.2~uORF:IOH42984	391	43	348
B31R03C01	31-1-3	Hs~Ref:NM_199139.1~uORF:IOH44783	1324	40	1284
B31R03C02	31-2-3	Hs~Ref:NM_199139.1~uORF:IOH44783	1267	40	1227
B31R03C03	31-3-3	Hs~Ref:NM_001008740.2~uORF:IOH41285	218	42	176
B31R03C04	31-4-3	Hs~Ref:NM_001008740.2~uORF:IOH41285	126	40	86
B31R03C05	31-5-3	Hs~Ref:NM_021255.1~uORF:IOH12192	388	43	345
B31R03C06	31-6-3	Hs~Ref:NM_021255.1~uORF:IOH12192	419	46	373
B31R03C07	31-7-3	Hs~Ref:NM_016289.2~uORF:IOH10730	519	45	474
B31R03C08	31-8-3	Hs~Ref:NM_016289.2~uORF:IOH10730	481	46	435
B31R03C09	31-9-3	Hs~Ref:NM_021079.2~uORF:IOH14141	1858	43	1815
B31R03C10	31-10-3	Hs~Ref:NM_021079.2~uORF:IOH14141	1802	43	1759
B31R03C11	31-11-3	Hs~MGC:BC020946.1~uORF:IOH26800	202	52	150
B31R03C12	31-12-3	Hs~MGC:BC020946.1~uORF:IOH26800	237	46	191
B31R03C13	31-13-3	Hs~MGC:BC007407.1~uORF:IOH5830	397	47	350
B31R03C14	31-14-3	Hs~MGC:BC007407.1~uORF:IOH5830	401	47	354
B31R03C15	31-15-3	Hs~Ref:NM_145792.1~uORF:IOH7456	439	44	395
B31R03C16	31-16-3	Hs~Ref:NM_145792.1~uORF:IOH7456	363	45	318
B31R03C17	31-17-3	Hs~MGC:NM_173362.2~uORF:IOH12123	254	50	204
B31R03C18	31-18-3	Hs~MGC:NM_173362.2~uORF:IOH12123	261	53	208
B31R03C19	31-19-3	Hs~MGC:BC015059.1~uORF:IOH13646	526	45	481
B31R03C20	31-20-3	Hs~MGC:BC015059.1~uORF:IOH13646	531	44	487
B31R03C21	31-21-3	Hs~Ref:NM_003509.2~uORF:IOH1642	429	44	385
B31R03C22	31-22-3	Hs~Ref:NM_003509.2~uORF:IOH1642	428	43	385
B31R04C01	31-1-4	Hs~Ref:NM_022497.2~uORF:IOH1725	361	85	276
B31R04C02	31-2-4	Hs~Ref:NM_022497.2~uORF:IOH1725	302	42	260
B31R04C03	31-3-4	Hs~Ref:NM_014286.2~uORF:IOH1769	128	133	-5
B31R04C04	31-4-4	Hs~Ref:NM_014286.2~uORF:IOH1769	138	47	91
B31R04C05	31-5-4	Hs~Ref:NM_022839.2~uORF:IOH1783	1052	40	1012
B31R04C06	31-6-4	Hs~Ref:NM_022839.2~uORF:IOH1783	1052	41	1011
B31R04C07	31-7-4	Hs~MGC:BC005974.1~uORF:IOH7463	464	44	420
B31R04C08	31-8-4	Hs~MGC:BC005974.1~uORF:IOH7463	475	46	429
B31R04C09	31-9-4	Hs~Ref:NM_015948.2~uORF:IOH7165	318	44	274
B31R04C10	31-10-4	Hs~Ref:NM_015948.2~uORF:IOH7165	322	43	279
B31R04C11	31-11-4	Hs~MGC:BC014457.1~uORF:IOH12101	128	86	42
B31R04C12	31-12-4	Hs~MGC:BC014457.1~uORF:IOH12101	83	48	35
B31R04C13	31-13-4	Hs~MGC:BC007019.1~uORF:IOH7241	427	48	379
B31R04C14	31-14-4	Hs~MGC:BC007019.1~uORF:IOH7241	417	46	371
B31R04C15	31-15-4	Hs~Ref:NM_006303.2~uORF:IOH5395	706	42	664
B31R04C16	31-16-4	Hs~Ref:NM_006303.2~uORF:IOH5395	663	43	620
B31R04C17	31-17-4	Hs~Ref:NM_199326.1~uORF:IOH3323	604	45	559
B31R04C18	31-18-4	Hs~Ref:NM_199326.1~uORF:IOH3323	599	45	554
B31R04C19	31-19-4	Hs~Ref:NM_004577.3~uORF:IOH39828	487	44	443
B31R04C20	31-20-4	Hs~Ref:NM_004577.3~uORF:IOH39828	476	46	430
B31R04C21	31-21-4	Hs~Ref:NM_005181.2~uORF:IOH1901	214	45	169
B31R04C22	31-22-4	Hs~Ref:NM_005181.2~uORF:IOH1901	239	179	60
B31R05C01	31-1-5	Hs~Ref:NM_020466.3~uORF:IOH12271	5703	41	5662
B31R05C02	31-2-5	Hs~Ref:NM_020466.3~uORF:IOH12271	5718	41	5677
B31R05C03	31-3-5	Hs~Ref:NM_052822.1~uORF:IOH12952	695	44	651
B31R05C04	31-4-5	Hs~Ref:NM_052822.1~uORF:IOH12952	659	42	617
B31R05C05	31-5-5	Hs~Ref:NM_006299.2~uORF:IOH12838	5248	42	5206
B31R05C06	31-6-5	Hs~Ref:NM_006299.2~uORF:IOH12838	5262	40	5222
B31R05C07	31-7-5	Hs~Ref:NM_006984.1~uORF:IOH12270	441	41	400
B31R05C08	31-8-5	Hs~Ref:NM_006984.1~uORF:IOH12270	467	42	425
B31R05C09	31-9-5	Hs~MGC:BC039831.1~uORF:IOH26290	162	42	120
B31R05C10	31-10-5	Hs~MGC:BC039831.1~uORF:IOH26290	200	46	154
B31R05C11	31-11-5	Hs~MGC:BC038953.1~uORF:IOH26135	1219	48	1171
B31R05C12	31-12-5	Hs~MGC:BC038953.1~uORF:IOH26135	1186	47	1139
B31R05C13	31-13-5	Hs~Ref:NM_006977.1~uORF:IOH26026	225	47	178
B31R05C14	31-14-5	Hs~Ref:NM_006977.1~uORF:IOH26026	271	58	213
B31R05C15	31-15-5	Hs~MGC:BC039825.1~uORF:IOH26189	309	45	264
B31R05C16	31-16-5	Hs~MGC:BC039825.1~uORF:IOH26189	327	64	263
B31R05C17	31-17-5	Hs~Ref:NM_002305.2~uORF:IOH3861	1079	46	1033
B31R05C18	31-18-5	Hs~Ref:NM_002305.2~uORF:IOH3861	1061	45	1016
B31R05C19	31-19-5	Hs~MGC:BC020197.1~uORF:IOH13293	679	44	635
B31R05C20	31-20-5	Hs~MGC:BC020197.1~uORF:IOH13293	626	45	581
B31R05C21	31-21-5	Hs~Ref:NM_031468.1~uORF:IOH13340	338	51	287
B31R05C22	31-22-5	Hs~Ref:NM_031468.1~uORF:IOH13340	357	55	302
B31R06C01	31-1-6	Hs~Ref:NM_017495.3~uORF:IOH13305	348	42	306
B31R06C02	31-2-6	Hs~Ref:NM_017495.3~uORF:IOH13305	246	40	206
B31R06C03	31-3-6	Hs~Ref:NM_206917.1~uORF:IOH45829	215	42	173
B31R06C04	31-4-6	Hs~Ref:NM_206917.1~uORF:IOH45829	154	79	75
B31R06C05	31-5-6	Hs~Ref:NM_198197.1~uORF:IOH45782	313	146	167
B31R06C06	31-6-6	Hs~Ref:NM_198197.1~uORF:IOH45782	187	41	146
B31R06C07	31-7-6	Hs~Ref:NM_172002.3~uORF:IOH45832	293	44	249
B31R06C08	31-8-6	Hs~Ref:NM_172002.3~uORF:IOH45832	280	44	236
B31R06C09	31-9-6	Hs~Ref:NM_201516.1~uORF:IOH45833	389	42	347
B31R06C10	31-10-6	Hs~Ref:NM_201516.1~uORF:IOH45833	391	43	348
B31R06C11	31-11-6	Hs~Ref:NM_080675.2~uORF:IOH10614	744	44	700
B31R06C12	31-12-6	Hs~Ref:NM_080675.2~uORF:IOH10614	773	45	728
B31R06C13	31-13-6	Hs~MGC:BC021250.1~uORF:IOH23082	491	44	447
B31R06C14	31-14-6	Hs~MGC:BC021250.1~uORF:IOH23082	449	45	404
B31R06C15	31-15-6	Hs~MGC:BC020868.1~uORF:IOH12287	509	45	464
B31R06C16	31-16-6	Hs~MGC:BC020868.1~uORF:IOH12287	502	46	456
B31R06C17	31-17-6	Hs~Ref:NM_017863.2~uORF:IOH45788	385	47	338
B31R06C18	31-18-6	Hs~Ref:NM_017863.2~uORF:IOH45788	374	49	325
B31R06C19	31-19-6	Hs~Ref:NM_015888.3~uORF:IOH57157	295	121	174
B31R06C20	31-20-6	Hs~Ref:NM_015888.3~uORF:IOH57157	306	46	260
B31R06C21	31-21-6	Hs~Ref:NM_018290.2~uORF:IOH55528	93	57	36
B31R06C22	31-22-6	Hs~Ref:NM_018290.2~uORF:IOH55528	89	84	5
B31R07C01	31-1-7	Hs~MGC:BC022494.1~uORF:IOH56010	190	50	140
B31R07C02	31-2-7	Hs~MGC:BC022494.1~uORF:IOH56010	85	62	23
B31R07C03	31-3-7	Hs~MGC:BC030958.1~uORF:IOH23152	156	42	114
B31R07C04	31-4-7	Hs~MGC:BC030958.1~uORF:IOH23152	222	94	128
B31R07C05	31-5-7	Hs~Ref:NM_001744.2~uORF:IOH13877	355	51	304
B31R07C06	31-6-7	Hs~Ref:NM_001744.2~uORF:IOH13877	190	48	142
B31R07C07	31-7-7	Hs~MGC:BC024291.1~uORF:IOH14775	286	104	182
B31R07C08	31-8-7	Hs~MGC:BC024291.1~uORF:IOH14775	227	46	181
B31R07C09	31-9-7	Hs~MGC:BC017236.1~uORF:IOH14401	123	43	80
B31R07C10	31-10-7	Hs~MGC:BC017236.1~uORF:IOH14401	241	77	164
B31R07C11	31-11-7	Hs~Ref:NM_003656.3~uORF:IOH21059	291	55	236
B31R07C12	31-12-7	Hs~Ref:NM_003656.3~uORF:IOH21059	384	74	310
B31R07C13	31-13-7	Hs~Ref:NM_006930.2~uORF:IOH11897	165	47	118
B31R07C14	31-14-7	Hs~Ref:NM_006930.2~uORF:IOH11897	328	183	145
B31R07C15	31-15-7	Hs~MGC:BC040272.1~uORF:IOH27314	951	47	904
B31R07C16	31-16-7	Hs~MGC:BC040272.1~uORF:IOH27314	889	45	844
B31R07C17	31-17-7	Hs~Ref:NM_002987.2~uORF:IOH39735	226	97	129
B31R07C18	31-18-7	Hs~Ref:NM_002987.2~uORF:IOH39735	424	188	236
B31R07C19	31-19-7	Hs~MGC:BC029529.1~uORF:IOH27222	423	114	309
B31R07C20	31-20-7	Hs~MGC:BC029529.1~uORF:IOH27222	347	83	264
B31R07C21	31-21-7	Hs~Ref:NM_000459.1~N/A	595	44	551
B31R07C22	31-22-7	Hs~Ref:NM_000459.1~N/A	579	45	534
B31R08C01	31-1-8	Hs~Ref:NM_002577.1~N/A	411	47	364
B31R08C02	31-2-8	Hs~Ref:NM_002577.1~N/A	474	52	422
B31R08C03	31-3-8	Hs~Ref:NM_000061.1~N/A	465	44	421
B31R08C04	31-4-8	Hs~Ref:NM_000061.1~N/A	468	44	424
B31R08C05	31-5-8	Hs~Ref:NM_006254.1~N/A	484	45	439
B31R08C06	31-6-8	Hs~Ref:NM_006254.1~N/A	475	46	429
B31R08C07	31-7-8	Hs~MGC:BC032370.1~uORF:IOH21637	255	50	205
B31R08C08	31-8-8	Hs~MGC:BC032370.1~uORF:IOH21637	242	51	191
B31R08C09	31-9-8	Hs~MGC:BC012926.1~uORF:IOH9695	1611	45	1566
B31R08C10	31-10-8	Hs~MGC:BC012926.1~uORF:IOH9695	1464	44	1420
B31R08C11	31-11-8	Hs~MGC:BC031663.1~uORF:IOH27378	96	50	46
B31R08C12	31-12-8	Hs~MGC:BC031663.1~uORF:IOH27378	105	52	53
B31R08C13	31-13-8	Hs~MGC:BC015182.1~uORF:IOH11570	345	51	294
B31R08C14	31-14-8	Hs~MGC:BC015182.1~uORF:IOH11570	459	50	409
B31R08C15	31-15-8	Hs~Ref:NM_180699.1~uORF:IOH44651	4619	46	4573
B31R08C16	31-16-8	Hs~Ref:NM_180699.1~uORF:IOH44651	4134	43	4091
B31R08C17	31-17-8	Hs~Ref:NM_016430.2~uORF:IOH44539	698	45	653
B31R08C18	31-18-8	Hs~Ref:NM_016430.2~uORF:IOH44539	767	44	723
B31R08C19	31-19-8	Hs~Ref:NM_005125.1~uORF:IOH44423	864	47	817
B31R08C20	31-20-8	Hs~Ref:NM_005125.1~uORF:IOH44423	898	47	851
B31R08C21	31-21-8	Hs~Ref:NM_005669.3~uORF:IOH45648	492	46	446
B31R08C22	31-22-8	Hs~Ref:NM_005669.3~uORF:IOH45648	410	47	363
B31R09C01	31-1-9	Hs~Ref:NM_017830.1~uORF:IOH3035	597	44	553
B31R09C02	31-2-9	Hs~Ref:NM_017830.1~uORF:IOH3035	571	46	525
B31R09C03	31-3-9	Hs~MGC:BC013737.1~uORF:IOH11914	347	67	280
B31R09C04	31-4-9	Hs~MGC:BC013737.1~uORF:IOH11914	212	46	166
B31R09C05	31-5-9	Hs~Ref:NM_021165.1~uORF:IOH21556	162	101	61
B31R09C06	31-6-9	Hs~Ref:NM_021165.1~uORF:IOH21556	121	42	79
B31R09C07	31-7-9	Hs~MGC:BC033621.2~uORF:IOH21688	1020	46	974
B31R09C08	31-8-9	Hs~MGC:BC033621.2~uORF:IOH21688	1007	47	960
B31R09C09	31-9-9	Hs~MGC:BC008353.1~uORF:IOH6984	288	45	243
B31R09C10	31-10-9	Hs~MGC:BC008353.1~uORF:IOH6984	269	43	226
B31R09C11	31-11-9	Hs~MGC:BC037982.1~uORF:IOH25936	364	47	317
B31R09C12	31-12-9	Hs~MGC:BC037982.1~uORF:IOH25936	379	45	334
B31R09C13	31-13-9	Hs~Ref:NM_005879.2~uORF:IOH3484	423	42	381
B31R09C14	31-14-9	Hs~Ref:NM_005879.2~uORF:IOH3484	440	42	398
B31R09C15	31-15-9	Hs~Ref:NM_005084.2~uORF:IOH25919	474	45	429
B31R09C16	31-16-9	Hs~Ref:NM_005084.2~uORF:IOH25919	374	44	330
B31R09C17	31-17-9	Hs~MGC:BC008919.2~uORF:IOH46149	254	47	207
B31R09C18	31-18-9	Hs~MGC:BC008919.2~uORF:IOH46149	283	49	234
B31R09C19	31-19-9	Hs~Ref:NM_033115.2~uORF:IOH46178	494	82	412
B31R09C20	31-20-9	Hs~Ref:NM_033115.2~uORF:IOH46178	384	57	327
B31R09C21	31-21-9	Hs~Ref:NM_001010905.1~uORF:IOH46114	346	47	299
B31R09C22	31-22-9	Hs~Ref:NM_001010905.1~uORF:IOH46114	90	46	44
B31R10C01	31-1-10	Hs~MGC:BC017258.2~uORF:IOH46181	172	40	132
B31R10C02	31-2-10	Hs~MGC:BC017258.2~uORF:IOH46181	165	41	124
B31R10C03	31-3-10	Hs~MGC:BC064485.1~uORF:IOH40682	342	50	292
B31R10C04	31-4-10	Hs~MGC:BC064485.1~uORF:IOH40682	248	43	205
B31R10C05	31-5-10	Hs~Ref:NM_014519.2~uORF:IOH40635	439	41	398
B31R10C06	31-6-10	Hs~Ref:NM_014519.2~uORF:IOH40635	439	42	397
B31R10C07	31-7-10	Hs~Ref:NM_198949.1~uORF:IOH40684	134	43	91
B31R10C08	31-8-10	Hs~Ref:NM_198949.1~uORF:IOH40684	116	43	73
B31R10C09	31-9-10	Hs~MGC:BC064515.1~uORF:IOH40670	298	49	249
B31R10C10	31-10-10	Hs~MGC:BC064515.1~uORF:IOH40670	356	46	310
B31R10C11	31-11-10	GST1	45	41	4
B31R10C12	31-12-10	GST1	64	43	21
B31R10C13	31-13-10	GST2	45	41	4
B31R10C14	31-14-10	GST2	46	40	6
B31R10C15	31-15-10	GST3	51	42	9
B31R10C16	31-16-10	GST3	44	43	1
B31R10C17	31-17-10	GST4	66	41	25
B31R10C18	31-18-10	GST4	134	49	85
B31R10C19	31-19-10	Anti-HumanIgA1~N/A	8793	43	8750
B31R10C20	31-20-10	Anti-HumanIgA1~N/A	8413	43	8370
B31R10C21	31-21-10	Anti-HumanIgA2~N/A	14554	45	14509
B31R10C22	31-22-10	Anti-HumanIgA2~N/A	14441	44	14397
B31R11C01	31-1-11	AlexaAntiMouseAb~N/A	26301	40	26261
B31R11C02	31-2-11	AlexaAntiMouseAb~N/A	23148	41	23107
B31R11C03	31-3-11	MAPKAP~N/A	103	40	63
B31R11C04	31-4-11	MAPKAP~N/A	94	41	53
B31R11C05	31-5-11	Buffer	2139	40	2099
B31R11C06	31-6-11	Buffer	2112	40	2072
B31R11C07	31-7-11	BSA~N/A	9352	42	9310
B31R11C08	31-8-11	BSA~N/A	9136	44	9092
B31R11C09	31-9-11	Anti-HumanIgG1~N/A	1755	42	1713
B31R11C10	31-10-11	Anti-HumanIgG1~N/A	1749	44	1705
B31R11C11	31-11-11	Anti-HumanIgG2~N/A	3272	46	3226
B31R11C12	31-12-11	Anti-HumanIgG2~N/A	3274	47	3227
B31R11C13	31-13-11	Anti-HumanIgG3~N/A	6121	44	6077
B31R11C14	31-14-11	Anti-HumanIgG3~N/A	6054	43	6011
B31R11C15	31-15-11	Anti-HumanIgG4~N/A	11675	44	11631
B31R11C16	31-16-11	Anti-HumanIgG4~N/A	11246	44	11202
B31R11C17	31-17-11	AntiBiotinAb~N/A	11934	41	11893
B31R11C18	31-18-11	AntiBiotinAb~N/A	11985	41	11944
B31R11C19	31-19-11	Buffer	63	43	20
B31R11C20	31-20-11	Buffer	54	41	13
B31R11C21	31-21-11	Hs~Ref:NM_001156.2~uORF:IOH5300	921	41	880
B31R11C22	31-22-11	Hs~Ref:NM_001156.2~uORF:IOH5300	773	41	732
B31R12C01	31-1-12	Hs~Ref:NM_001001974.1~uORF:IOH3868	682	41	641
B31R12C02	31-2-12	Hs~Ref:NM_001001974.1~uORF:IOH3868	647	40	607
B31R12C03	31-3-12	Hs~Ref:NM_017677.2~uORF:IOH10557	400	42	358
B31R12C04	31-4-12	Hs~Ref:NM_017677.2~uORF:IOH10557	387	43	344
B31R12C05	31-5-12	Hs~Ref:NM_006745.2~uORF:IOH9727	268	44	224
B31R12C06	31-6-12	Hs~Ref:NM_006745.2~uORF:IOH9727	332	64	268
B31R12C07	31-7-12	Hs~MGC:BC017046.1~uORF:IOH11667	316	48	268
B31R12C08	31-8-12	Hs~MGC:BC017046.1~uORF:IOH11667	361	79	282
B31R12C09	31-9-12	Hs~Ref:NM_005550.2~uORF:IOH22889	865	46	819
B31R12C10	31-10-12	Hs~Ref:NM_005550.2~uORF:IOH22889	860	46	814
B31R12C11	31-11-12	Hs~Ref:NM_001819.1~uORF:IOH3444	686	50	636
B31R12C12	31-12-12	Hs~Ref:NM_001819.1~uORF:IOH3444	655	49	606
B31R12C13	31-13-12	Hs~MGC:BC000712.1~uORF:IOH4703	3836	44	3792
B31R12C14	31-14-12	Hs~MGC:BC000712.1~uORF:IOH4703	3654	44	3610
B31R12C15	31-15-12	Hs~Ref:NM_005967.2~uORF:IOH45658	911	43	868
B31R12C16	31-16-12	Hs~Ref:NM_005967.2~uORF:IOH45658	829	41	788
B31R12C17	31-17-12	Hs~Ref:NM_000897.2~uORF:IOH45547	891	41	850
B31R12C18	31-18-12	Hs~Ref:NM_000897.2~uORF:IOH45547	893	44	849
B31R12C19	31-19-12	Hs~Ref:NM_003928.1~uORF:IOH45869	730	43	687
B31R12C20	31-20-12	Hs~Ref:NM_003928.1~uORF:IOH45869	733	43	690
B31R12C21	31-21-12	Hs~Ref:NM_004074.2~uORF:IOH45641	682	42	640
B31R12C22	31-22-12	Hs~Ref:NM_004074.2~uORF:IOH45641	633	41	592
B31R13C01	31-1-13	Hs~MGC:BC038713.1~uORF:IOH27724	475	41	434
B31R13C02	31-2-13	Hs~MGC:BC038713.1~uORF:IOH27724	470	40	430
B31R13C03	31-3-13	Hs~MGC:BC016609.1~uORF:IOH11216	879	44	835
B31R13C04	31-4-13	Hs~MGC:BC016609.1~uORF:IOH11216	839	43	796
B31R13C05	31-5-13	Hs~Ref:NM_003845.1~uORF:IOH21591	143	71	72
B31R13C06	31-6-13	Hs~Ref:NM_003845.1~uORF:IOH21591	123	42	81
B31R13C07	31-7-13	Hs~Ref:NM_024081.4~uORF:IOH12575	78	41	37
B31R13C08	31-8-13	Hs~Ref:NM_024081.4~uORF:IOH12575	102	66	36
B31R13C09	31-9-13	Hs~Ref:NM_001008572.1~uORF:IOH45757	879	44	835
B31R13C10	31-10-13	Hs~Ref:NM_001008572.1~uORF:IOH45757	749	46	703
B31R13C11	31-11-13	Hs~Ref:NM_006313.1~uORF:IOH60028	510	51	459
B31R13C12	31-12-13	Hs~Ref:NM_006313.1~uORF:IOH60028	464	51	413
B31R13C13	31-13-13	Hs~Ref:NM_013278.3~uORF:IOH34775	586	45	541
B31R13C14	31-14-13	Hs~Ref:NM_013278.3~uORF:IOH34775	585	43	542
B31R13C15	31-15-13	Hs~MGC:BC074721.2~uORF:IOH61917	213	44	169
B31R13C16	31-16-13	Hs~MGC:BC074721.2~uORF:IOH61917	359	45	314
B31R13C17	31-17-13	Hs~MGC:BC016842.1~uORF:IOH10739	250	45	205
B31R13C18	31-18-13	Hs~MGC:BC016842.1~uORF:IOH10739	332	116	216
B31R13C19	31-19-13	Hs~Ref:NM_006117.1~uORF:IOH21097	308	46	262
B31R13C20	31-20-13	Hs~Ref:NM_006117.1~uORF:IOH21097	339	47	292
B31R13C21	31-21-13	Hs~MGC:BC002460.1~uORF:IOH4190	264	45	219
B31R13C22	31-22-13	Hs~MGC:BC002460.1~uORF:IOH4190	270	43	227
B31R14C01	31-1-14	Hs~Ref:NM_001218.2~uORF:IOH14010	483	42	441
B31R14C02	31-2-14	Hs~Ref:NM_001218.2~uORF:IOH14010	437	43	394
B31R14C03	31-3-14	Hs~Ref:NM_001006624.1~uORF:IOH58664	158	45	113
B31R14C04	31-4-14	Hs~Ref:NM_001006624.1~uORF:IOH58664	146	44	102
B31R14C05	31-5-14	Hs~Ref:NM_175725.1~uORF:IOH53929	137	43	94
B31R14C06	31-6-14	Hs~Ref:NM_175725.1~uORF:IOH53929	119	42	77
B31R14C07	31-7-14	Hs~Ref:NM_003935.3~uORF:IOH54164	1254	39	1215
B31R14C08	31-8-14	Hs~Ref:NM_003935.3~uORF:IOH54164	1263	42	1221
B31R14C09	31-9-14	Hs~Ref:NM_003919.1~uORF:IOH53992	356	49	307
B31R14C10	31-10-14	Hs~Ref:NM_003919.1~uORF:IOH53992	380	45	335
B31R14C11	31-11-14	Hs~Ref:NM_004436.1~uORF:IOH3457	2770	48	2722
B31R14C12	31-12-14	Hs~Ref:NM_004436.1~uORF:IOH3457	2666	46	2620
B31R14C13	31-13-14	Hs~MGC:BC013957.1~uORF:IOH13899	14265	44	14221
B31R14C14	31-14-14	Hs~MGC:BC013957.1~uORF:IOH13899	14342	42	14300
B31R14C15	31-15-14	Hs~Ref:NM_003141.2~uORF:IOH9948	65535	42	65493
B31R14C16	31-16-14	Hs~Ref:NM_003141.2~uORF:IOH9948	65535	43	65492
B31R14C17	31-17-14	Hs~Ref:NM_002149.2~uORF:IOH13481	147	45	102
B31R14C18	31-18-14	Hs~Ref:NM_002149.2~uORF:IOH13481	470	75	395
B31R14C19	31-19-14	Hs~MGC:BC068599.1~uORF:IOH60376	428	143	285
B31R14C20	31-20-14	Hs~MGC:BC068599.1~uORF:IOH60376	409	92	317
B31R14C21	31-21-14	Hs~MGC:BC062331.1~uORF:IOH62974	363	45	318
B31R14C22	31-22-14	Hs~MGC:BC062331.1~uORF:IOH62974	353	43	310
B31R15C01	31-1-15	Hs~MGC:BC063414.1~uORF:IOH61544	428	42	386
B31R15C02	31-2-15	Hs~MGC:BC063414.1~uORF:IOH61544	372	43	329
B31R15C03	31-3-15	Hs~MGC:BC064521.1~uORF:IOH61569	276	52	224
B31R15C04	31-4-15	Hs~MGC:BC064521.1~uORF:IOH61569	166	54	112
B31R15C05	31-5-15	Hs~MGC:BC057831.1~uORF:IOH29174	153	85	68
B31R15C06	31-6-15	Hs~MGC:BC057831.1~uORF:IOH29174	173	92	81
B31R15C07	31-7-15	Hs~MGC:BC060317.1~uORF:IOH29297	109	40	69
B31R15C08	31-8-15	Hs~MGC:BC060317.1~uORF:IOH29297	110	41	69
B31R15C09	31-9-15	Hs~MGC:BC057848.1~uORF:IOH29211	124	44	80
B31R15C10	31-10-15	Hs~MGC:BC057848.1~uORF:IOH29211	199	58	141
B31R15C11	31-11-15	Hs~MGC:BC058819.1~uORF:IOH29418	112	78	34
B31R15C12	31-12-15	Hs~MGC:BC058819.1~uORF:IOH29418	92	42	50
B31R15C13	31-13-15	Hs~Ref:NM_023109.1~CAT:PV3146	415	43	372
B31R15C14	31-14-15	Hs~Ref:NM_023109.1~CAT:PV3146	436	42	394
B31R15C15	31-15-15	Hs~Ref:NP_002341~CAT:P2906	540	42	498
B31R15C16	31-16-15	Hs~Ref:NP_002341~CAT:P2906	491	43	448
B31R15C17	31-17-15	Hs~Ref:NM_006343.1~CAT:PV3627	67	41	26
B31R15C18	31-18-15	Hs~Ref:NM_006343.1~CAT:PV3627	68	41	27
B31R15C19	31-19-15	Hs~Ref:NM_014496.1~CAT:PV4557	3905	42	3863
B31R15C20	31-20-15	Hs~Ref:NM_014496.1~CAT:PV4557	3871	43	3828
B31R15C21	31-21-15	Hs~Ref:NM_001007156.1~CAT:PV3617	401	43	358
B31R15C22	31-22-15	Hs~Ref:NM_001007156.1~CAT:PV3617	422	42	380
B31R16C01	31-1-16	Hs~Ref:NM_001715.2~CAT:PV3683	99	41	58
B31R16C02	31-2-16	Hs~Ref:NM_001715.2~CAT:PV3683	160	81	79
B31R16C03	31-3-16	Hs~Ref:NM_198578.2~CAT:PV4881	402	40	362
B31R16C04	31-4-16	Hs~Ref:NM_198578.2~CAT:PV4881	431	39	392
B31R16C05	31-5-16	Hs~Ref:NM_000965.2~CAT:PV4716	88	42	46
B31R16C06	31-6-16	Hs~Ref:NM_000965.2~CAT:PV4716	72	51	21
B31R16C07	31-7-16	Hs~Ref:NM_001031726.1~uORF:IOH61516	106	40	66
B31R16C08	31-8-16	Hs~Ref:NM_001031726.1~uORF:IOH61516	96	44	52
B31R16C09	31-9-16	Hs~Ref:NM_001040663.1~uORF:IOH61866	324	54	270
B31R16C10	31-10-16	Hs~Ref:NM_001040663.1~uORF:IOH61866	325	72	253
B31R16C11	31-11-16	Hs~MGC:BC094747.1~uORF:IOH62638	394	45	349
B31R16C12	31-12-16	Hs~MGC:BC094747.1~uORF:IOH62638	404	44	360
B31R16C13	31-13-16	Hs~MGC:BC088370.1~uORF:IOH62603	323	93	230
B31R16C14	31-14-16	Hs~MGC:BC088370.1~uORF:IOH62603	326	52	274
B31R16C15	31-15-16	Hs~MGC:BC022244.1~uORF:IOH28623	330	52	278
B31R16C16	31-16-16	Hs~MGC:BC022244.1~uORF:IOH28623	307	63	244
B31R16C17	31-17-16	Hs~MGC:BC053594.1~uORF:IOH28968	366	44	322
B31R16C18	31-18-16	Hs~MGC:BC053594.1~uORF:IOH28968	353	42	311
B31R16C19	31-19-16	Hs~MGC:BC037571.1~uORF:IOH28701	361	41	320
B31R16C20	31-20-16	Hs~MGC:BC037571.1~uORF:IOH28701	316	43	273
B31R16C21	31-21-16	Hs~MGC:BC056682.1~uORF:IOH29473	443	62	381
B31R16C22	31-22-16	Hs~MGC:BC056682.1~uORF:IOH29473	462	65	397
B31R17C01	31-1-17	Hs~MGC:BC026238.1~uORF:IOH13560	489	41	448
B31R17C02	31-2-17	Hs~MGC:BC026238.1~uORF:IOH13560	487	42	445
B31R17C03	31-3-17	Hs~MGC:NM_152448.1~uORF:IOH22571	644	40	604
B31R17C04	31-4-17	Hs~MGC:NM_152448.1~uORF:IOH22571	671	40	631
B31R17C05	31-5-17	Hs~MGC:BC021266.1~uORF:IOH14195	672	41	631
B31R17C06	31-6-17	Hs~MGC:BC021266.1~uORF:IOH14195	742	41	701
B31R17C07	31-7-17	Hs~Ref:NM_004617.2~uORF:IOH3961	550	42	508
B31R17C08	31-8-17	Hs~Ref:NM_004617.2~uORF:IOH3961	491	44	447
B31R17C09	31-9-17	Hs~Ref:NM_004888.2~uORF:IOH7535	1130	48	1082
B31R17C10	31-10-17	Hs~Ref:NM_004888.2~uORF:IOH7535	1033	49	984
B31R17C11	31-11-17	Hs~Ref:NM_019087.1~uORF:IOH14821	210	164	46
B31R17C12	31-12-17	Hs~Ref:NM_019087.1~uORF:IOH14821	216	165	51
B31R17C13	31-13-17	Hs~MGC:BC004955.1~uORF:IOH5528	345	48	297
B31R17C14	31-14-17	Hs~MGC:BC004955.1~uORF:IOH5528	340	48	292
B31R17C15	31-15-17	Hs~Ref:NM_022747.1~uORF:IOH22152	240	50	190
B31R17C16	31-16-17	Hs~Ref:NM_022747.1~uORF:IOH22152	237	97	140
B31R17C17	31-17-17	Hs~MGC:BC000395.1~uORF:IOH3542	295	49	246
B31R17C18	31-18-17	Hs~MGC:BC000395.1~uORF:IOH3542	351	53	298
B31R17C19	31-19-17	Hs~Ref:NM_080658.1~uORF:IOH3352	337	49	288
B31R17C20	31-20-17	Hs~Ref:NM_080658.1~uORF:IOH3352	338	49	289
B31R17C21	31-21-17	Hs~MGC:BC008031.1~uORF:IOH7008	157	64	93
B31R17C22	31-22-17	Hs~MGC:BC008031.1~uORF:IOH7008	233	133	100
B31R18C01	31-1-18	Hs~MGC:BC009696.1~uORF:IOH9811	379	51	328
B31R18C02	31-2-18	Hs~MGC:BC009696.1~uORF:IOH9811	440	70	370
B31R18C03	31-3-18	Hs~Ref:NM_002402.1~uORF:IOH3706	441	45	396
B31R18C04	31-4-18	Hs~Ref:NM_002402.1~uORF:IOH3706	424	44	380
B31R18C05	31-5-18	Hs~MGC:BC024939.1~uORF:IOH21470	344	45	299
B31R18C06	31-6-18	Hs~MGC:BC024939.1~uORF:IOH21470	413	52	361
B31R18C07	31-7-18	Hs~MGC:BC000120.1~uORF:IOH4407	335	44	291
B31R18C08	31-8-18	Hs~MGC:BC000120.1~uORF:IOH4407	356	46	310
B31R18C09	31-9-18	Hs~Ref:NM_020239.2~uORF:IOH21482	42	44	-2
B31R18C10	31-10-18	Hs~Ref:NM_020239.2~uORF:IOH21482	42	45	-3
B31R18C11	31-11-18	Hs~MGC:BC060814.1~uORF:IOH39802	40	42	-2
B31R18C12	31-12-18	Hs~MGC:BC060814.1~uORF:IOH39802	38	41	-3
B31R18C13	31-13-18	Hs~MGC:BC036056.1~uORF:IOH27184	7865	44	7821
B31R18C14	31-14-18	Hs~MGC:BC036056.1~uORF:IOH27184	7560	43	7517
B31R18C15	31-15-18	Hs~Ref:XM_498434.1~uORF:IOH57016	460	47	413
B31R18C16	31-16-18	Hs~Ref:XM_498434.1~uORF:IOH57016	438	49	389
B31R18C17	31-17-18	Hs~Ref:NM_182481.1~uORF:IOH58617	390	49	341
B31R18C18	31-18-18	Hs~Ref:NM_182481.1~uORF:IOH58617	426	132	294
B31R18C19	31-19-18	Hs~Ref:NM_017839.3~uORF:IOH40661	462	53	409
B31R18C20	31-20-18	Hs~Ref:NM_017839.3~uORF:IOH40661	431	57	374
B31R18C21	31-21-18	Hs~Ref:NM_005034.2~uORF:IOH10479	583	46	537
B31R18C22	31-22-18	Hs~Ref:NM_005034.2~uORF:IOH10479	546	43	503
B31R19C01	31-1-19	Hs~Ref:NM_014763.2~uORF:IOH23003	3359	43	3316
B31R19C02	31-2-19	Hs~Ref:NM_014763.2~uORF:IOH23003	3262	48	3214
B31R19C03	31-3-19	Hs~Ref:NM_003992.1~N/A	410	50	360
B31R19C04	31-4-19	Hs~Ref:NM_003992.1~N/A	337	46	291
B31R19C05	31-5-19	Hs~Ref:NM_004887.2~uORF:IOH5492	288	47	241
B31R19C06	31-6-19	Hs~Ref:NM_004887.2~uORF:IOH5492	617	45	572
B31R19C07	31-7-19	Hs~Ref:NM_016511.1~uORF:IOH27414	504	41	463
B31R19C08	31-8-19	Hs~Ref:NM_016511.1~uORF:IOH27414	549	43	506
B31R19C09	31-9-19	Hs~MGC:BC029869.1~uORF:IOH22797	472	55	417
B31R19C10	31-10-19	Hs~MGC:BC029869.1~uORF:IOH22797	458	61	397
B31R19C11	31-11-19	Hs~Ref:NM_013342.1~uORF:IOH5505	463	46	417
B31R19C12	31-12-19	Hs~Ref:NM_013342.1~uORF:IOH5505	441	41	400
B31R19C13	31-13-19	Hs~MGC:BC001304.1~uORF:IOH45994	13609	44	13565
B31R19C14	31-14-19	Hs~MGC:BC001304.1~uORF:IOH45994	15612	45	15567
B31R19C15	31-15-19	Hs~Ref:NM_004755.2~uORF:IOH45179	489	46	443
B31R19C16	31-16-19	Hs~Ref:NM_004755.2~uORF:IOH45179	530	45	485
B31R19C17	31-17-19	Hs~Ref:XM_379117.1~uORF:IOH43619	621	44	577
B31R19C18	31-18-19	Hs~Ref:XM_379117.1~uORF:IOH43619	626	50	576
B31R19C19	31-19-19	Hs~Ref:NM_207013.1~uORF:IOH42170	468	56	412
B31R19C20	31-20-19	Hs~Ref:NM_207013.1~uORF:IOH42170	505	200	305
B31R19C21	31-21-19	Hs~MGC:BC017117.1~uORF:IOH10010	807	46	761
B31R19C22	31-22-19	Hs~MGC:BC017117.1~uORF:IOH10010	729	42	687
B31R20C01	31-1-20	Hs~MGC:BC011400.1~uORF:IOH9691	849	40	809
B31R20C02	31-2-20	Hs~MGC:BC011400.1~uORF:IOH9691	832	40	792
B31R20C03	31-3-20	Hs~MGC:BC010518.1~uORF:IOH10184	1276	44	1232
B31R20C04	31-4-20	Hs~MGC:BC010518.1~uORF:IOH10184	1196	44	1152
B31R20C05	31-5-20	Hs~Ref:NM_033414.1~uORF:IOH10240	935	42	893
B31R20C06	31-6-20	Hs~Ref:NM_033414.1~uORF:IOH10240	929	40	889
B31R20C07	31-7-20	Hs~Ref:NM_012437.2~uORF:IOH3724	36	38	-2
B31R20C08	31-8-20	Hs~Ref:NM_012437.2~uORF:IOH3724	39	40	-1
B31R20C09	31-9-20	Hs~MGC:BC015738.1~uORF:IOH14824	384	72	312
B31R20C10	31-10-20	Hs~MGC:BC015738.1~uORF:IOH14824	358	306	52
B31R20C11	31-11-20	Hs~MGC:BC001780.1~uORF:IOH4955	527	54	473
B31R20C12	31-12-20	Hs~MGC:BC001780.1~uORF:IOH4955	487	42	445
B31R20C13	31-13-20	Hs~MGC:BC002737.1~uORF:IOH5347	275	46	229
B31R20C14	31-14-20	Hs~MGC:BC002737.1~uORF:IOH5347	217	45	172
B31R20C15	31-15-20	Hs~MGC:BC037951.1~uORF:IOH27587	380	45	335
B31R20C16	31-16-20	Hs~MGC:BC037951.1~uORF:IOH27587	355	40	315
B31R20C17	31-17-20	Hs~MGC:BC036710.1~uORF:IOH27903	473	48	425
B31R20C18	31-18-20	Hs~MGC:BC036710.1~uORF:IOH27903	465	60	405
B31R20C19	31-19-20	Hs~MGC:BC056904.1~uORF:IOH29048	674	54	620
B31R20C20	31-20-20	Hs~MGC:BC056904.1~uORF:IOH29048	714	45	669
B31R20C21	31-21-20	Hs~MGC:XM_372390.1~uORF:IOH28515	438	48	390
B31R20C22	31-22-20	Hs~MGC:XM_372390.1~uORF:IOH28515	478	50	428
B31R21C01	31-1-21	Hs~Ref:NM_020879.1~uORF:IOH27213	268	105	163
B31R21C02	31-2-21	Hs~Ref:NM_020879.1~uORF:IOH27213	176	104	72
B31R21C03	31-3-21	Hs~Ref:NM_173567.2~uORF:IOH26302	379	111	268
B31R21C04	31-4-21	Hs~Ref:NM_173567.2~uORF:IOH26302	363	169	194
B31R21C05	31-5-21	Hs~Ref:BC032944.2~uORF:IOH27157	102	41	61
B31R21C06	31-6-21	Hs~Ref:BC032944.2~uORF:IOH27157	186	42	144
B31R21C07	31-7-21	Hs~MGC:BC037209.1~uORF:IOH27670	225	78	147
B31R21C08	31-8-21	Hs~MGC:BC037209.1~uORF:IOH27670	104	41	63
B31R21C09	31-9-21	Hs~Ref:NP_000607.1~CAT_10400-H03H-25	14088	54	14034
B31R21C10	31-10-21	Hs~Ref:NP_000607.1~CAT_10400-H03H-25	14480	66	14414
B31R21C11	31-11-21	Internal_1007209	81	47	34
B31R21C12	31-12-21	Internal_1007209	76	45	31
B31R21C13	31-13-21	Hs~Ref:P15391~CAT_11880-H08H-25	170	58	112
B31R21C14	31-14-21	Hs~Ref:P15391~CAT_11880-H08H-25	71	39	32
B31R21C15	31-15-21	Internal_1007209	44	38	6
B31R21C16	31-16-21	Internal_1007209	45	38	7
B31R21C17	31-17-21	Hs~Ref:NP_054862.1~CAT_10084-H02H-25	11365	46	11319
B31R21C18	31-18-21	Hs~Ref:NP_054862.1~CAT_10084-H02H-25	12543	54	12489
B31R21C19	31-19-21	Internal_1007209	4372	51	4321
B31R21C20	31-20-21	Internal_1007209	4402	42	4360
B31R21C21	31-21-21	Hs~IVGN:NM_000758~CAT_PHC2011~N/A	8438	43	8395
B31R21C22	31-22-21	Hs~IVGN:NM_000758~CAT_PHC2011~N/A	8142	42	8100
B31R22C01	31-1-22	ERa~N/A	2752	37	2715
B31R22C02	31-2-22	ERa~N/A	2880	38	2842
B31R22C03	31-3-22	PKCeta~N/A	807	39	768
B31R22C04	31-4-22	PKCeta~N/A	828	39	789
B31R22C05	31-5-22	Calmodulin~N/A	882	38	844
B31R22C06	31-6-22	Calmodulin~N/A	893	38	855
B31R22C07	31-7-22	V5control5~N/A	1876	39	1837
B31R22C08	31-8-22	V5control5~N/A	1889	40	1849
B31R22C09	31-9-22	V5control4~N/A	303	46	257
B31R22C10	31-10-22	V5control4~N/A	331	44	287
B31R22C11	31-11-22	V5control3~N/A	339	49	290
B31R22C12	31-12-22	V5control3~N/A	321	40	281
B31R22C13	31-13-22	V5control2~N/A	331	39	292
B31R22C14	31-14-22	V5control2~N/A	357	39	318
B31R22C15	31-15-22	V5control1~N/A	412	39	373
B31R22C16	31-16-22	V5control1~N/A	384	38	346
B31R22C17	31-17-22	CMK2A~N/A	626	39	587
B31R22C18	31-18-22	CMK2A~N/A	606	41	565
B31R22C19	31-19-22	ERa~N/A	2061	41	2020
B31R22C20	31-20-22	ERa~N/A	2234	40	2194
B31R22C21	31-21-22	AlexaAntiMouseAb~N/A	10618	40	10578
B31R22C22	31-22-22	AlexaAntiMouseAb~N/A	9319	39	9280
B32R01C01	32-1-1	AlexaAntiMouseAb~N/A	32071	66	32005
B32R01C02	32-2-1	AlexaAntiMouseAb~N/A	32118	72	32046
B32R01C03	32-3-1	ERa~N/A	1920	45	1875
B32R01C04	32-4-1	ERa~N/A	1878	43	1835
B32R01C05	32-5-1	HumanIgG1~N/A	1032	42	990
B32R01C06	32-6-1	HumanIgG1~N/A	962	41	921
B32R01C07	32-7-1	HumanIgG2~N/A	2498	41	2457
B32R01C08	32-8-1	HumanIgG2~N/A	2413	41	2372
B32R01C09	32-9-1	HumanIgG3~N/A	11870	42	11828
B32R01C10	32-10-1	HumanIgG3~N/A	12291	43	12248
B32R01C11	32-11-1	HumanIgG4~N/A	37095	53	37042
B32R01C12	32-12-1	HumanIgG4~N/A	34622	50	34572
B32R01C13	32-13-1	BiotinAb~N/A	260	49	211
B32R01C14	32-14-1	BiotinAb~N/A	229	49	180
B32R01C15	32-15-1	RanBP2deltaFG~N/A	383	49	334
B32R01C16	32-16-1	RanBP2deltaFG~N/A	368	48	320
B32R01C17	32-17-1	hMDM2~N/A	761	46	715
B32R01C18	32-18-1	hMDM2~N/A	657	47	610
B32R01C19	32-19-1	PKCeta~N/A	327	47	280
B32R01C20	32-20-1	PKCeta~N/A	344	52	292
B32R01C21	32-21-1	AlexaAntiMouseAb~N/A	25016	49	24967
B32R01C22	32-22-1	AlexaAntiMouseAb~N/A	27235	48	27187
B32R02C01	32-1-2	PKCeta~N/A	734	50	684
B32R02C02	32-2-2	PKCeta~N/A	1126	73	1053
B32R02C03	32-3-2	Buffer	655	71	584
B32R02C04	32-4-2	Buffer	1196	331	865
B32R02C05	32-5-2	HumanIgA~N/A	17970	48	17922
B32R02C06	32-6-2	HumanIgA~N/A	18755	42	18713
B32R02C07	32-7-2	Buffer	88	42	46
B32R02C08	32-8-2	Buffer	93	41	52
B32R02C09	32-9-2	BSA~N/A	10836	41	10795
B32R02C10	32-10-2	BSA~N/A	11535	43	11492
B32R02C11	32-11-2	Hs~Ref:NM_053056.1~uORF:IOH1962	636	44	592
B32R02C12	32-12-2	Hs~Ref:NM_053056.1~uORF:IOH1962	719	57	662
B32R02C13	32-13-2	Hs~MGC:BC006410.1~uORF:IOH6249	336	74	262
B32R02C14	32-14-2	Hs~MGC:BC006410.1~uORF:IOH6249	324	60	264
B32R02C15	32-15-2	Hs~MGC:BC029611.1~uORF:IOH28688	1585	53	1532
B32R02C16	32-16-2	Hs~MGC:BC029611.1~uORF:IOH28688	2880	66	2814
B32R02C17	32-17-2	Hs~Ref:NM_007176.1~uORF:IOH4267	1416	206	1210
B32R02C18	32-18-2	Hs~Ref:NM_007176.1~uORF:IOH4267	1077	109	968
B32R02C19	32-19-2	Hs~MGC:BC032350.1~uORF:IOH21707	203	75	128
B32R02C20	32-20-2	Hs~MGC:BC032350.1~uORF:IOH21707	97	77	20
B32R02C21	32-21-2	Hs~Ref:NM_001756.2~uORF:IOH2195	187	50	137
B32R02C22	32-22-2	Hs~Ref:NM_001756.2~uORF:IOH2195	173	47	126
B32R03C01	32-1-3	Hs~Ref:NM_016188.3~uORF:IOH2230	600	53	547
B32R03C02	32-2-3	Hs~Ref:NM_016188.3~uORF:IOH2230	536	71	465
B32R03C03	32-3-3	Hs~Ref:NM_012095.2~uORF:IOH12776	758	69	689
B32R03C04	32-4-3	Hs~Ref:NM_012095.2~uORF:IOH12776	776	83	693
B32R03C05	32-5-3	Hs~Ref:NM_006427.2~uORF:IOH40965	270	69	201
B32R03C06	32-6-3	Hs~Ref:NM_006427.2~uORF:IOH40965	192	46	146
B32R03C07	32-7-3	Hs~Ref:NM_022170.1~uORF:IOH44460	504	45	459
B32R03C08	32-8-3	Hs~Ref:NM_022170.1~uORF:IOH44460	432	42	390
B32R03C09	32-9-3	Hs~Ref:NM_019885.2~uORF:IOH37861	101	41	60
B32R03C10	32-10-3	Hs~Ref:NM_019885.2~uORF:IOH37861	90	43	47
B32R03C11	32-11-3	Hs~MGC:BC066974.1~uORF:IOH40056	318	50	268
B32R03C12	32-12-3	Hs~MGC:BC066974.1~uORF:IOH40056	335	72	263
B32R03C13	32-13-3	Hs~Ref:NM_138348.3~uORF:IOH45908	541	56	485
B32R03C14	32-14-3	Hs~Ref:NM_138348.3~uORF:IOH45908	540	53	487
B32R03C15	32-15-3	Hs~Ref:NM_001752.2~uORF:IOH41295	804	52	752
B32R03C16	32-16-3	Hs~Ref:NM_001752.2~uORF:IOH41295	1061	62	999
B32R03C17	32-17-3	Hs~Ref:XM_379498.2~uORF:IOH44469	1433	83	1350
B32R03C18	32-18-3	Hs~Ref:XM_379498.2~uORF:IOH44469	1538	93	1445
B32R03C19	32-19-3	Hs~Ref:NM_194358.1~uORF:IOH45538	82	98	-16
B32R03C20	32-20-3	Hs~Ref:NM_194358.1~uORF:IOH45538	117	116	1
B32R03C21	32-21-3	Hs~MGC:BC016857.1~uORF:IOH10375	62	96	-34
B32R03C22	32-22-3	Hs~MGC:BC016857.1~uORF:IOH10375	51	80	-29
B32R04C01	32-1-4	Hs~MGC:NM_177403.3~uORF:IOH10406	390	66	324
B32R04C02	32-2-4	Hs~MGC:NM_177403.3~uORF:IOH10406	337	276	61
B32R04C03	32-3-4	Hs~Ref:NM_017853.1~uORF:IOH10793	424	59	365
B32R04C04	32-4-4	Hs~Ref:NM_017853.1~uORF:IOH10793	389	337	52
B32R04C05	32-5-4	Hs~Ref:NM_138777.1~uORF:IOH10791	469	82	387
B32R04C06	32-6-4	Hs~Ref:NM_138777.1~uORF:IOH10791	590	282	308
B32R04C07	32-7-4	Hs~Ref:NM_005272.2~uORF:IOH4363	348	50	298
B32R04C08	32-8-4	Hs~Ref:NM_005272.2~uORF:IOH4363	363	47	316
B32R04C09	32-9-4	Hs~MGC:NM_182488.1~uORF:IOH10698	447	44	403
B32R04C10	32-10-4	Hs~MGC:NM_182488.1~uORF:IOH10698	394	46	348
B32R04C11	32-11-4	Hs~Ref:NM_138379.1~uORF:IOH3316	442	47	395
B32R04C12	32-12-4	Hs~Ref:NM_138379.1~uORF:IOH3316	417	46	371
B32R04C13	32-13-4	Hs~Ref:NM_003666.1~uORF:IOH13812	608	47	561
B32R04C14	32-14-4	Hs~Ref:NM_003666.1~uORF:IOH13812	661	48	613
B32R04C15	32-15-4	Hs~Ref:NM_018180.2~uORF:IOH38247	453	49	404
B32R04C16	32-16-4	Hs~Ref:NM_018180.2~uORF:IOH38247	460	59	401
B32R04C17	32-17-4	Hs~MGC:BC060886.1~uORF:IOH29219	44	54	-10
B32R04C18	32-18-4	Hs~MGC:BC060886.1~uORF:IOH29219	180	74	106
B32R04C19	32-19-4	Hs~Ref:NM_152570.1~uORF:IOH38048	305	62	243
B32R04C20	32-20-4	Hs~Ref:NM_152570.1~uORF:IOH38048	52	113	-61
B32R04C21	32-21-4	Hs~Ref:NM_016457.3~uORF:IOH38433	411	78	333
B32R04C22	32-22-4	Hs~Ref:NM_016457.3~uORF:IOH38433	399	63	336
B32R05C01	32-1-5	Hs~Ref:NM_002198.1~uORF:IOH2022	507	55	452
B32R05C02	32-2-5	Hs~Ref:NM_002198.1~uORF:IOH2022	372	60	312
B32R05C03	32-3-5	Hs~MGC:BC022258.1~uORF:IOH12079	5478	58	5420
B32R05C04	32-4-5	Hs~MGC:BC022258.1~uORF:IOH12079	5130	58	5072
B32R05C05	32-5-5	Hs~MGC:BC017864.1~uORF:IOH12322	909	76	833
B32R05C06	32-6-5	Hs~MGC:BC017864.1~uORF:IOH12322	1017	118	899
B32R05C07	32-7-5	Hs~MGC:NM_152396.1~uORF:IOH12966	52	125	-73
B32R05C08	32-8-5	Hs~MGC:NM_152396.1~uORF:IOH12966	841	331	510
B32R05C09	32-9-5	Hs~Ref:NM_006575.2~N/A	392	48	344
B32R05C10	32-10-5	Hs~Ref:NM_006575.2~N/A	581	59	522
B32R05C11	32-11-5	Hs~Ref:NM_005465.2~N/A	467	46	421
B32R05C12	32-12-5	Hs~Ref:NM_005465.2~N/A	430	44	386
B32R05C13	32-13-5	Hs~Ref:NM_003718.2~N/A	443	45	398
B32R05C14	32-14-5	Hs~Ref:NM_003718.2~N/A	434	44	390
B32R05C15	32-15-5	Hs~Ref:NM_021643.1~N/A	483	48	435
B32R05C16	32-16-5	Hs~Ref:NM_021643.1~N/A	461	69	392
B32R05C17	32-17-5	Hs~Ref:NM_000496.1~uORF:IOH40269	715	50	665
B32R05C18	32-18-5	Hs~Ref:NM_000496.1~uORF:IOH40269	660	58	602
B32R05C19	32-19-5	Hs~Ref:NM_138499.2~uORF:IOH40143	1774	67	1707
B32R05C20	32-20-5	Hs~Ref:NM_138499.2~uORF:IOH40143	1688	75	1613
B32R05C21	32-21-5	Hs~Ref:NM_003089.4~uORF:IOH40192	821	70	751
B32R05C22	32-22-5	Hs~Ref:NM_003089.4~uORF:IOH40192	720	54	666
B32R06C01	32-1-6	Hs~Ref:NM_032847.1~uORF:IOH40091	508	57	451
B32R06C02	32-2-6	Hs~Ref:NM_032847.1~uORF:IOH40091	411	82	329
B32R06C03	32-3-6	Hs~Ref:NM_080590.1~uORF:IOH13252	190	66	124
B32R06C04	32-4-6	Hs~Ref:NM_080590.1~uORF:IOH13252	190	64	126
B32R06C05	32-5-6	Hs~MGC:NM_173652.1~uORF:IOH22733	496	152	344
B32R06C06	32-6-6	Hs~MGC:NM_173652.1~uORF:IOH22733	334	197	137
B32R06C07	32-7-6	Hs~Ref:NM_144594.1~uORF:IOH10942	745	149	596
B32R06C08	32-8-6	Hs~Ref:NM_144594.1~uORF:IOH10942	713	85	628
B32R06C09	32-9-6	Hs~Ref:NM_003975.1~uORF:IOH13203	20564	75	20489
B32R06C10	32-10-6	Hs~Ref:NM_003975.1~uORF:IOH13203	20792	75	20717
B32R06C11	32-11-6	Hs~Ref:NM_002421.2~uORF:IOH59103	101	72	29
B32R06C12	32-12-6	Hs~Ref:NM_002421.2~uORF:IOH59103	374	85	289
B32R06C13	32-13-6	Hs~Ref:NM_013310.3~uORF:IOH59703	355	57	298
B32R06C14	32-14-6	Hs~Ref:NM_013310.3~uORF:IOH59703	373	246	127
B32R06C15	32-15-6	Hs~Ref:NM_198217.1~uORF:IOH59743	929	48	881
B32R06C16	32-16-6	Hs~Ref:NM_198217.1~uORF:IOH59743	902	47	855
B32R06C17	32-17-6	Hs~Ref:NM_001543.3~uORF:IOH52925	161	49	112
B32R06C18	32-18-6	Hs~Ref:NM_001543.3~uORF:IOH52925	63	74	-11
B32R06C19	32-19-6	Hs~Ref:NM_006759.3~uORF:IOH26550	46	129	-83
B32R06C20	32-20-6	Hs~Ref:NM_006759.3~uORF:IOH26550	266	56	210
B32R06C21	32-21-6	Hs~Ref:NM_016302.2~uORF:IOH23076	46	119	-73
B32R06C22	32-22-6	Hs~Ref:NM_016302.2~uORF:IOH23076	63	67	-4
B32R07C01	32-1-7	Hs~Ref:NM_020320.2~uORF:IOH14861	469	196	273
B32R07C02	32-2-7	Hs~Ref:NM_020320.2~uORF:IOH14861	74	64	10
B32R07C03	32-3-7	Hs~Ref:NM_006919.1~uORF:IOH7262	344	53	291
B32R07C04	32-4-7	Hs~Ref:NM_006919.1~uORF:IOH7262	324	73	251
B32R07C05	32-5-7	Hs~Ref:NM_005362.2~uORF:IOH3602	234	195	39
B32R07C06	32-6-7	Hs~Ref:NM_005362.2~uORF:IOH3602	241	201	40
B32R07C07	32-7-7	Hs~Ref:NM_007177.1~uORF:IOH10203	3517	104	3413
B32R07C08	32-8-7	Hs~Ref:NM_007177.1~uORF:IOH10203	3686	69	3617
B32R07C09	32-9-7	Hs~Ref:NM_001500.1~uORF:IOH4377	711	470	241
B32R07C10	32-10-7	Hs~Ref:NM_001500.1~uORF:IOH4377	571	88	483
B32R07C11	32-11-7	Hs~Ref:NM_005319.3~uORF:IOH5275	674	79	595
B32R07C12	32-12-7	Hs~Ref:NM_005319.3~uORF:IOH5275	651	74	577
B32R07C13	32-13-7	Hs~Ref:NM_018401.1~N/A	498	58	440
B32R07C14	32-14-7	Hs~Ref:NM_018401.1~N/A	480	229	251
B32R07C15	32-15-7	Hs~Ref:NM_003081.2~uORF:IOH9748	857	57	800
B32R07C16	32-16-7	Hs~Ref:NM_003081.2~uORF:IOH9748	841	51	790
B32R07C17	32-17-7	Hs~MGC:BC007610.1~uORF:IOH6911	902	62	840
B32R07C18	32-18-7	Hs~MGC:BC007610.1~uORF:IOH6911	1105	559	546
B32R07C19	32-19-7	Hs~MGC:BC013781.1~uORF:IOH9733	112	93	19
B32R07C20	32-20-7	Hs~MGC:BC013781.1~uORF:IOH9733	289	68	221
B32R07C21	32-21-7	Hs~Ref:NM_016013.2~uORF:IOH4599	49	64	-15
B32R07C22	32-22-7	Hs~Ref:NM_016013.2~uORF:IOH4599	587	57	530
B32R08C01	32-1-8	Hs~MGC:BC028124.1~uORF:IOH11563	635	54	581
B32R08C02	32-2-8	Hs~MGC:BC028124.1~uORF:IOH11563	57	66	-9
B32R08C03	32-3-8	Hs~Ref:NM_016271.3~uORF:IOH11194	41	74	-33
B32R08C04	32-4-8	Hs~Ref:NM_016271.3~uORF:IOH11194	47	82	-35
B32R08C05	32-5-8	Hs~MGC:BC035054.2~uORF:IOH27693	74	187	-113
B32R08C06	32-6-8	Hs~MGC:BC035054.2~uORF:IOH27693	74	147	-73
B32R08C07	32-7-8	Hs~Ref:NM_001008657.1~uORF:IOH13916	937	63	874
B32R08C08	32-8-8	Hs~Ref:NM_001008657.1~uORF:IOH13916	881	56	825
B32R08C09	32-9-8	Hs~MGC:BC007957.1~uORF:IOH6766	665	401	264
B32R08C10	32-10-8	Hs~MGC:BC007957.1~uORF:IOH6766	476	119	357
B32R08C11	32-11-8	Hs~Ref:NM_182801.1~uORF:IOH23237	602	78	524
B32R08C12	32-12-8	Hs~Ref:NM_182801.1~uORF:IOH23237	769	56	713
B32R08C13	32-13-8	Hs~Ref:NM_005567.2~uORF:IOH3566	273	61	212
B32R08C14	32-14-8	Hs~Ref:NM_005567.2~uORF:IOH3566	208	68	140
B32R08C15	32-15-8	Hs~MGC:BC021573.1~uORF:IOH14848	798	56	742
B32R08C16	32-16-8	Hs~MGC:BC021573.1~uORF:IOH14848	820	62	758
B32R08C17	32-17-8	Hs~MGC:BC010349.1~uORF:IOH14182	57	64	-7
B32R08C18	32-18-8	Hs~MGC:BC010349.1~uORF:IOH14182	77	64	13
B32R08C19	32-19-8	Hs~Ref:NM_032858.1~uORF:IOH12001	119	95	24
B32R08C20	32-20-8	Hs~Ref:NM_032858.1~uORF:IOH12001	410	75	335
B32R08C21	32-21-8	Hs~Ref:NM_198965.1~uORF:IOH44500	1056	53	1003
B32R08C22	32-22-8	Hs~Ref:NM_198965.1~uORF:IOH44500	1412	50	1362
B32R09C01	32-1-9	Hs~Ref:NM_001003704.1~uORF:IOH58771	48	55	-7
B32R09C02	32-2-9	Hs~Ref:NM_001003704.1~uORF:IOH58771	43	64	-21
B32R09C03	32-3-9	Hs~Ref:NM_021100.3~uORF:IOH39970	335	53	282
B32R09C04	32-4-9	Hs~Ref:NM_021100.3~uORF:IOH39970	42	66	-24
B32R09C05	32-5-9	Hs~Ref:NM_001487.1~uORF:IOH58705	606	65	541
B32R09C06	32-6-9	Hs~Ref:NM_001487.1~uORF:IOH58705	889	330	559
B32R09C07	32-7-9	Hs~Ref:NM_207440.1~uORF:IOH58673	131	71	60
B32R09C08	32-8-9	Hs~Ref:NM_207440.1~uORF:IOH58673	106	64	42
B32R09C09	32-9-9	Hs~Ref:NM_017703.1~uORF:IOH57088	801	51	750
B32R09C10	32-10-9	Hs~Ref:NM_017703.1~uORF:IOH57088	794	52	742
B32R09C11	32-11-9	Hs~MGC:BC067085.1~uORF:IOH57304	1583	51	1532
B32R09C12	32-12-9	Hs~MGC:BC067085.1~uORF:IOH57304	1506	50	1456
B32R09C13	32-13-9	Hs~Ref:NM_001030002.1~uORF:IOH55430	10703	52	10651
B32R09C14	32-14-9	Hs~Ref:NM_001030002.1~uORF:IOH55430	10721	53	10668
B32R09C15	32-15-9	Hs~Ref:NM_014470.2~uORF:IOH55981	833	55	778
B32R09C16	32-16-9	Hs~Ref:NM_014470.2~uORF:IOH55981	899	58	841
B32R09C17	32-17-9	Hs~MGC:BC007324.1~uORF:IOH7013	285	59	226
B32R09C18	32-18-9	Hs~MGC:BC007324.1~uORF:IOH7013	168	53	115
B32R09C19	32-19-9	Hs~MGC:BC020495.1~uORF:IOH10734	147	100	47
B32R09C20	32-20-9	Hs~MGC:BC020495.1~uORF:IOH10734	83	57	26
B32R09C21	32-21-9	Hs~Ref:NM_014310.3~uORF:IOH12833	1022	433	589
B32R09C22	32-22-9	Hs~Ref:NM_014310.3~uORF:IOH12833	952	301	651
B32R10C01	32-1-10	Hs~Ref:NM_001803.1~uORF:IOH4221	319	53	266
B32R10C02	32-2-10	Hs~Ref:NM_001803.1~uORF:IOH4221	54	77	-23
B32R10C03	32-3-10	Hs~Ref:NM_017846.3~uORF:IOH4319	321	56	265
B32R10C04	32-4-10	Hs~Ref:NM_017846.3~uORF:IOH4319	165	73	92
B32R10C05	32-5-10	Hs~MGC:BC050718.1~uORF:IOH27017	1305	61	1244
B32R10C06	32-6-10	Hs~MGC:BC050718.1~uORF:IOH27017	238	99	139
B32R10C07	32-7-10	Hs~MGC:BC036107.1~uORF:IOH27227	2248	206	2042
B32R10C08	32-8-10	Hs~MGC:BC036107.1~uORF:IOH27227	910	77	833
B32R10C09	32-9-10	Hs~Ref:NM_004055.3~uORF:IOH10878	553	55	498
B32R10C10	32-10-10	Hs~Ref:NM_004055.3~uORF:IOH10878	74	58	16
B32R10C11	32-11-10	GST1	42	44	-2
B32R10C12	32-12-10	GST1	42	42	0
B32R10C13	32-13-10	GST2	45	42	3
B32R10C14	32-14-10	GST2	47	41	6
B32R10C15	32-15-10	GST3	46	45	1
B32R10C16	32-16-10	GST3	53	48	5
B32R10C17	32-17-10	GST4	64	58	6
B32R10C18	32-18-10	GST4	682	62	620
B32R10C19	32-19-10	Anti-HumanIgA1~N/A	7330	51	7279
B32R10C20	32-20-10	Anti-HumanIgA1~N/A	6814	52	6762
B32R10C21	32-21-10	Anti-HumanIgA2~N/A	13210	56	13154
B32R10C22	32-22-10	Anti-HumanIgA2~N/A	12545	53	12492
B32R11C01	32-1-11	AlexaAntiMouseAb~N/A	20979	48	20931
B32R11C02	32-2-11	AlexaAntiMouseAb~N/A	22544	54	22490
B32R11C03	32-3-11	MAPKAP~N/A	64	63	1
B32R11C04	32-4-11	MAPKAP~N/A	96	73	23
B32R11C05	32-5-11	Buffer	201	51	150
B32R11C06	32-6-11	Buffer	194	51	143
B32R11C07	32-7-11	BSA~N/A	7204	52	7152
B32R11C08	32-8-11	BSA~N/A	9614	114	9500
B32R11C09	32-9-11	Anti-HumanIgG1~N/A	4612	173	4439
B32R11C10	32-10-11	Anti-HumanIgG1~N/A	1698	80	1618
B32R11C11	32-11-11	Anti-HumanIgG2~N/A	3122	54	3068
B32R11C12	32-12-11	Anti-HumanIgG2~N/A	2872	52	2820
B32R11C13	32-13-11	Anti-HumanIgG3~N/A	5053	52	5001
B32R11C14	32-14-11	Anti-HumanIgG3~N/A	5110	52	5058
B32R11C15	32-15-11	Anti-HumanIgG4~N/A	9840	50	9790
B32R11C16	32-16-11	Anti-HumanIgG4~N/A	9240	54	9186
B32R11C17	32-17-11	AntiBiotinAb~N/A	13881	74	13807
B32R11C18	32-18-11	AntiBiotinAb~N/A	13114	64	13050
B32R11C19	32-19-11	Buffer	57	51	6
B32R11C20	32-20-11	Buffer	55	49	6
B32R11C21	32-21-11	Hs~MGC:BC010697.1~uORF:IOH9799	742	50	692
B32R11C22	32-22-11	Hs~MGC:BC010697.1~uORF:IOH9799	714	47	667
B32R12C01	32-1-12	Hs~Ref:NM_016525.3~uORF:IOH10415	562	45	517
B32R12C02	32-2-12	Hs~Ref:NM_016525.3~uORF:IOH10415	49	68	-19
B32R12C03	32-3-12	Hs~Ref:NM_012402.1~uORF:IOH3521	129	93	36
B32R12C04	32-4-12	Hs~Ref:NM_012402.1~uORF:IOH3521	55	74	-19
B32R12C05	32-5-12	Hs~MGC:BC017070.1~uORF:IOH11214	910	118	792
B32R12C06	32-6-12	Hs~MGC:BC017070.1~uORF:IOH11214	365	78	287
B32R12C07	32-7-12	Hs~Ref:NM_138392.1~uORF:IOH13855	283	58	225
B32R12C08	32-8-12	Hs~Ref:NM_138392.1~uORF:IOH13855	2725	158	2567
B32R12C09	32-9-12	Hs~Ref:NM_138812.1~uORF:IOH10642	778	248	530
B32R12C10	32-10-12	Hs~Ref:NM_138812.1~uORF:IOH10642	71	299	-228
B32R12C11	32-11-12	Hs~Ref:NM_145041.1~uORF:IOH13199	59	231	-172
B32R12C12	32-12-12	Hs~Ref:NM_145041.1~uORF:IOH13199	50	68	-18
B32R12C13	32-13-12	Hs~Ref:NM_022755.2~uORF:IOH10937	47	280	-233
B32R12C14	32-14-12	Hs~Ref:NM_022755.2~uORF:IOH10937	38	65	-27
B32R12C15	32-15-12	Hs~Ref:NM_014582.1~uORF:IOH40248	117	54	63
B32R12C16	32-16-12	Hs~Ref:NM_014582.1~uORF:IOH40248	54	65	-11
B32R12C17	32-17-12	Hs~MGC:BC063451.1~uORF:IOH39854	3886	134	3752
B32R12C18	32-18-12	Hs~MGC:BC063451.1~uORF:IOH39854	1318	337	981
B32R12C19	32-19-12	Hs~Ref:NM_194463.1~uORF:IOH39866	93	64	29
B32R12C20	32-20-12	Hs~Ref:NM_194463.1~uORF:IOH39866	70	55	15
B32R12C21	32-21-12	Hs~Ref:NM_002662.2~uORF:IOH40471	129	56	73
B32R12C22	32-22-12	Hs~Ref:NM_002662.2~uORF:IOH40471	53	45	8
B32R13C01	32-1-13	Hs~MGC:BC022077.1~uORF:IOH22412	452	46	406
B32R13C02	32-2-13	Hs~MGC:BC022077.1~uORF:IOH22412	651	57	594
B32R13C03	32-3-13	Hs~MGC:BC032957.1~uORF:IOH22428	417	53	364
B32R13C04	32-4-13	Hs~MGC:BC032957.1~uORF:IOH22428	67	150	-83
B32R13C05	32-5-13	Hs~MGC:BC001741.1~uORF:IOH4415	48	200	-152
B32R13C06	32-6-13	Hs~MGC:BC001741.1~uORF:IOH4415	40	205	-165
B32R13C07	32-7-13	Hs~Ref:NM_144588.2~uORF:IOH22403	482	148	334
B32R13C08	32-8-13	Hs~Ref:NM_144588.2~uORF:IOH22403	93	84	9
B32R13C09	32-9-13	Hs~Ref:NM_012239.3~uORF:IOH3763	272	166	106
B32R13C10	32-10-13	Hs~Ref:NM_012239.3~uORF:IOH3763	50	182	-132
B32R13C11	32-11-13	Hs~MGC:BC038509.1~uORF:IOH27674	73	104	-31
B32R13C12	32-12-13	Hs~MGC:BC038509.1~uORF:IOH27674	46	94	-48
B32R13C13	32-13-13	Hs~Ref:NM_005834.1~uORF:IOH12331	132	75	57
B32R13C14	32-14-13	Hs~Ref:NM_005834.1~uORF:IOH12331	73	75	-2
B32R13C15	32-15-13	Hs~MGC:NM_182522.2~uORF:IOH22723	44	44	0
B32R13C16	32-16-13	Hs~MGC:NM_182522.2~uORF:IOH22723	42	51	-9
B32R13C17	32-17-13	Hs~MGC:BC010089.1~uORF:IOH27833	46	257	-211
B32R13C18	32-18-13	Hs~MGC:BC010089.1~uORF:IOH27833	124	525	-401
B32R13C19	32-19-13	Hs~MGC:BC032646.1~uORF:IOH28703	57	118	-61
B32R13C20	32-20-13	Hs~MGC:BC032646.1~uORF:IOH28703	69	61	8
B32R13C21	32-21-13	Hs~MGC:BC047664.1~uORF:IOH28841	50	89	-39
B32R13C22	32-22-13	Hs~MGC:BC047664.1~uORF:IOH28841	61	117	-56
B32R14C01	32-1-14	Hs~MGC:BC052750.1~uORF:IOH28795	522	46	476
B32R14C02	32-2-14	Hs~MGC:BC052750.1~uORF:IOH28795	599	226	373
B32R14C03	32-3-14	Hs~MGC:BC006222.2~uORF:IOH6310	257	68	189
B32R14C04	32-4-14	Hs~MGC:BC006222.2~uORF:IOH6310	228	153	75
B32R14C05	32-5-14	Hs~Ref:NM_203370.1~uORF:IOH40905	49	230	-181
B32R14C06	32-6-14	Hs~Ref:NM_203370.1~uORF:IOH40905	44	116	-72
B32R14C07	32-7-14	Hs~Ref:NM_012097.2~uORF:IOH3083	45	163	-118
B32R14C08	32-8-14	Hs~Ref:NM_012097.2~uORF:IOH3083	137	109	28
B32R14C09	32-9-14	Hs~MGC:BC005984.1~uORF:IOH7476	807	343	464
B32R14C10	32-10-14	Hs~MGC:BC005984.1~uORF:IOH7476	88	210	-122
B32R14C11	32-11-14	Hs~Ref:NM_181313.1~uORF:IOH53460	46	87	-41
B32R14C12	32-12-14	Hs~Ref:NM_181313.1~uORF:IOH53460	67	74	-7
B32R14C13	32-13-14	Hs~Ref:NM_016827.1~uORF:IOH59670	48	65	-17
B32R14C14	32-14-14	Hs~Ref:NM_016827.1~uORF:IOH59670	63	68	-5
B32R14C15	32-15-14	Hs~Ref:NM_001033059.1~uORF:IOH59012	74	73	1
B32R14C16	32-16-14	Hs~Ref:NM_001033059.1~uORF:IOH59012	45	69	-24
B32R14C17	32-17-14	Hs~Ref:NM_145802.1~uORF:IOH14040	679	51	628
B32R14C18	32-18-14	Hs~Ref:NM_145802.1~uORF:IOH14040	60	63	-3
B32R14C19	32-19-14	Hs~MGC:BC038583.1~uORF:IOH28700	125	52	73
B32R14C20	32-20-14	Hs~MGC:BC038583.1~uORF:IOH28700	55	58	-3
B32R14C21	32-21-14	Hs~MGC:BC058861.1~uORF:IOH28672	56	157	-101
B32R14C22	32-22-14	Hs~MGC:BC058861.1~uORF:IOH28672	46	305	-259
B32R15C01	32-1-15	Hs~MGC:BC054031.2~uORF:IOH29106	532	44	488
B32R15C02	32-2-15	Hs~MGC:BC054031.2~uORF:IOH29106	581	47	534
B32R15C03	32-3-15	Hs~MGC:BC007888.1~uORF:IOH29315	514	49	465
B32R15C04	32-4-15	Hs~MGC:BC007888.1~uORF:IOH29315	553	58	495
B32R15C05	32-5-15	Hs~Ref:NM_005639.1~uORF:IOH29114	2221	54	2167
B32R15C06	32-6-15	Hs~Ref:NM_005639.1~uORF:IOH29114	2068	51	2017
B32R15C07	32-7-15	Hs~Ref:NM_015327.1~uORF:IOH27102	430	51	379
B32R15C08	32-8-15	Hs~Ref:NM_015327.1~uORF:IOH27102	407	63	344
B32R15C09	32-9-15	Hs~Ref:NM_145796.2~uORF:IOH29191	1010	699	311
B32R15C10	32-10-15	Hs~Ref:NM_145796.2~uORF:IOH29191	891	166	725
B32R15C11	32-11-15	Hs~MGC:BC041831.1~uORF:IOH27713	936	59	877
B32R15C12	32-12-15	Hs~MGC:BC041831.1~uORF:IOH27713	999	57	942
B32R15C13	32-13-15	Hs~Ref:NM_000245.2~CAT:PV3968	45	52	-7
B32R15C14	32-14-15	Hs~Ref:NM_000245.2~CAT:PV3968	77	48	29
B32R15C15	32-15-15	Hs~Ref:NM_006575.2~CAT:PV3682	904	127	777
B32R15C16	32-16-15	Hs~Ref:NM_006575.2~CAT:PV3682	339	365	-26
B32R15C17	32-17-15	Hs~Ref:NM_005158.2~CAT:PV3266	1169	383	786
B32R15C18	32-18-15	Hs~Ref:NM_005158.2~CAT:PV3266	962	48	914
B32R15C19	32-19-15	Hs~Ref:NM_005157.2~CAT:PV3863	438	161	277
B32R15C20	32-20-15	Hs~Ref:NM_005157.2~CAT:PV3863	364	48	316
B32R15C21	32-21-15	Hs~Ref:NM_006549.2~CAT:PV4206	124	69	55
B32R15C22	32-22-15	Hs~Ref:NM_006549.2~CAT:PV4206	41	105	-64
B32R16C01	32-1-16	Hs~Ref:NM_000758.2~CAT_PHC2015	387	42	345
B32R16C02	32-2-16	Hs~Ref:NM_000758.2~CAT_PHC2015	370	43	327
B32R16C03	32-3-16	Hs~N/A:NM_002006.3~CAT_PHG0026	45	44	1
B32R16C04	32-4-16	Hs~N/A:NM_002006.3~CAT_PHG0026	44	42	2
B32R16C05	32-5-16	Hs~Ref:NM_002752.3~CAT:PV3620	48	51	-3
B32R16C06	32-6-16	Hs~Ref:NM_002752.3~CAT:PV3620	63	57	6
B32R16C07	32-7-16	Hs~Ref:NM_014166.2~uORF:IOH53881	973	54	919
B32R16C08	32-8-16	Hs~Ref:NM_014166.2~uORF:IOH53881	905	54	851
B32R16C09	32-9-16	Hs~Ref:BC041818.1~uORF:IOH62270	211	55	156
B32R16C10	32-10-16	Hs~Ref:BC041818.1~uORF:IOH62270	241	84	157
B32R16C11	32-11-16	Hs~MGC:BC093070.1~uORF:IOH63176	315	51	264
B32R16C12	32-12-16	Hs~MGC:BC093070.1~uORF:IOH63176	322	50	272
B32R16C13	32-13-16	Hs~MGC:BC015875.1~uORF:IOH62816	217	49	168
B32R16C14	32-14-16	Hs~MGC:BC015875.1~uORF:IOH62816	60	59	1
B32R16C15	32-15-16	Hs~Ref:NM_001005373.1~uORF:IOH55653	581	350	231
B32R16C16	32-16-16	Hs~Ref:NM_001005373.1~uORF:IOH55653	483	408	75
B32R16C17	32-17-16	Hs~Ref:NM_016216.2~uORF:IOH57112	385	59	326
B32R16C18	32-18-16	Hs~Ref:NM_016216.2~uORF:IOH57112	395	51	344
B32R16C19	32-19-16	Hs~Ref:NM_004691.3~uORF:IOH57018	119	52	67
B32R16C20	32-20-16	Hs~Ref:NM_004691.3~uORF:IOH57018	107	51	56
B32R16C21	32-21-16	Hs~MGC:BC008042.2~uORF:IOH57013	604	125	479
B32R16C22	32-22-16	Hs~MGC:BC008042.2~uORF:IOH57013	641	72	569
B32R17C01	32-1-17	Hs~Ref:NM_020961.2~uORF:IOH6104	839	42	797
B32R17C02	32-2-17	Hs~Ref:NM_020961.2~uORF:IOH6104	814	43	771
B32R17C03	32-3-17	Hs~Ref:NM_000420.2~uORF:IOH5088	621	43	578
B32R17C04	32-4-17	Hs~Ref:NM_000420.2~uORF:IOH5088	80	45	35
B32R17C05	32-5-17	Hs~MGC:BC093891.1~uORF:IOH62005	46	53	-7
B32R17C06	32-6-17	Hs~MGC:BC093891.1~uORF:IOH62005	169	87	82
B32R17C07	32-7-17	Hs~Ref:NM_001064.1~uORF:IOH61026	921	56	865
B32R17C08	32-8-17	Hs~Ref:NM_001064.1~uORF:IOH61026	849	48	801
B32R17C09	32-9-17	Hs~MGC:NM_152690.1~uORF:IOH10343	277	48	229
B32R17C10	32-10-17	Hs~MGC:NM_152690.1~uORF:IOH10343	1017	101	916
B32R17C11	32-11-17	Hs~Ref:NM_032146.2~uORF:IOH10608	638	55	583
B32R17C12	32-12-17	Hs~Ref:NM_032146.2~uORF:IOH10608	801	47	754
B32R17C13	32-13-17	Hs~Ref:NM_002994.2~uORF:IOH7295	486	62	424
B32R17C14	32-14-17	Hs~Ref:NM_002994.2~uORF:IOH7295	58	57	1
B32R17C15	32-15-17	Hs~MGC:BC010963.1~uORF:IOH13789	558	48	510
B32R17C16	32-16-17	Hs~MGC:BC010963.1~uORF:IOH13789	523	46	477
B32R17C17	32-17-17	Hs~Ref:NM_013409.1~uORF:IOH5621	138	57	81
B32R17C18	32-18-17	Hs~Ref:NM_013409.1~uORF:IOH5621	63	79	-16
B32R17C19	32-19-17	Hs~Ref:NM_020124.1~uORF:IOH35273	63	73	-10
B32R17C20	32-20-17	Hs~Ref:NM_020124.1~uORF:IOH35273	72	57	15
B32R17C21	32-21-17	Hs~Ref:NM_173624.1~uORF:IOH35387	45	51	-6
B32R17C22	32-22-17	Hs~Ref:NM_173624.1~uORF:IOH35387	42	45	-3
B32R18C01	32-1-18	Hs~Ref:NM_015370.1~uORF:IOH35430	415	45	370
B32R18C02	32-2-18	Hs~Ref:NM_015370.1~uORF:IOH35430	392	44	348
B32R18C03	32-3-18	Hs~MGC:BC044580.1~uORF:IOH26748	290	55	235
B32R18C04	32-4-18	Hs~MGC:BC044580.1~uORF:IOH26748	82	61	21
B32R18C05	32-5-18	Hs~MGC:BC021664.1~uORF:IOH12244	44	55	-11
B32R18C06	32-6-18	Hs~MGC:BC021664.1~uORF:IOH12244	139	47	92
B32R18C07	32-7-18	Hs~MGC:BC026241.1~uORF:IOH12763	166	44	122
B32R18C08	32-8-18	Hs~MGC:BC026241.1~uORF:IOH12763	147	43	104
B32R18C09	32-9-18	Hs~MGC:BC008390.1~uORF:IOH7426	401	47	354
B32R18C10	32-10-18	Hs~MGC:BC008390.1~uORF:IOH7426	513	74	439
B32R18C11	32-11-18	Hs~MGC:BC039256.1~uORF:IOH27247	218	67	151
B32R18C12	32-12-18	Hs~MGC:BC039256.1~uORF:IOH27247	230	51	179
B32R18C13	32-13-18	Hs~MGC:BC053576.1~uORF:IOH28927	56	51	5
B32R18C14	32-14-18	Hs~MGC:BC053576.1~uORF:IOH28927	356	47	309
B32R18C15	32-15-18	Hs~Ref:NM_181712.2~uORF:IOH29203	330	49	281
B32R18C16	32-16-18	Hs~Ref:NM_181712.2~uORF:IOH29203	350	52	298
B32R18C17	32-17-18	Hs~Ref:NM_016848.2~uORF:IOH11138	3894	61	3833
B32R18C18	32-18-18	Hs~Ref:NM_016848.2~uORF:IOH11138	3804	63	3741
B32R18C19	32-19-18	Hs~MGC:BC020960.1~uORF:IOH10418	184	58	126
B32R18C20	32-20-18	Hs~MGC:BC020960.1~uORF:IOH10418	53	72	-19
B32R18C21	32-21-18	Hs~Ref:NM_016204.1~uORF:IOH40347	52	59	-7
B32R18C22	32-22-18	Hs~Ref:NM_016204.1~uORF:IOH40347	44	51	-7
B32R19C01	32-1-19	Hs~Ref:NM_024678.3~uORF:IOH40617	381	42	339
B32R19C02	32-2-19	Hs~Ref:NM_024678.3~uORF:IOH40617	412	43	369
B32R19C03	32-3-19	Hs~MGC:BC068031.1~uORF:IOH40029	363	43	320
B32R19C04	32-4-19	Hs~MGC:BC068031.1~uORF:IOH40029	377	44	333
B32R19C05	32-5-19	Hs~Ref:NM_005204.2~N/A	235	46	189
B32R19C06	32-6-19	Hs~Ref:NM_005204.2~N/A	55	59	-4
B32R19C07	32-7-19	Hs~Ref:NM_002011.2~N/A	139	47	92
B32R19C08	32-8-19	Hs~Ref:NM_002011.2~N/A	95	52	43
B32R19C09	32-9-19	Hs~MGC:BC000251.1~N/A	45	56	-11
B32R19C10	32-10-19	Hs~MGC:BC000251.1~N/A	174	59	115
B32R19C11	32-11-19	Hs~MGC:BC002541.1~N/A	63	66	-3
B32R19C12	32-12-19	Hs~MGC:BC002541.1~N/A	56	51	5
B32R19C13	32-13-19	Hs~MGC:BC001096.2~uORF:IOH62830	180	50	130
B32R19C14	32-14-19	Hs~MGC:BC001096.2~uORF:IOH62830	183	50	133
B32R19C15	32-15-19	Hs~MGC:BC080631.1~uORF:IOH63128	203	61	142
B32R19C16	32-16-19	Hs~MGC:BC080631.1~uORF:IOH63128	155	47	108
B32R19C17	32-17-19	Hs~MGC:BC070154.1~uORF:IOH63011	2324	45	2279
B32R19C18	32-18-19	Hs~MGC:BC070154.1~uORF:IOH63011	2325	46	2279
B32R19C19	32-19-19	Hs~MGC:BC071844.1~uORF:IOH63093	288	60	228
B32R19C20	32-20-19	Hs~MGC:BC071844.1~uORF:IOH63093	279	100	179
B32R19C21	32-21-19	Hs~Ref:NM_014314.3~uORF:IOH52971	42	44	-2
B32R19C22	32-22-19	Hs~Ref:NM_014314.3~uORF:IOH52971	40	41	-1
B32R20C01	32-1-20	Hs~Ref:NM_012215.1~uORF:IOH52962	47	46	1
B32R20C02	32-2-20	Hs~Ref:NM_012215.1~uORF:IOH52962	47	46	1
B32R20C03	32-3-20	Hs~Ref:NM_014382.2~uORF:IOH52964	37	39	-2
B32R20C04	32-4-20	Hs~Ref:NM_014382.2~uORF:IOH52964	37	39	-2
B32R20C05	32-5-20	Hs~Ref:NM_004320.3~uORF:IOH53042	42	44	-2
B32R20C06	32-6-20	Hs~Ref:NM_004320.3~uORF:IOH53042	39	45	-6
B32R20C07	32-7-20	Hs~Ref:NM_021216.3~uORF:IOH57151	338	47	291
B32R20C08	32-8-20	Hs~Ref:NM_021216.3~uORF:IOH57151	110	61	49
B32R20C09	32-9-20	Hs~Ref:NM_001694.2~uORF:IOH56918	124	45	79
B32R20C10	32-10-20	Hs~Ref:NM_001694.2~uORF:IOH56918	104	50	54
B32R20C11	32-11-20	Hs~Ref:NM_001948.3~uORF:IOH56236	663	79	584
B32R20C12	32-12-20	Hs~Ref:NM_001948.3~uORF:IOH56236	549	51	498
B32R20C13	32-13-20	Hs~MGC:BC013412.2~uORF:IOH57123	573	46	527
B32R20C14	32-14-20	Hs~MGC:BC013412.2~uORF:IOH57123	599	45	554
B32R20C15	32-15-20	Hs~Ref:NM_207009.2~uORF:IOH12874	180	48	132
B32R20C16	32-16-20	Hs~Ref:NM_207009.2~uORF:IOH12874	179	48	131
B32R20C17	32-17-20	Hs~MGC:BC031330.1~uORF:IOH23267	269	110	159
B32R20C18	32-18-20	Hs~MGC:BC031330.1~uORF:IOH23267	263	52	211
B32R20C19	32-19-20	Hs~Ref:NM_201433.1~uORF:IOH36830	1103	47	1056
B32R20C20	32-20-20	Hs~Ref:NM_201433.1~uORF:IOH36830	1016	46	970
B32R20C21	32-21-20	Hs~MGC:BC033237.1~uORF:IOH23268	11550	43	11507
B32R20C22	32-22-20	Hs~MGC:BC033237.1~uORF:IOH23268	12451	40	12411
B32R21C01	32-1-21	Hs~Ref:NM_032177.2~uORF:IOH13401	1035	45	990
B32R21C02	32-2-21	Hs~Ref:NM_032177.2~uORF:IOH13401	991	48	943
B32R21C03	32-3-21	Hs~MGC:BC013386.1~uORF:IOH12478	396	43	353
B32R21C04	32-4-21	Hs~MGC:BC013386.1~uORF:IOH12478	372	42	330
B32R21C05	32-5-21	Hs~Ref:NM_003281.3~uORF:IOH13010	670	43	627
B32R21C06	32-6-21	Hs~Ref:NM_003281.3~uORF:IOH13010	580	44	536
B32R21C07	32-7-21	Hs~Ref:NM_000125.2~uORF:IOH34665	268	45	223
B32R21C08	32-8-21	Hs~Ref:NM_000125.2~uORF:IOH34665	92	52	40
B32R21C09	32-9-21	Hs~Ref:NP_079083.2~CAT_11655-H08H-25	100	41	59
B32R21C10	32-10-21	Hs~Ref:NP_079083.2~CAT_11655-H08H-25	750	42	708
B32R21C11	32-11-21	Internal_1007209	851	104	747
B32R21C12	32-12-21	Internal_1007209	79	58	21
B32R21C13	32-13-21	Hs~Ref:Q96DU3-1~CAT_11945-H08H-25	41	41	0
B32R21C14	32-14-21	Hs~Ref:Q96DU3-1~CAT_11945-H08H-25	38	39	-1
B32R21C15	32-15-21	Internal_1007209	973	57	916
B32R21C16	32-16-21	Internal_1007209	839	43	796
B32R21C17	32-17-21	Hs~Ref:NP_001120645.1~CAT_11214-H08H-25	37	40	-3
B32R21C18	32-18-21	Hs~Ref:NP_001120645.1~CAT_11214-H08H-25	40	39	1
B32R21C19	32-19-21	Internal_1007209	39	40	-1
B32R21C20	32-20-21	Internal_1007209	41	40	1
B32R21C21	32-21-21	Internal_1007209	41	40	1
B32R21C22	32-22-21	Internal_1007209	39	38	1
B32R22C01	32-1-22	ERa~N/A	2873	39	2834
B32R22C02	32-2-22	ERa~N/A	3098	38	3060
B32R22C03	32-3-22	PKCeta~N/A	316	42	274
B32R22C04	32-4-22	PKCeta~N/A	311	41	270
B32R22C05	32-5-22	Calmodulin~N/A	65	42	23
B32R22C06	32-6-22	Calmodulin~N/A	51	45	6
B32R22C07	32-7-22	V5control5~N/A	175	50	125
B32R22C08	32-8-22	V5control5~N/A	266	44	222
B32R22C09	32-9-22	V5control4~N/A	132	42	90
B32R22C10	32-10-22	V5control4~N/A	119	43	76
B32R22C11	32-11-22	V5control3~N/A	93	55	38
B32R22C12	32-12-22	V5control3~N/A	355	60	295
B32R22C13	32-13-22	V5control2~N/A	44	43	1
B32R22C14	32-14-22	V5control2~N/A	58	42	16
B32R22C15	32-15-22	V5control1~N/A	52	42	10
B32R22C16	32-16-22	V5control1~N/A	50	42	8
B32R22C17	32-17-22	CMK2A~N/A	579	41	538
B32R22C18	32-18-22	CMK2A~N/A	526	40	486
B32R22C19	32-19-22	ERa~N/A	2048	41	2007
B32R22C20	32-20-22	ERa~N/A	1968	42	1926
B32R22C21	32-21-22	AlexaAntiMouseAb~N/A	6946	42	6904
B32R22C22	32-22-22	AlexaAntiMouseAb~N/A	8198	40	8158
B33R01C01	33-1-1	AlexaAntiMouseAb~N/A	28644	38	28606
B33R01C02	33-2-1	AlexaAntiMouseAb~N/A	31843	38	31805
B33R01C03	33-3-1	ERa~N/A	2001	36	1965
B33R01C04	33-4-1	ERa~N/A	2128	36	2092
B33R01C05	33-5-1	HumanIgG1~N/A	900	37	863
B33R01C06	33-6-1	HumanIgG1~N/A	895	36	859
B33R01C07	33-7-1	HumanIgG2~N/A	2216	36	2180
B33R01C08	33-8-1	HumanIgG2~N/A	2199	37	2162
B33R01C09	33-9-1	HumanIgG3~N/A	11486	38	11448
B33R01C10	33-10-1	HumanIgG3~N/A	11425	39	11386
B33R01C11	33-11-1	HumanIgG4~N/A	32349	42	32307
B33R01C12	33-12-1	HumanIgG4~N/A	32377	39	32338
B33R01C13	33-13-1	BiotinAb~N/A	318	38	280
B33R01C14	33-14-1	BiotinAb~N/A	291	42	249
B33R01C15	33-15-1	RanBP2deltaFG~N/A	248	40	208
B33R01C16	33-16-1	RanBP2deltaFG~N/A	69	36	33
B33R01C17	33-17-1	hMDM2~N/A	745	35	710
B33R01C18	33-18-1	hMDM2~N/A	720	35	685
B33R01C19	33-19-1	PKCeta~N/A	388	35	353
B33R01C20	33-20-1	PKCeta~N/A	405	36	369
B33R01C21	33-21-1	AlexaAntiMouseAb~N/A	33692	38	33654
B33R01C22	33-22-1	AlexaAntiMouseAb~N/A	38404	39	38365
B33R02C01	33-1-2	PKCeta~N/A	861	38	823
B33R02C02	33-2-2	PKCeta~N/A	1036	45	991
B33R02C03	33-3-2	Buffer	216	37	179
B33R02C04	33-4-2	Buffer	96	45	51
B33R02C05	33-5-2	HumanIgA~N/A	17952	37	17915
B33R02C06	33-6-2	HumanIgA~N/A	18933	36	18897
B33R02C07	33-7-2	Buffer	324	65	259
B33R02C08	33-8-2	Buffer	93	36	57
B33R02C09	33-9-2	BSA~N/A	9283	35	9248
B33R02C10	33-10-2	BSA~N/A	9376	38	9338
B33R02C11	33-11-2	Hs~Ref:NM_003930.2~uORF:IOH5696	587	167	420
B33R02C12	33-12-2	Hs~Ref:NM_003930.2~uORF:IOH5696	511	61	450
B33R02C13	33-13-2	Hs~MGC:BC008741.1~uORF:IOH5919	672	42	630
B33R02C14	33-14-2	Hs~MGC:BC008741.1~uORF:IOH5919	703	43	660
B33R02C15	33-15-2	Hs~Ref:NM_022128.1~uORF:IOH14265	456	42	414
B33R02C16	33-16-2	Hs~Ref:NM_022128.1~uORF:IOH14265	396	37	359
B33R02C17	33-17-2	Hs~Ref:NM_033313.1~uORF:IOH20983	616	35	581
B33R02C18	33-18-2	Hs~Ref:NM_033313.1~uORF:IOH20983	605	35	570
B33R02C19	33-19-2	Hs~MGC:BC020747.1~uORF:IOH14518	327	35	292
B33R02C20	33-20-2	Hs~MGC:BC020747.1~uORF:IOH14518	333	35	298
B33R02C21	33-21-2	Hs~MGC:BC028206.1~uORF:IOH11618	374	37	337
B33R02C22	33-22-2	Hs~MGC:BC028206.1~uORF:IOH11618	233	37	196
B33R03C01	33-1-3	Hs~Ref:NM_001612.3~uORF:IOH11009	289	38	251
B33R03C02	33-2-3	Hs~Ref:NM_001612.3~uORF:IOH11009	267	40	227
B33R03C03	33-3-3	Hs~Ref:NM_025055.2~uORF:IOH11794	215	40	175
B33R03C04	33-4-3	Hs~Ref:NM_025055.2~uORF:IOH11794	199	39	160
B33R03C05	33-5-3	Hs~Ref:NM_015484.1~uORF:IOH9828	1032	37	995
B33R03C06	33-6-3	Hs~Ref:NM_015484.1~uORF:IOH9828	1034	41	993
B33R03C07	33-7-3	Hs~Ref:NM_017824.2~uORF:IOH9985	165	67	98
B33R03C08	33-8-3	Hs~Ref:NM_017824.2~uORF:IOH9985	342	48	294
B33R03C09	33-9-3	Hs~Ref:NM_003795.1~uORF:IOH7529	426	37	389
B33R03C10	33-10-3	Hs~Ref:NM_003795.1~uORF:IOH7529	527	39	488
B33R03C11	33-11-3	Hs~MGC:BC009614.1~uORF:IOH9949	170	43	127
B33R03C12	33-12-3	Hs~MGC:BC009614.1~uORF:IOH9949	189	43	146
B33R03C13	33-13-3	Hs~MGC:BC044576.1~uORF:IOH26888	440	82	358
B33R03C14	33-14-3	Hs~MGC:BC044576.1~uORF:IOH26888	380	41	339
B33R03C15	33-15-3	Hs~Ref:NM_032593.1~uORF:IOH26687	798	40	758
B33R03C16	33-16-3	Hs~Ref:NM_032593.1~uORF:IOH26687	726	36	690
B33R03C17	33-17-3	Hs~MGC:BC040106.1~uORF:IOH26285	3996	35	3961
B33R03C18	33-18-3	Hs~MGC:BC040106.1~uORF:IOH26285	4418	39	4379
B33R03C19	33-19-3	Hs~Ref:NM_012176.1~uORF:IOH26750	407	45	362
B33R03C20	33-20-3	Hs~Ref:NM_012176.1~uORF:IOH26750	375	41	334
B33R03C21	33-21-3	Hs~MGC:BC008440.1~uORF:IOH7416	692	37	655
B33R03C22	33-22-3	Hs~MGC:BC008440.1~uORF:IOH7416	886	39	847
B33R04C01	33-1-4	Hs~Ref:NM_145306.1~uORF:IOH9906	1741	37	1704
B33R04C02	33-2-4	Hs~Ref:NM_145306.1~uORF:IOH9906	1728	41	1687
B33R04C03	33-3-4	Hs~Ref:NM_032359.1~uORF:IOH5762	905	48	857
B33R04C04	33-4-4	Hs~Ref:NM_032359.1~uORF:IOH5762	854	43	811
B33R04C05	33-5-4	Hs~Ref:NM_004782.2~uORF:IOH9957	642	36	606
B33R04C06	33-6-4	Hs~Ref:NM_004782.2~uORF:IOH9957	690	37	653
B33R04C07	33-7-4	Hs~Ref:NM_016040.2~uORF:IOH11975	290	40	250
B33R04C08	33-8-4	Hs~Ref:NM_016040.2~uORF:IOH11975	1972	85	1887
B33R04C09	33-9-4	Hs~MGC:BC000977.2~uORF:IOH2923	254	37	217
B33R04C10	33-10-4	Hs~MGC:BC000977.2~uORF:IOH2923	262	218	44
B33R04C11	33-11-4	Hs~Ref:NM_002412.1~uORF:IOH3104	328	203	125
B33R04C12	33-12-4	Hs~Ref:NM_002412.1~uORF:IOH3104	252	51	201
B33R04C13	33-13-4	Hs~Ref:NM_005574.2~uORF:IOH22221	392	42	350
B33R04C14	33-14-4	Hs~Ref:NM_005574.2~uORF:IOH22221	377	44	333
B33R04C15	33-15-4	Hs~Ref:NM_020376.2~uORF:IOH14746	310	46	264
B33R04C16	33-16-4	Hs~Ref:NM_020376.2~uORF:IOH14746	337	44	293
B33R04C17	33-17-4	Hs~MGC:BC050387.1~uORF:IOH26653	1543	36	1507
B33R04C18	33-18-4	Hs~MGC:BC050387.1~uORF:IOH26653	1461	39	1422
B33R04C19	33-19-4	Hs~Ref:NM_198517.2~uORF:IOH25922	2530	55	2475
B33R04C20	33-20-4	Hs~Ref:NM_198517.2~uORF:IOH25922	2147	47	2100
B33R04C21	33-21-4	Hs~MGC:BC044851.1~uORF:IOH27643	290	44	246
B33R04C22	33-22-4	Hs~MGC:BC044851.1~uORF:IOH27643	203	41	162
B33R05C01	33-1-5	Hs~MGC:BC063392.1~uORF:IOH39855	234	35	199
B33R05C02	33-2-5	Hs~MGC:BC063392.1~uORF:IOH39855	190	38	152
B33R05C03	33-3-5	Hs~MGC:BC000381.2~uORF:IOH3454	694	46	648
B33R05C04	33-4-5	Hs~MGC:BC000381.2~uORF:IOH3454	686	39	647
B33R05C05	33-5-5	Hs~Ref:NM_032498.1~uORF:IOH11289	181	36	145
B33R05C06	33-6-5	Hs~Ref:NM_032498.1~uORF:IOH11289	209	42	167
B33R05C07	33-7-5	Hs~Ref:NM_018246.1~uORF:IOH40864	677	41	636
B33R05C08	33-8-5	Hs~Ref:NM_018246.1~uORF:IOH40864	687	39	648
B33R05C09	33-9-5	Hs~Ref:NM_024563.1~uORF:IOH23059	1140	35	1105
B33R05C10	33-10-5	Hs~Ref:NM_024563.1~uORF:IOH23059	1127	36	1091
B33R05C11	33-11-5	Hs~MGC:BC030813.1~uORF:IOH23055	41565	42	41523
B33R05C12	33-12-5	Hs~MGC:BC030813.1~uORF:IOH23055	41070	43	41027
B33R05C13	33-13-5	Hs~Ref:NM_001290.1~uORF:IOH23054	999	45	954
B33R05C14	33-14-5	Hs~Ref:NM_001290.1~uORF:IOH23054	932	50	882
B33R05C15	33-15-5	Hs~MGC:BC002373.1~uORF:IOH3593	401	320	81
B33R05C16	33-16-5	Hs~MGC:BC002373.1~uORF:IOH3593	402	172	230
B33R05C17	33-17-5	Hs~MGC:BC050721.1~uORF:IOH27058	961	36	925
B33R05C18	33-18-5	Hs~MGC:BC050721.1~uORF:IOH27058	940	36	904
B33R05C19	33-19-5	Hs~MGC:BC047918.1~uORF:IOH26981	443	38	405
B33R05C20	33-20-5	Hs~MGC:BC047918.1~uORF:IOH26981	446	39	407
B33R05C21	33-21-5	Hs~Ref:NM_002788.1~uORF:IOH26156	260	44	216
B33R05C22	33-22-5	Hs~Ref:NM_002788.1~uORF:IOH26156	206	48	158
B33R06C01	33-1-6	Hs~Ref:NM_032373.1~uORF:IOH27011	140	37	103
B33R06C02	33-2-6	Hs~Ref:NM_032373.1~uORF:IOH27011	134	36	98
B33R06C03	33-3-6	Hs~Ref:NM_015894.2~uORF:IOH1745	215	100	115
B33R06C04	33-4-6	Hs~Ref:NM_015894.2~uORF:IOH1745	141	38	103
B33R06C05	33-5-6	Hs~Ref:NM_002694.2~uORF:IOH1927	380	40	340
B33R06C06	33-6-6	Hs~Ref:NM_002694.2~uORF:IOH1927	530	51	479
B33R06C07	33-7-6	Hs~MGC:BC022251.1~uORF:IOH12839	294	41	253
B33R06C08	33-8-6	Hs~MGC:BC022251.1~uORF:IOH12839	276	41	235
B33R06C09	33-9-6	Hs~MGC:BC012814.1~uORF:IOH13051	235	39	196
B33R06C10	33-10-6	Hs~MGC:BC012814.1~uORF:IOH13051	221	40	181
B33R06C11	33-11-6	Hs~Ref:NM_032111.2~uORF:IOH39958	216	36	180
B33R06C12	33-12-6	Hs~Ref:NM_032111.2~uORF:IOH39958	201	36	165
B33R06C13	33-13-6	Hs~Ref:NM_001002018.1~uORF:IOH40008	539	36	503
B33R06C14	33-14-6	Hs~Ref:NM_001002018.1~uORF:IOH40008	532	35	497
B33R06C15	33-15-6	Hs~MGC:BC064367.1~uORF:IOH39904	2317	36	2281
B33R06C16	33-16-6	Hs~MGC:BC064367.1~uORF:IOH39904	2221	37	2184
B33R06C17	33-17-6	Hs~MGC:BC066654.1~uORF:IOH39960	1141	37	1104
B33R06C18	33-18-6	Hs~MGC:BC066654.1~uORF:IOH39960	1186	38	1148
B33R06C19	33-19-6	Hs~Ref:NM_032193.1~uORF:IOH27907	340	38	302
B33R06C20	33-20-6	Hs~Ref:NM_032193.1~uORF:IOH27907	357	40	317
B33R06C21	33-21-6	Hs~MGC:BC038105.2~uORF:IOH27173	785	39	746
B33R06C22	33-22-6	Hs~MGC:BC038105.2~uORF:IOH27173	749	44	705
B33R07C01	33-1-7	Hs~MGC:BC043269.2~uORF:IOH25865	415	98	317
B33R07C02	33-2-7	Hs~MGC:BC043269.2~uORF:IOH25865	190	39	151
B33R07C03	33-3-7	Hs~MGC:BC018671.1~uORF:IOH27933	225	39	186
B33R07C04	33-4-7	Hs~MGC:BC018671.1~uORF:IOH27933	137	70	67
B33R07C05	33-5-7	Hs~MGC:BC051366.1~uORF:IOH28071	645	43	602
B33R07C06	33-6-7	Hs~MGC:BC051366.1~uORF:IOH28071	667	44	623
B33R07C07	33-7-7	Hs~Ref:NM_000997.2~uORF:IOH1585	1251	38	1213
B33R07C08	33-8-7	Hs~Ref:NM_000997.2~uORF:IOH1585	1261	39	1222
B33R07C09	33-9-7	Hs~MGC:BC008058.1~uORF:IOH5838	3076	43	3033
B33R07C10	33-10-7	Hs~MGC:BC008058.1~uORF:IOH5838	3086	41	3045
B33R07C11	33-11-7	Hs~MGC:BC000980.1~uORF:IOH2952	180	37	143
B33R07C12	33-12-7	Hs~MGC:BC000980.1~uORF:IOH2952	313	42	271
B33R07C13	33-13-7	Hs~MGC:NM_183397.1~uORF:IOH44678	793	38	755
B33R07C14	33-14-7	Hs~MGC:NM_183397.1~uORF:IOH44678	786	37	749
B33R07C15	33-15-7	Hs~Ref:NM_182534.1~uORF:IOH40992	852	36	816
B33R07C16	33-16-7	Hs~Ref:NM_182534.1~uORF:IOH40992	873	37	836
B33R07C17	33-17-7	Hs~Ref:NM_199123.1~uORF:IOH42083	649	38	611
B33R07C18	33-18-7	Hs~Ref:NM_199123.1~uORF:IOH42083	648	37	611
B33R07C19	33-19-7	Hs~Ref:NM_025041.2~uORF:IOH44711	522	38	484
B33R07C20	33-20-7	Hs~Ref:NM_025041.2~uORF:IOH44711	523	38	485
B33R07C21	33-21-7	Hs~Ref:NM_033317.1~uORF:IOH14207	656	39	617
B33R07C22	33-22-7	Hs~Ref:NM_033317.1~uORF:IOH14207	797	43	754
B33R08C01	33-1-8	Hs~Ref:NM_005435.2~uORF:IOH14526	2403	44	2359
B33R08C02	33-2-8	Hs~Ref:NM_005435.2~uORF:IOH14526	2320	41	2279
B33R08C03	33-3-8	Hs~Ref:NM_017952.2~uORF:IOH14124	1396	38	1358
B33R08C04	33-4-8	Hs~Ref:NM_017952.2~uORF:IOH14124	1405	40	1365
B33R08C05	33-5-8	Hs~MGC:BC016381.1~uORF:IOH13653	65535	41	65494
B33R08C06	33-6-8	Hs~MGC:BC016381.1~uORF:IOH13653	65535	41	65494
B33R08C07	33-7-8	Hs~Ref:NM_001400.2~uORF:IOH14201	277	38	239
B33R08C08	33-8-8	Hs~Ref:NM_001400.2~uORF:IOH14201	315	44	271
B33R08C09	33-9-8	Hs~Ref:NM_020677.1~uORF:IOH5739	288	43	245
B33R08C10	33-10-8	Hs~Ref:NM_020677.1~uORF:IOH5739	282	42	240
B33R08C11	33-11-8	Hs~MGC:BC015947.1~uORF:IOH10114	299	149	150
B33R08C12	33-12-8	Hs~MGC:BC015947.1~uORF:IOH10114	362	38	324
B33R08C13	33-13-8	Hs~MGC:BC009961.1~uORF:IOH12967	447	39	408
B33R08C14	33-14-8	Hs~MGC:BC009961.1~uORF:IOH12967	421	39	382
B33R08C15	33-15-8	Hs~Ref:NM_001688.2~uORF:IOH7382	353	47	306
B33R08C16	33-16-8	Hs~Ref:NM_001688.2~uORF:IOH7382	223	36	187
B33R08C17	33-17-8	Hs~Ref:NM_005872.1~uORF:IOH7255	316	37	279
B33R08C18	33-18-8	Hs~Ref:NM_005872.1~uORF:IOH7255	331	38	293
B33R08C19	33-19-8	Hs~Ref:NM_012108.1~uORF:IOH13463	321	36	285
B33R08C20	33-20-8	Hs~Ref:NM_012108.1~uORF:IOH13463	284	37	247
B33R08C21	33-21-8	Hs~MGC:BC022340.1~uORF:IOH14764	416	38	378
B33R08C22	33-22-8	Hs~MGC:BC022340.1~uORF:IOH14764	348	45	303
B33R09C01	33-1-9	Hs~Ref:NM_181532.2~uORF:IOH35326	351	42	309
B33R09C02	33-2-9	Hs~Ref:NM_181532.2~uORF:IOH35326	322	39	283
B33R09C03	33-3-9	Hs~Ref:NM_000572.2~uORF:IOH29878	753	38	715
B33R09C04	33-4-9	Hs~Ref:NM_000572.2~uORF:IOH29878	692	39	653
B33R09C05	33-5-9	Hs~Ref:NM_181622.1~uORF:IOH35176	697	62	635
B33R09C06	33-6-9	Hs~Ref:NM_181622.1~uORF:IOH35176	652	40	612
B33R09C07	33-7-9	Hs~Ref:NM_176895.1~uORF:IOH29729	474	39	435
B33R09C08	33-8-9	Hs~Ref:NM_176895.1~uORF:IOH29729	710	43	667
B33R09C09	33-9-9	Hs~MGC:BC005364.1~uORF:IOH7240	113	39	74
B33R09C10	33-10-9	Hs~MGC:BC005364.1~uORF:IOH7240	103	39	64
B33R09C11	33-11-9	Hs~MGC:BC016764.1~uORF:IOH13805	374	48	326
B33R09C12	33-12-9	Hs~MGC:BC016764.1~uORF:IOH13805	343	36	307
B33R09C13	33-13-9	Hs~Ref:NM_018327.1~uORF:IOH14250	261	36	225
B33R09C14	33-14-9	Hs~Ref:NM_018327.1~uORF:IOH14250	288	39	249
B33R09C15	33-15-9	Hs~Ref:NM_001225.2~uORF:IOH14345	226	48	178
B33R09C16	33-16-9	Hs~Ref:NM_001225.2~uORF:IOH14345	213	37	176
B33R09C17	33-17-9	Hs~Ref:NM_014448.2~uORF:IOH5304	375	37	338
B33R09C18	33-18-9	Hs~Ref:NM_014448.2~uORF:IOH5304	379	37	342
B33R09C19	33-19-9	Hs~Ref:NM_001864.2~uORF:IOH5372	277	38	239
B33R09C20	33-20-9	Hs~Ref:NM_001864.2~uORF:IOH5372	261	41	220
B33R09C21	33-21-9	Hs~MGC:BC002859.1~uORF:IOH5428	1347	44	1303
B33R09C22	33-22-9	Hs~MGC:BC002859.1~uORF:IOH5428	1783	227	1556
B33R10C01	33-1-10	Hs~Ref:NM_030577.1~uORF:IOH5575	1099	102	997
B33R10C02	33-2-10	Hs~Ref:NM_030577.1~uORF:IOH5575	119	38	81
B33R10C03	33-3-10	Hs~Ref:NM_032648.1~uORF:IOH5485	737	36	701
B33R10C04	33-4-10	Hs~Ref:NM_032648.1~uORF:IOH5485	680	43	637
B33R10C05	33-5-10	Hs~Ref:NM_032321.1~uORF:IOH6608	272	190	82
B33R10C06	33-6-10	Hs~Ref:NM_032321.1~uORF:IOH6608	262	43	219
B33R10C07	33-7-10	Hs~MGC:BC005043.1~uORF:IOH6656	4077	39	4038
B33R10C08	33-8-10	Hs~MGC:BC005043.1~uORF:IOH6656	3845	38	3807
B33R10C09	33-9-10	Hs~Ref:NM_138779.2~uORF:IOH45970	889	48	841
B33R10C10	33-10-10	Hs~Ref:NM_138779.2~uORF:IOH45970	798	38	760
B33R10C11	33-11-10	GST1	53	36	17
B33R10C12	33-12-10	GST1	36	34	2
B33R10C13	33-13-10	GST2	38	34	4
B33R10C14	33-14-10	GST2	38	35	3
B33R10C15	33-15-10	GST3	41	35	6
B33R10C16	33-16-10	GST3	42	35	7
B33R10C17	33-17-10	GST4	60	35	25
B33R10C18	33-18-10	GST4	49	35	14
B33R10C19	33-19-10	Anti-HumanIgA1~N/A	7687	37	7650
B33R10C20	33-20-10	Anti-HumanIgA1~N/A	6696	38	6658
B33R10C21	33-21-10	Anti-HumanIgA2~N/A	13025	37	12988
B33R10C22	33-22-10	Anti-HumanIgA2~N/A	9746	46	9700
B33R11C01	33-1-11	AlexaAntiMouseAb~N/A	23081	41	23040
B33R11C02	33-2-11	AlexaAntiMouseAb~N/A	22622	43	22579
B33R11C03	33-3-11	MAPKAP~N/A	52	43	9
B33R11C04	33-4-11	MAPKAP~N/A	53	44	9
B33R11C05	33-5-11	Buffer	1213	42	1171
B33R11C06	33-6-11	Buffer	1160	41	1119
B33R11C07	33-7-11	BSA~N/A	6445	37	6408
B33R11C08	33-8-11	BSA~N/A	6523	38	6485
B33R11C09	33-9-11	Anti-HumanIgG1~N/A	1360	37	1323
B33R11C10	33-10-11	Anti-HumanIgG1~N/A	1379	37	1342
B33R11C11	33-11-11	Anti-HumanIgG2~N/A	2430	37	2393
B33R11C12	33-12-11	Anti-HumanIgG2~N/A	2420	36	2384
B33R11C13	33-13-11	Anti-HumanIgG3~N/A	4332	37	4295
B33R11C14	33-14-11	Anti-HumanIgG3~N/A	4090	37	4053
B33R11C15	33-15-11	Anti-HumanIgG4~N/A	8734	37	8697
B33R11C16	33-16-11	Anti-HumanIgG4~N/A	9878	36	9842
B33R11C17	33-17-11	AntiBiotinAb~N/A	10413	36	10377
B33R11C18	33-18-11	AntiBiotinAb~N/A	10767	36	10731
B33R11C19	33-19-11	Buffer	47	35	12
B33R11C20	33-20-11	Buffer	41	36	5
B33R11C21	33-21-11	Hs~Ref:NM_005981.2~uORF:IOH14295	615	36	579
B33R11C22	33-22-11	Hs~Ref:NM_005981.2~uORF:IOH14295	541	43	498
B33R12C01	33-1-12	Hs~Ref:NM_002136.1~uORF:IOH3526	1054	47	1007
B33R12C02	33-2-12	Hs~Ref:NM_002136.1~uORF:IOH3526	1186	50	1136
B33R12C03	33-3-12	Hs~Ref:NM_016079.1~uORF:IOH5607	309	70	239
B33R12C04	33-4-12	Hs~Ref:NM_016079.1~uORF:IOH5607	307	70	237
B33R12C05	33-5-12	Hs~MGC:BC011804.2~uORF:IOH14438	1030	62	968
B33R12C06	33-6-12	Hs~MGC:BC011804.2~uORF:IOH14438	963	43	920
B33R12C07	33-7-12	Hs~MGC:BC007067.1~uORF:IOH57055	86	40	46
B33R12C08	33-8-12	Hs~MGC:BC007067.1~uORF:IOH57055	42	41	1
B33R12C09	33-9-12	Hs~Ref:NM_001920.3~uORF:IOH57041	160	45	115
B33R12C10	33-10-12	Hs~Ref:NM_001920.3~uORF:IOH57041	132	41	91
B33R12C11	33-11-12	Hs~MGC:BC075800.1~uORF:IOH62474	144	40	104
B33R12C12	33-12-12	Hs~MGC:BC075800.1~uORF:IOH62474	138	40	98
B33R12C13	33-13-12	Hs~MGC:BC073876.1~uORF:IOH61770	127	45	82
B33R12C14	33-14-12	Hs~MGC:BC073876.1~uORF:IOH61770	89	41	48
B33R12C15	33-15-12	Hs~Ref:NM_023039.2~uORF:IOH11016	59	36	23
B33R12C16	33-16-12	Hs~Ref:NM_023039.2~uORF:IOH11016	65	35	30
B33R12C17	33-17-12	Hs~Ref:NM_031412.1~uORF:IOH14808	263	40	223
B33R12C18	33-18-12	Hs~Ref:NM_031412.1~uORF:IOH14808	267	38	229
B33R12C19	33-19-12	Hs~Ref:NM_012241.2~uORF:IOH4405	1171	36	1135
B33R12C20	33-20-12	Hs~Ref:NM_012241.2~uORF:IOH4405	1223	37	1186
B33R12C21	33-21-12	Hs~MGC:BC008437.1~uORF:IOH7418	91	38	53
B33R12C22	33-22-12	Hs~MGC:BC008437.1~uORF:IOH7418	375	56	319
B33R13C01	33-1-13	Hs~Ref:NM_000528.2~uORF:IOH4607	808	56	752
B33R13C02	33-2-13	Hs~Ref:NM_000528.2~uORF:IOH4607	735	42	693
B33R13C03	33-3-13	Hs~MGC:BC040107.1~uORF:IOH26226	776	47	729
B33R13C04	33-4-13	Hs~MGC:BC040107.1~uORF:IOH26226	754	51	703
B33R13C05	33-5-13	Hs~MGC:BC041143.1~uORF:IOH26146	289	43	246
B33R13C06	33-6-13	Hs~MGC:BC041143.1~uORF:IOH26146	223	37	186
B33R13C07	33-7-13	Hs~MGC:BC047030.1~uORF:IOH26622	238	40	198
B33R13C08	33-8-13	Hs~MGC:BC047030.1~uORF:IOH26622	255	44	211
B33R13C09	33-9-13	Hs~Ref:NM_001017973.1~uORF:IOH26049	426	48	378
B33R13C10	33-10-13	Hs~Ref:NM_001017973.1~uORF:IOH26049	494	328	166
B33R13C11	33-11-13	Hs~Ref:NM_001001325.1~uORF:IOH50193	324	38	286
B33R13C12	33-12-13	Hs~Ref:NM_001001325.1~uORF:IOH50193	336	41	295
B33R13C13	33-13-13	Hs~Ref:NM_148910.1~uORF:IOH42286	910	46	864
B33R13C14	33-14-13	Hs~Ref:NM_148910.1~uORF:IOH42286	902	43	859
B33R13C15	33-15-13	Hs~Ref:NM_207499.1~uORF:IOH37385	356	37	319
B33R13C16	33-16-13	Hs~Ref:NM_207499.1~uORF:IOH37385	327	37	290
B33R13C17	33-17-13	Hs~Ref:NM_199131.1~uORF:IOH35218	438	39	399
B33R13C18	33-18-13	Hs~Ref:NM_199131.1~uORF:IOH35218	484	39	445
B33R13C19	33-19-13	Hs~MGC:BC069546.1~uORF:IOH61880	425	38	387
B33R13C20	33-20-13	Hs~MGC:BC069546.1~uORF:IOH61880	456	42	414
B33R13C21	33-21-13	Hs~Ref:NM_002055.1~uORF:IOH9657	1179	61	1118
B33R13C22	33-22-13	Hs~Ref:NM_002055.1~uORF:IOH9657	1041	66	975
B33R14C01	33-1-14	Hs~Ref:NM_001629.2~uORF:IOH11710	616	45	571
B33R14C02	33-2-14	Hs~Ref:NM_001629.2~uORF:IOH11710	856	42	814
B33R14C03	33-3-14	Hs~Ref:NM_021244.2~uORF:IOH41163	494	44	450
B33R14C04	33-4-14	Hs~Ref:NM_021244.2~uORF:IOH41163	446	251	195
B33R14C05	33-5-14	Hs~Ref:NM_024979.2~uORF:IOH23111	805	41	764
B33R14C06	33-6-14	Hs~Ref:NM_024979.2~uORF:IOH23111	729	38	691
B33R14C07	33-7-14	Hs~Ref:NM_002279.3~uORF:IOH13096	67	49	18
B33R14C08	33-8-14	Hs~Ref:NM_002279.3~uORF:IOH13096	158	42	116
B33R14C09	33-9-14	Hs~Ref:NM_182563.2~uORF:IOH25780	105	50	55
B33R14C10	33-10-14	Hs~Ref:NM_182563.2~uORF:IOH25780	112	46	66
B33R14C11	33-11-14	Hs~MGC:BC029444.1~uORF:IOH23178	12666	37	12629
B33R14C12	33-12-14	Hs~MGC:BC029444.1~uORF:IOH23178	13396	38	13358
B33R14C13	33-13-14	Hs~MGC:BC034142.1~uORF:IOH23177	25523	43	25480
B33R14C14	33-14-14	Hs~MGC:BC034142.1~uORF:IOH23177	25627	38	25589
B33R14C15	33-15-14	Hs~Ref:NM_005522.3~uORF:IOH21992	55563	37	55526
B33R14C16	33-16-14	Hs~Ref:NM_005522.3~uORF:IOH21992	53359	37	53322
B33R14C17	33-17-14	Hs~Ref:NM_005047.2~uORF:IOH12867	352	41	311
B33R14C18	33-18-14	Hs~Ref:NM_005047.2~uORF:IOH12867	358	40	318
B33R14C19	33-19-14	Hs~Ref:NM_182835.1~uORF:IOH45521	552	38	514
B33R14C20	33-20-14	Hs~Ref:NM_182835.1~uORF:IOH45521	633	39	594
B33R14C21	33-21-14	Hs~Ref:NM_134427.1~uORF:IOH45474	3209	54	3155
B33R14C22	33-22-14	Hs~Ref:NM_134427.1~uORF:IOH45474	2611	58	2553
B33R15C01	33-1-15	Hs~Ref:NM_004706.3~uORF:IOH45526	438	165	273
B33R15C02	33-2-15	Hs~Ref:NM_004706.3~uORF:IOH45526	447	40	407
B33R15C03	33-3-15	Hs~MGC:BC027994.1~uORF:IOH11366	276	40	236
B33R15C04	33-4-15	Hs~MGC:BC027994.1~uORF:IOH11366	472	91	381
B33R15C05	33-5-15	Hs~Ref:XM_379309.2~uORF:IOH43186	182	37	145
B33R15C06	33-6-15	Hs~Ref:XM_379309.2~uORF:IOH43186	503	199	304
B33R15C07	33-7-15	Hs~MGC:NM_153032.1~uORF:IOH43325	204	42	162
B33R15C08	33-8-15	Hs~MGC:NM_153032.1~uORF:IOH43325	254	39	215
B33R15C09	33-9-15	Hs~Ref:NM_198489.1~uORF:IOH43342	1401	40	1361
B33R15C10	33-10-15	Hs~Ref:NM_198489.1~uORF:IOH43342	1203	40	1163
B33R15C11	33-11-15	Hs~Ref:NM_001008237.1~uORF:IOH43157	1999	38	1961
B33R15C12	33-12-15	Hs~Ref:NM_001008237.1~uORF:IOH43157	2055	39	2016
B33R15C13	33-13-15	Hs~IVGN:PM_2142~Ext:ssDNA~N/A	115	37	78
B33R15C14	33-14-15	Hs~IVGN:PM_2142~Ext:ssDNA~N/A	245	40	205
B33R15C15	33-15-15	Hs~Ref:NM_001274.2~CAT:P3040	51	35	16
B33R15C16	33-16-15	Hs~Ref:NM_001274.2~CAT:P3040	53	35	18
B33R15C17	33-17-15	Hs~Ref:NM_014326.2~CAT:PV3614	405	35	370
B33R15C18	33-18-15	Hs~Ref:NM_014326.2~CAT:PV3614	434	35	399
B33R15C19	33-19-15	Hs~Ref:NM_002419.2~CAT:PV3788	264	104	160
B33R15C20	33-20-15	Hs~Ref:NM_002419.2~CAT:PV3788	123	36	87
B33R15C21	33-21-15	Hs~Ref:NM_001024937.1~CAT:PV3810	51	41	10
B33R15C22	33-22-15	Hs~Ref:NM_001024937.1~CAT:PV3810	456	52	404
B33R16C01	33-1-16	Hs~Ref:NM_004579.2~CAT:PV4211	98	40	58
B33R16C02	33-2-16	Hs~Ref:NM_004579.2~CAT:PV4211	96	38	58
B33R16C03	33-3-16	Hs~Ref:NM_004451.3~CAT:PV4665	115	42	73
B33R16C04	33-4-16	Hs~Ref:NM_004451.3~CAT:PV4665	120	40	80
B33R16C05	33-5-16	Hs~Ref:NM_000594.2~CAT_PHC3015L	38	37	1
B33R16C06	33-6-16	Hs~Ref:NM_000594.2~CAT_PHC3015L	69	37	32
B33R16C07	33-7-16	Hs~MGC:BC060786.1~uORF:IOH29290	687	396	291
B33R16C08	33-8-16	Hs~MGC:BC060786.1~uORF:IOH29290	620	184	436
B33R16C09	33-9-16	Hs~MGC:BC036651.2~uORF:IOH28634	852	42	810
B33R16C10	33-10-16	Hs~MGC:BC036651.2~uORF:IOH28634	765	40	725
B33R16C11	33-11-16	Hs~MGC:BC002704.1~uORF:IOH5332	558	41	517
B33R16C12	33-12-16	Hs~MGC:BC002704.1~uORF:IOH5332	643	44	599
B33R16C13	33-13-16	Hs~MGC:BC001274.1~uORF:IOH3095	724	39	685
B33R16C14	33-14-16	Hs~MGC:BC001274.1~uORF:IOH3095	669	37	632
B33R16C15	33-15-16	Hs~Ref:XM_167152.4~uORF:IOH43549	437	36	401
B33R16C16	33-16-16	Hs~Ref:XM_167152.4~uORF:IOH43549	397	36	361
B33R16C17	33-17-16	Hs~MGC:BC041876.1~uORF:IOH27738	587	37	550
B33R16C18	33-18-16	Hs~MGC:BC041876.1~uORF:IOH27738	551	37	514
B33R16C19	33-19-16	Hs~Ref:NM_001009554.1~uORF:IOH45685	404	38	366
B33R16C20	33-20-16	Hs~Ref:NM_001009554.1~uORF:IOH45685	426	38	388
B33R16C21	33-21-16	Hs~MGC:BC017475.1~uORF:IOH14365	281	43	238
B33R16C22	33-22-16	Hs~MGC:BC017475.1~uORF:IOH14365	635	58	577
B33R17C01	33-1-17	Hs~MGC:BC007080.1~uORF:IOH7467	328	39	289
B33R17C02	33-2-17	Hs~MGC:BC007080.1~uORF:IOH7467	312	41	271
B33R17C03	33-3-17	Hs~Ref:NM_023926.2~uORF:IOH22949	249	49	200
B33R17C04	33-4-17	Hs~Ref:NM_023926.2~uORF:IOH22949	235	46	189
B33R17C05	33-5-17	Hs~Ref:NM_016267.1~uORF:IOH2890	1746	41	1705
B33R17C06	33-6-17	Hs~Ref:NM_016267.1~uORF:IOH2890	1707	41	1666
B33R17C07	33-7-17	Hs~Ref:NM_003891.1~uORF:IOH29585	474	66	408
B33R17C08	33-8-17	Hs~Ref:NM_003891.1~uORF:IOH29585	187	53	134
B33R17C09	33-9-17	Hs~MGC:BC032598.1~uORF:IOH21976	492	41	451
B33R17C10	33-10-17	Hs~MGC:BC032598.1~uORF:IOH21976	466	39	427
B33R17C11	33-11-17	Hs~MGC:BC032587.1~uORF:IOH21953	807	41	766
B33R17C12	33-12-17	Hs~MGC:BC032587.1~uORF:IOH21953	740	43	697
B33R17C13	33-13-17	Hs~Ref:NM_053046.2~uORF:IOH27186	699	40	659
B33R17C14	33-14-17	Hs~Ref:NM_053046.2~uORF:IOH27186	663	36	627
B33R17C15	33-15-17	Hs~MGC:BC033881.1~uORF:IOH22099	525	37	488
B33R17C16	33-16-17	Hs~MGC:BC033881.1~uORF:IOH22099	513	38	475
B33R17C17	33-17-17	Hs~Ref:NM_022142.3~uORF:IOH13085	299	38	261
B33R17C18	33-18-17	Hs~Ref:NM_022142.3~uORF:IOH13085	308	42	266
B33R17C19	33-19-17	Hs~Ref:NM_000200.1~uORF:IOH12986	274	39	235
B33R17C20	33-20-17	Hs~Ref:NM_000200.1~uORF:IOH12986	416	48	368
B33R17C21	33-21-17	Hs~MGC:BC011578.1~uORF:IOH12646	239	46	193
B33R17C22	33-22-17	Hs~MGC:BC011578.1~uORF:IOH12646	528	73	455
B33R18C01	33-1-18	Hs~MGC:NM_152394.2~uORF:IOH21592	494	59	435
B33R18C02	33-2-18	Hs~MGC:NM_152394.2~uORF:IOH21592	354	99	255
B33R18C03	33-3-18	Hs~Ref:NM_017719.2~N/A	623	41	582
B33R18C04	33-4-18	Hs~Ref:NM_017719.2~N/A	649	42	607
B33R18C05	33-5-18	Hs~Ref:NM_021158.1~N/A	822	41	781
B33R18C06	33-6-18	Hs~Ref:NM_021158.1~N/A	802	41	761
B33R18C07	33-7-18	Hs~Ref:NM_032409.1~N/A	300	42	258
B33R18C08	33-8-18	Hs~Ref:NM_032409.1~N/A	173	52	121
B33R18C09	33-9-18	Hs~Ref:NM_014920.1~N/A	808	40	768
B33R18C10	33-10-18	Hs~Ref:NM_014920.1~N/A	889	38	851
B33R18C11	33-11-18	Hs~Ref:NM_207327.4~uORF:IOH40136	854	40	814
B33R18C12	33-12-18	Hs~Ref:NM_207327.4~uORF:IOH40136	843	44	799
B33R18C13	33-13-18	Hs~Ref:NM_018145.1~uORF:IOH40027	54	43	11
B33R18C14	33-14-18	Hs~Ref:NM_018145.1~uORF:IOH40027	38	37	1
B33R18C15	33-15-18	Hs~Ref:NM_001692.2~uORF:IOH39878	339	36	303
B33R18C16	33-16-18	Hs~Ref:NM_001692.2~uORF:IOH39878	375	38	337
B33R18C17	33-17-18	Hs~Ref:NM_001926.2~uORF:IOH40361	386	39	347
B33R18C18	33-18-18	Hs~Ref:NM_001926.2~uORF:IOH40361	385	40	345
B33R18C19	33-19-18	Hs~MGC:BC096285.2~uORF:IOH63237	589	45	544
B33R18C20	33-20-18	Hs~MGC:BC096285.2~uORF:IOH63237	574	40	534
B33R18C21	33-21-18	Hs~MGC:BC017408.1~uORF:IOH27934	2252	47	2205
B33R18C22	33-22-18	Hs~MGC:BC017408.1~uORF:IOH27934	1286	65	1221
B33R19C01	33-1-19	Hs~Ref:NM_012244.2~uORF:IOH28096	378	43	335
B33R19C02	33-2-19	Hs~Ref:NM_012244.2~uORF:IOH28096	357	43	314
B33R19C03	33-3-19	Hs~Ref:NM_052874.1~uORF:IOH40693	402	45	357
B33R19C04	33-4-19	Hs~Ref:NM_052874.1~uORF:IOH40693	490	46	444
B33R19C05	33-5-19	Hs~Ref:NM_080617.4~uORF:IOH40259	665	39	626
B33R19C06	33-6-19	Hs~Ref:NM_080617.4~uORF:IOH40259	715	39	676
B33R19C07	33-7-19	Hs~Ref:NM_017817.1~uORF:IOH12515	592	49	543
B33R19C08	33-8-19	Hs~Ref:NM_017817.1~uORF:IOH12515	498	52	446
B33R19C09	33-9-19	Hs~MGC:BC018048.1~uORF:IOH10610	415	74	341
B33R19C10	33-10-19	Hs~MGC:BC018048.1~uORF:IOH10610	368	44	324
B33R19C11	33-11-19	Hs~MGC:BC017066.1~uORF:IOH11186	145	40	105
B33R19C12	33-12-19	Hs~MGC:BC017066.1~uORF:IOH11186	142	42	100
B33R19C13	33-13-19	Hs~Ref:NM_152322.2~uORF:IOH44718	541	47	494
B33R19C14	33-14-19	Hs~Ref:NM_152322.2~uORF:IOH44718	497	41	456
B33R19C15	33-15-19	Hs~Ref:NM_002795.1~uORF:IOH14510	254	38	216
B33R19C16	33-16-19	Hs~Ref:NM_002795.1~uORF:IOH14510	281	173	108
B33R19C17	33-17-19	Hs~Ref:NM_152706.2~uORF:IOH11478	311	42	269
B33R19C18	33-18-19	Hs~Ref:NM_152706.2~uORF:IOH11478	314	51	263
B33R19C19	33-19-19	Hs~MGC:BC010629.1~uORF:IOH9802	1023	41	982
B33R19C20	33-20-19	Hs~MGC:BC010629.1~uORF:IOH9802	1038	39	999
B33R19C21	33-21-19	Hs~MGC:BC003182.1~uORF:IOH5146	301	45	256
B33R19C22	33-22-19	Hs~MGC:BC003182.1~uORF:IOH5146	799	63	736
B33R20C01	33-1-20	Hs~Ref:NM_004448.1~N/A	172	43	129
B33R20C02	33-2-20	Hs~Ref:NM_004448.1~N/A	156	41	115
B33R20C03	33-3-20	Hs~Ref:NM_002031.1~N/A	244	41	203
B33R20C04	33-4-20	Hs~Ref:NM_002031.1~N/A	364	45	319
B33R20C05	33-5-20	Hs~Ref:NM_001619.2~N/A	163	40	123
B33R20C06	33-6-20	Hs~Ref:NM_001619.2~N/A	142	37	105
B33R20C07	33-7-20	Hs~MGC:BC009797.1~uORF:IOH13683	192	41	151
B33R20C08	33-8-20	Hs~MGC:BC009797.1~uORF:IOH13683	59	40	19
B33R20C09	33-9-20	Hs~MGC:NM_139156.1~uORF:IOH6401	53	55	-2
B33R20C10	33-10-20	Hs~MGC:NM_139156.1~uORF:IOH6401	144	41	103
B33R20C11	33-11-20	Hs~Ref:NM_024837.2~uORF:IOH53173	173	41	132
B33R20C12	33-12-20	Hs~Ref:NM_024837.2~uORF:IOH53173	118	44	74
B33R20C13	33-13-20	Hs~Ref:NM_022343.2~uORF:IOH59950	56	44	12
B33R20C14	33-14-20	Hs~Ref:NM_022343.2~uORF:IOH59950	69	42	27
B33R20C15	33-15-20	Hs~Ref:NM_153018.1~uORF:IOH41683	401	35	366
B33R20C16	33-16-20	Hs~Ref:NM_153018.1~uORF:IOH41683	421	35	386
B33R20C17	33-17-20	Hs~Ref:NM_001934.2~uORF:IOH44385	100	36	64
B33R20C18	33-18-20	Hs~Ref:NM_001934.2~uORF:IOH44385	88	36	52
B33R20C19	33-19-20	Hs~Ref:NM_020653.1~uORF:IOH44906	602	38	564
B33R20C20	33-20-20	Hs~Ref:NM_020653.1~uORF:IOH44906	1042	125	917
B33R20C21	33-21-20	Hs~Ref:NM_016359.2~uORF:IOH45439	669	53	616
B33R20C22	33-22-20	Hs~Ref:NM_016359.2~uORF:IOH45439	643	333	310
B33R21C01	33-1-21	Hs~Ref:NM_205854.1~uORF:IOH43313	78	40	38
B33R21C02	33-2-21	Hs~Ref:NM_205854.1~uORF:IOH43313	79	40	39
B33R21C03	33-3-21	Hs~Ref:BC104179.1~uORF:IOH43403	87	53	34
B33R21C04	33-4-21	Hs~Ref:BC104179.1~uORF:IOH43403	180	58	122
B33R21C05	33-5-21	Hs~Ref:ENST00000332492~uORF:IOH43086	49	43	6
B33R21C06	33-6-21	Hs~Ref:ENST00000332492~uORF:IOH43086	65	43	22
B33R21C07	33-7-21	Hs~Ref:NM_014443.2~uORF:IOH43021	198	38	160
B33R21C08	33-8-21	Hs~Ref:NM_014443.2~uORF:IOH43021	187	38	149
B33R21C09	33-9-21	Hs~Ref:NP_004351.1~CAT_10204-H08H-25	35	39	-4
B33R21C10	33-10-21	Hs~Ref:NP_004351.1~CAT_10204-H08H-25	38	34	4
B33R21C11	33-11-21	Internal_1007209	65535	44	65491
B33R21C12	33-12-21	Internal_1007209	65535	42	65493
B33R21C13	33-13-21	Hs~Ref:P01566~CAT_10349-H01H-25	9840	40	9800
B33R21C14	33-14-21	Hs~Ref:P01566~CAT_10349-H01H-25	9823	41	9782
B33R21C15	33-15-21	Internal_1007209	63	40	23
B33R21C16	33-16-21	Internal_1007209	43	35	8
B33R21C17	33-17-21	Hs~Ref:NP_004325.2~CAT_10060-H08H-25	34	35	-1
B33R21C18	33-18-21	Hs~Ref:NP_004325.2~CAT_10060-H08H-25	37	36	1
B33R21C19	33-19-21	Internal_1007209	178	36	142
B33R21C20	33-20-21	Internal_1007209	154	40	114
B33R21C21	33-21-21	Hs~Ref:CR542171~CAT_PHC9221	985	108	877
B33R21C22	33-22-21	Hs~Ref:CR542171~CAT_PHC9221	867	58	809
B33R22C01	33-1-22	ERa~N/A	2059	41	2018
B33R22C02	33-2-22	ERa~N/A	2042	40	2002
B33R22C03	33-3-22	PKCeta~N/A	160	39	121
B33R22C04	33-4-22	PKCeta~N/A	294	68	226
B33R22C05	33-5-22	Calmodulin~N/A	158	42	116
B33R22C06	33-6-22	Calmodulin~N/A	101	47	54
B33R22C07	33-7-22	V5control5~N/A	2170	62	2108
B33R22C08	33-8-22	V5control5~N/A	279	68	211
B33R22C09	33-9-22	V5control4~N/A	103	54	49
B33R22C10	33-10-22	V5control4~N/A	91	39	52
B33R22C11	33-11-22	V5control3~N/A	49	36	13
B33R22C12	33-12-22	V5control3~N/A	97	44	53
B33R22C13	33-13-22	V5control2~N/A	50	35	15
B33R22C14	33-14-22	V5control2~N/A	47	38	9
B33R22C15	33-15-22	V5control1~N/A	50	40	10
B33R22C16	33-16-22	V5control1~N/A	41	39	2
B33R22C17	33-17-22	CMK2A~N/A	570	36	534
B33R22C18	33-18-22	CMK2A~N/A	509	35	474
B33R22C19	33-19-22	ERa~N/A	1967	35	1932
B33R22C20	33-20-22	ERa~N/A	2027	39	1988
B33R22C21	33-21-22	AlexaAntiMouseAb~N/A	9891	55	9836
B33R22C22	33-22-22	AlexaAntiMouseAb~N/A	9672	52	9620
B34R01C01	34-1-1	AlexaAntiMouseAb~N/A	31348	50	31298
B34R01C02	34-2-1	AlexaAntiMouseAb~N/A	39295	83	39212
B34R01C03	34-3-1	ERa~N/A	1873	81	1792
B34R01C04	34-4-1	ERa~N/A	1879	45	1834
B34R01C05	34-5-1	HumanIgG1~N/A	1461	45	1416
B34R01C06	34-6-1	HumanIgG1~N/A	1482	43	1439
B34R01C07	34-7-1	HumanIgG2~N/A	3336	44	3292
B34R01C08	34-8-1	HumanIgG2~N/A	3185	46	3139
B34R01C09	34-9-1	HumanIgG3~N/A	14340	47	14293
B34R01C10	34-10-1	HumanIgG3~N/A	16558	54	16504
B34R01C11	34-11-1	HumanIgG4~N/A	54674	63	54611
B34R01C12	34-12-1	HumanIgG4~N/A	61174	51	61123
B34R01C13	34-13-1	BiotinAb~N/A	432	44	388
B34R01C14	34-14-1	BiotinAb~N/A	505	42	463
B34R01C15	34-15-1	RanBP2deltaFG~N/A	297	44	253
B34R01C16	34-16-1	RanBP2deltaFG~N/A	224	46	178
B34R01C17	34-17-1	hMDM2~N/A	793	47	746
B34R01C18	34-18-1	hMDM2~N/A	793	46	747
B34R01C19	34-19-1	PKCeta~N/A	484	49	435
B34R01C20	34-20-1	PKCeta~N/A	339	49	290
B34R01C21	34-21-1	AlexaAntiMouseAb~N/A	33396	41	33355
B34R01C22	34-22-1	AlexaAntiMouseAb~N/A	35178	40	35138
B34R02C01	34-1-2	PKCeta~N/A	965	57	908
B34R02C02	34-2-2	PKCeta~N/A	1196	85	1111
B34R02C03	34-3-2	Buffer	474	93	381
B34R02C04	34-4-2	Buffer	48	49	-1
B34R02C05	34-5-2	HumanIgA~N/A	25598	44	25554
B34R02C06	34-6-2	HumanIgA~N/A	24724	43	24681
B34R02C07	34-7-2	Buffer	66	46	20
B34R02C08	34-8-2	Buffer	59	54	5
B34R02C09	34-9-2	BSA~N/A	13376	60	13316
B34R02C10	34-10-2	BSA~N/A	13187	64	13123
B34R02C11	34-11-2	Hs~Ref:NM_032343.1~uORF:IOH6589	815	63	752
B34R02C12	34-12-2	Hs~Ref:NM_032343.1~uORF:IOH6589	764	57	707
B34R02C13	34-13-2	Hs~Ref:NM_032369.1~uORF:IOH6885	353	49	304
B34R02C14	34-14-2	Hs~Ref:NM_032369.1~uORF:IOH6885	317	46	271
B34R02C15	34-15-2	Hs~Ref:NM_138455.1~uORF:IOH14338	273	45	228
B34R02C16	34-16-2	Hs~Ref:NM_138455.1~uORF:IOH14338	227	45	182
B34R02C17	34-17-2	Hs~MGC:BC020788.1~uORF:IOH12612	825	48	777
B34R02C18	34-18-2	Hs~MGC:BC020788.1~uORF:IOH12612	705	51	654
B34R02C19	34-19-2	Hs~MGC:BC030642.2~uORF:IOH22273	659	54	605
B34R02C20	34-20-2	Hs~MGC:BC030642.2~uORF:IOH22273	639	54	585
B34R02C21	34-21-2	Hs~Ref:NM_000206.1~uORF:IOH14230	644	46	598
B34R02C22	34-22-2	Hs~Ref:NM_000206.1~uORF:IOH14230	603	42	561
B34R03C01	34-1-3	Hs~MGC:BC022082.1~uORF:IOH22416	818	96	722
B34R03C02	34-2-3	Hs~MGC:BC022082.1~uORF:IOH22416	733	200	533
B34R03C03	34-3-3	Hs~Ref:NM_003256.2~uORF:IOH10243	820	58	762
B34R03C04	34-4-3	Hs~Ref:NM_003256.2~uORF:IOH10243	785	48	737
B34R03C05	34-5-3	Hs~Ref:XM_084990.6~uORF:IOH42207	161	45	116
B34R03C06	34-6-3	Hs~Ref:XM_084990.6~uORF:IOH42207	132	45	87
B34R03C07	34-7-3	Hs~MGC:NM_004545.3~uORF:IOH43540	121	79	42
B34R03C08	34-8-3	Hs~MGC:NM_004545.3~uORF:IOH43540	105	65	40
B34R03C09	34-9-3	Hs~Ref:NM_198493.1~uORF:IOH43276	1619	58	1561
B34R03C10	34-10-3	Hs~Ref:NM_198493.1~uORF:IOH43276	1533	69	1464
B34R03C11	34-11-3	Hs~Ref:NM_152340.1~uORF:IOH42183	360	124	236
B34R03C12	34-12-3	Hs~Ref:NM_152340.1~uORF:IOH42183	375	130	245
B34R03C13	34-13-3	Hs~Ref:NM_152382.1~uORF:IOH39899	110	48	62
B34R03C14	34-14-3	Hs~Ref:NM_152382.1~uORF:IOH39899	148	48	100
B34R03C15	34-15-3	Hs~Ref:NM_020125.1~uORF:IOH41018	213	50	163
B34R03C16	34-16-3	Hs~Ref:NM_020125.1~uORF:IOH41018	164	48	116
B34R03C17	34-17-3	Hs~Ref:NM_018396.1~uORF:IOH43688	262	50	212
B34R03C18	34-18-3	Hs~Ref:NM_018396.1~uORF:IOH43688	272	57	215
B34R03C19	34-19-3	Hs~Ref:NM_018430.1~uORF:IOH44089	541	54	487
B34R03C20	34-20-3	Hs~Ref:NM_018430.1~uORF:IOH44089	452	66	386
B34R03C21	34-21-3	Hs~MGC:BC020203.1~uORF:IOH14766	490	62	428
B34R03C22	34-22-3	Hs~MGC:BC020203.1~uORF:IOH14766	520	46	474
B34R04C01	34-1-4	Hs~Ref:NM_145273.1~uORF:IOH10923	465	55	410
B34R04C02	34-2-4	Hs~Ref:NM_145273.1~uORF:IOH10923	335	57	278
B34R04C03	34-3-4	Hs~MGC:BC012542.1~uORF:IOH14219	330	47	283
B34R04C04	34-4-4	Hs~MGC:BC012542.1~uORF:IOH14219	425	45	380
B34R04C05	34-5-4	Hs~MGC:NM_153207.2~uORF:IOH14301	1271	44	1227
B34R04C06	34-6-4	Hs~MGC:NM_153207.2~uORF:IOH14301	1307	44	1263
B34R04C07	34-7-4	Hs~Ref:NM_030814.4~uORF:IOH23215	1410	45	1365
B34R04C08	34-8-4	Hs~Ref:NM_030814.4~uORF:IOH23215	1541	47	1494
B34R04C09	34-9-4	Hs~MGC:BC017959.1~uORF:IOH12310	4580	46	4534
B34R04C10	34-10-4	Hs~MGC:BC017959.1~uORF:IOH12310	4643	48	4595
B34R04C11	34-11-4	Hs~MGC:BC030983.1~uORF:IOH23183	64530	117	64413
B34R04C12	34-12-4	Hs~MGC:BC030983.1~uORF:IOH23183	62470	79	62391
B34R04C13	34-13-4	Hs~MGC:BC029406.1~uORF:IOH23195	691	52	639
B34R04C14	34-14-4	Hs~MGC:BC029406.1~uORF:IOH23195	622	47	575
B34R04C15	34-15-4	Hs~Ref:NM_016233.1~uORF:IOH44889	524	46	478
B34R04C16	34-16-4	Hs~Ref:NM_016233.1~uORF:IOH44889	474	46	428
B34R04C17	34-17-4	Hs~Ref:NM_021912.2~uORF:IOH43073	143	46	97
B34R04C18	34-18-4	Hs~Ref:NM_021912.2~uORF:IOH43073	113	52	61
B34R04C19	34-19-4	Hs~Ref:NM_001302.3~uORF:IOH42947	524	50	474
B34R04C20	34-20-4	Hs~Ref:NM_001302.3~uORF:IOH42947	490	53	437
B34R04C21	34-21-4	Hs~Ref:NM_024800.1~N/A	376	68	308
B34R04C22	34-22-4	Hs~Ref:NM_024800.1~N/A	529	51	478
B34R05C01	34-1-5	Hs~Ref:XM_379632.1~uORF:IOH43275	219	54	165
B34R05C02	34-2-5	Hs~Ref:XM_379632.1~uORF:IOH43275	165	54	111
B34R05C03	34-3-5	Hs~Ref:XM_113825.3~uORF:IOH43376	147	46	101
B34R05C04	34-4-5	Hs~Ref:XM_113825.3~uORF:IOH43376	194	47	147
B34R05C05	34-5-5	Hs~Ref:NM_177457.2~uORF:IOH43474	250	45	205
B34R05C06	34-6-5	Hs~Ref:NM_177457.2~uORF:IOH43474	282	127	155
B34R05C07	34-7-5	Hs~Ref:NM_172193.1~uORF:IOH43476	282	55	227
B34R05C08	34-8-5	Hs~Ref:NM_172193.1~uORF:IOH43476	51	59	-8
B34R05C09	34-9-5	Hs~MGC:BC034435.1~uORF:IOH21500	761	48	713
B34R05C10	34-10-5	Hs~MGC:BC034435.1~uORF:IOH21500	782	47	735
B34R05C11	34-11-5	Hs~MGC:BC008765.2~uORF:IOH5957	447	52	395
B34R05C12	34-12-5	Hs~MGC:BC008765.2~uORF:IOH5957	464	53	411
B34R05C13	34-13-5	Hs~Ref:NM_005526.1~uORF:IOH13558	168	50	118
B34R05C14	34-14-5	Hs~Ref:NM_005526.1~uORF:IOH13558	166	49	117
B34R05C15	34-15-5	Hs~MGC:BC021180.2~uORF:IOH11041	688	45	643
B34R05C16	34-16-5	Hs~MGC:BC021180.2~uORF:IOH11041	640	44	596
B34R05C17	34-17-5	Hs~Ref:NM_002716.3~uORF:IOH42140	254	42	212
B34R05C18	34-18-5	Hs~Ref:NM_002716.3~uORF:IOH42140	288	43	245
B34R05C19	34-19-5	Hs~Ref:NM_018988.1~uORF:IOH42390	1149	44	1105
B34R05C20	34-20-5	Hs~Ref:NM_018988.1~uORF:IOH42390	1074	46	1028
B34R05C21	34-21-5	Hs~Ref:NM_148976.1~uORF:IOH41126	1604	46	1558
B34R05C22	34-22-5	Hs~Ref:NM_148976.1~uORF:IOH41126	1452	45	1407
B34R06C01	34-1-6	Hs~Ref:NM_003605.3~uORF:IOH42213	213	64	149
B34R06C02	34-2-6	Hs~Ref:NM_003605.3~uORF:IOH42213	173	58	115
B34R06C03	34-3-6	Hs~MGC:BC011888.1~uORF:IOH14513	147	44	103
B34R06C04	34-4-6	Hs~MGC:BC011888.1~uORF:IOH14513	121	44	77
B34R06C05	34-5-6	Hs~Ref:NM_004331.1~uORF:IOH10961	158	44	114
B34R06C06	34-6-6	Hs~Ref:NM_004331.1~uORF:IOH10961	202	44	158
B34R06C07	34-7-6	Hs~Ref:NM_006184.2~uORF:IOH3531	50	49	1
B34R06C08	34-8-6	Hs~Ref:NM_006184.2~uORF:IOH3531	42	47	-5
B34R06C09	34-9-6	Hs~Ref:NM_199294.1~uORF:IOH23127	49	46	3
B34R06C10	34-10-6	Hs~Ref:NM_199294.1~uORF:IOH23127	47	45	2
B34R06C11	34-11-6	Hs~Ref:NM_002275.1~uORF:IOH5303	469	43	426
B34R06C12	34-12-6	Hs~Ref:NM_002275.1~uORF:IOH5303	534	45	489
B34R06C13	34-13-6	Hs~Ref:NM_006479.2~uORF:IOH7384	2325	43	2282
B34R06C14	34-14-6	Hs~Ref:NM_006479.2~uORF:IOH7384	2198	44	2154
B34R06C15	34-15-6	Hs~MGC:NM_152443.1~uORF:IOH10746	568	43	525
B34R06C16	34-16-6	Hs~MGC:NM_152443.1~uORF:IOH10746	540	43	497
B34R06C17	34-17-6	Hs~MGC:BC017168.1~uORF:IOH10008	442	41	401
B34R06C18	34-18-6	Hs~MGC:BC017168.1~uORF:IOH10008	376	43	333
B34R06C19	34-19-6	Hs~MGC:BC096222.1~uORF:IOH63215	518	44	474
B34R06C20	34-20-6	Hs~MGC:BC096222.1~uORF:IOH63215	507	46	461
B34R06C21	34-21-6	Hs~MGC:BC095485.1~uORF:IOH62662	378	44	334
B34R06C22	34-22-6	Hs~MGC:BC095485.1~uORF:IOH62662	349	43	306
B34R07C01	34-1-7	Hs~MGC:BC085613.1~uORF:IOH62733	512	66	446
B34R07C02	34-2-7	Hs~MGC:BC085613.1~uORF:IOH62733	499	58	441
B34R07C03	34-3-7	Hs~MGC:BC096093.3~uORF:IOH63197	1165	44	1121
B34R07C04	34-4-7	Hs~MGC:BC096093.3~uORF:IOH63197	1033	43	990
B34R07C05	34-5-7	Hs~Ref:NM_178010.1~uORF:IOH43581	350	44	306
B34R07C06	34-6-7	Hs~Ref:NM_178010.1~uORF:IOH43581	347	51	296
B34R07C07	34-7-7	Hs~Ref:NM_002690.1~uORF:IOH41443	1581	63	1518
B34R07C08	34-8-7	Hs~Ref:NM_002690.1~uORF:IOH41443	1682	63	1619
B34R07C09	34-9-7	Hs~Ref:NM_022474.2~uORF:IOH44175	947	53	894
B34R07C10	34-10-7	Hs~Ref:NM_022474.2~uORF:IOH44175	919	49	870
B34R07C11	34-11-7	Hs~Ref:NM_000485.1~uORF:IOH41274	197	48	149
B34R07C12	34-12-7	Hs~Ref:NM_000485.1~uORF:IOH41274	129	47	82
B34R07C13	34-13-7	Hs~MGC:BC025242.1~uORF:IOH62968	322	42	280
B34R07C14	34-14-7	Hs~MGC:BC025242.1~uORF:IOH62968	369	61	308
B34R07C15	34-15-7	Hs~MGC:BC092449.1~uORF:IOH63170	493	46	447
B34R07C16	34-16-7	Hs~MGC:BC092449.1~uORF:IOH63170	488	44	444
B34R07C17	34-17-7	Hs~Ref:NM_144601.2~uORF:IOH26681	81	44	37
B34R07C18	34-18-7	Hs~Ref:NM_144601.2~uORF:IOH26681	55	46	9
B34R07C19	34-19-7	Hs~MGC:BC031063.1~uORF:IOH28655	50	46	4
B34R07C20	34-20-7	Hs~MGC:BC031063.1~uORF:IOH28655	53	48	5
B34R07C21	34-21-7	Hs~MGC:BC002660.1~uORF:IOH5287	55	47	8
B34R07C22	34-22-7	Hs~MGC:BC002660.1~uORF:IOH5287	147	43	104
B34R08C01	34-1-8	Hs~Ref:NM_016520.1~uORF:IOH5899	455	118	337
B34R08C02	34-2-8	Hs~Ref:NM_016520.1~uORF:IOH5899	310	56	254
B34R08C03	34-3-8	Hs~Ref:NM_002550.1~uORF:IOH28412	49	50	-1
B34R08C04	34-4-8	Hs~Ref:NM_002550.1~uORF:IOH28412	40	46	-6
B34R08C05	34-5-8	Hs~Ref:NM_015560.1~uORF:IOH38530	156	51	105
B34R08C06	34-6-8	Hs~Ref:NM_015560.1~uORF:IOH38530	148	46	102
B34R08C07	34-7-8	Hs~MGC:BC000116.1~uORF:IOH4364	1014	47	967
B34R08C08	34-8-8	Hs~MGC:BC000116.1~uORF:IOH4364	904	49	855
B34R08C09	34-9-8	Hs~Ref:NM_003908.1~uORF:IOH3554	409	52	357
B34R08C10	34-10-8	Hs~Ref:NM_003908.1~uORF:IOH3554	454	51	403
B34R08C11	34-11-8	Hs~MGC:BC000463.1~uORF:IOH3592	279	57	222
B34R08C12	34-12-8	Hs~MGC:BC000463.1~uORF:IOH3592	223	150	73
B34R08C13	34-13-8	Hs~Ref:NM_017727.2~uORF:IOH4312	270	43	227
B34R08C14	34-14-8	Hs~Ref:NM_017727.2~uORF:IOH4312	326	49	277
B34R08C15	34-15-8	Hs~MGC:BC012881.1~uORF:IOH10296	102	45	57
B34R08C16	34-16-8	Hs~MGC:BC012881.1~uORF:IOH10296	320	54	266
B34R08C17	34-17-8	Hs~MGC:BC021682.1~uORF:IOH12127	283	48	235
B34R08C18	34-18-8	Hs~MGC:BC021682.1~uORF:IOH12127	306	45	261
B34R08C19	34-19-8	Hs~Ref:NM_145303.1~uORF:IOH13071	137	46	91
B34R08C20	34-20-8	Hs~Ref:NM_145303.1~uORF:IOH13071	139	51	88
B34R08C21	34-21-8	Hs~Ref:NM_005726.2~uORF:IOH12647	107	50	57
B34R08C22	34-22-8	Hs~Ref:NM_005726.2~uORF:IOH12647	56	44	12
B34R09C01	34-1-9	Hs~MGC:BC068514.1~uORF:IOH40543	445	59	386
B34R09C02	34-2-9	Hs~MGC:BC068514.1~uORF:IOH40543	430	52	378
B34R09C03	34-3-9	Hs~Ref:NM_000899.3~uORF:IOH40380	445	68	377
B34R09C04	34-4-9	Hs~Ref:NM_000899.3~uORF:IOH40380	52	51	1
B34R09C05	34-5-9	Hs~MGC:BC068555.1~uORF:IOH40548	325	46	279
B34R09C06	34-6-9	Hs~MGC:BC068555.1~uORF:IOH40548	316	45	271
B34R09C07	34-7-9	Hs~Ref:NM_138416.1~uORF:IOH40625	328	44	284
B34R09C08	34-8-9	Hs~Ref:NM_138416.1~uORF:IOH40625	172	44	128
B34R09C09	34-9-9	Hs~Ref:NM_024053.1~uORF:IOH4348	419	140	279
B34R09C10	34-10-9	Hs~Ref:NM_024053.1~uORF:IOH4348	330	146	184
B34R09C11	34-11-9	Hs~Ref:NM_014765.1~uORF:IOH3218	507	45	462
B34R09C12	34-12-9	Hs~Ref:NM_014765.1~uORF:IOH3218	487	44	443
B34R09C13	34-13-9	Hs~Ref:NM_021178.1~uORF:IOH3409	827	41	786
B34R09C14	34-14-9	Hs~Ref:NM_021178.1~uORF:IOH3409	765	42	723
B34R09C15	34-15-9	Hs~Ref:NM_006802.1~uORF:IOH3503	208	47	161
B34R09C16	34-16-9	Hs~Ref:NM_006802.1~uORF:IOH3503	46	47	-1
B34R09C17	34-17-9	Hs~MGC:BC008069.2~uORF:IOH5756	719	43	676
B34R09C18	34-18-9	Hs~MGC:BC008069.2~uORF:IOH5756	673	44	629
B34R09C19	34-19-9	Hs~Ref:NM_032601.2~uORF:IOH12757	542	47	495
B34R09C20	34-20-9	Hs~Ref:NM_032601.2~uORF:IOH12757	544	48	496
B34R09C21	34-21-9	Hs~MGC:BC020711.1~uORF:IOH12325	608	49	559
B34R09C22	34-22-9	Hs~MGC:BC020711.1~uORF:IOH12325	596	61	535
B34R10C01	34-1-10	Hs~MGC:NM_173825.1~uORF:IOH13382	621	67	554
B34R10C02	34-2-10	Hs~MGC:NM_173825.1~uORF:IOH13382	616	59	557
B34R10C03	34-3-10	Hs~MGC:BC053595.1~uORF:IOH28970	804	44	760
B34R10C04	34-4-10	Hs~MGC:BC053595.1~uORF:IOH28970	731	43	688
B34R10C05	34-5-10	Hs~MGC:BC058285.1~uORF:IOH29450	197	44	153
B34R10C06	34-6-10	Hs~MGC:BC058285.1~uORF:IOH29450	244	44	200
B34R10C07	34-7-10	Hs~MGC:BC001681.1~uORF:IOH3766	188	58	130
B34R10C08	34-8-10	Hs~MGC:BC001681.1~uORF:IOH3766	58	46	12
B34R10C09	34-9-10	Hs~MGC:BC027475.1~uORF:IOH28681	202	46	156
B34R10C10	34-10-10	Hs~MGC:BC027475.1~uORF:IOH28681	156	46	110
B34R10C11	34-11-10	GST1	44	43	1
B34R10C12	34-12-10	GST1	41	41	0
B34R10C13	34-13-10	GST2	44	40	4
B34R10C14	34-14-10	GST2	51	43	8
B34R10C15	34-15-10	GST3	51	44	7
B34R10C16	34-16-10	GST3	42	45	-3
B34R10C17	34-17-10	GST4	52	44	8
B34R10C18	34-18-10	GST4	49	45	4
B34R10C19	34-19-10	Anti-HumanIgA1~N/A	8350	44	8306
B34R10C20	34-20-10	Anti-HumanIgA1~N/A	8004	47	7957
B34R10C21	34-21-10	Anti-HumanIgA2~N/A	15616	48	15568
B34R10C22	34-22-10	Anti-HumanIgA2~N/A	13687	45	13642
B34R11C01	34-1-11	AlexaAntiMouseAb~N/A	30086	67	30019
B34R11C02	34-2-11	AlexaAntiMouseAb~N/A	32190	58	32132
B34R11C03	34-3-11	MAPKAP~N/A	55	47	8
B34R11C04	34-4-11	MAPKAP~N/A	59	44	15
B34R11C05	34-5-11	Buffer	61	42	19
B34R11C06	34-6-11	Buffer	62	43	19
B34R11C07	34-7-11	BSA~N/A	8744	43	8701
B34R11C08	34-8-11	BSA~N/A	9162	42	9120
B34R11C09	34-9-11	Anti-HumanIgG1~N/A	1514	42	1472
B34R11C10	34-10-11	Anti-HumanIgG1~N/A	1528	43	1485
B34R11C11	34-11-11	Anti-HumanIgG2~N/A	2686	44	2642
B34R11C12	34-12-11	Anti-HumanIgG2~N/A	2729	42	2687
B34R11C13	34-13-11	Anti-HumanIgG3~N/A	5064	40	5024
B34R11C14	34-14-11	Anti-HumanIgG3~N/A	5328	41	5287
B34R11C15	34-15-11	Anti-HumanIgG4~N/A	9984	45	9939
B34R11C16	34-16-11	Anti-HumanIgG4~N/A	9695	44	9651
B34R11C17	34-17-11	AntiBiotinAb~N/A	9849	42	9807
B34R11C18	34-18-11	AntiBiotinAb~N/A	11053	43	11010
B34R11C19	34-19-11	Buffer	55	48	7
B34R11C20	34-20-11	Buffer	265	50	215
B34R11C21	34-21-11	Hs~MGC:BC051888.1~uORF:IOH27068	775	52	723
B34R11C22	34-22-11	Hs~MGC:BC051888.1~uORF:IOH27068	674	45	629
B34R12C01	34-1-12	Hs~MGC:BC012901.1~uORF:IOH10497	346	83	263
B34R12C02	34-2-12	Hs~MGC:BC012901.1~uORF:IOH10497	605	77	528
B34R12C03	34-3-12	Hs~MGC:NM_152646.2~uORF:IOH28001	942	56	886
B34R12C04	34-4-12	Hs~MGC:NM_152646.2~uORF:IOH28001	886	48	838
B34R12C05	34-5-12	Hs~MGC:BC001294.1~uORF:IOH3067	435	43	392
B34R12C06	34-6-12	Hs~MGC:BC001294.1~uORF:IOH3067	451	45	406
B34R12C07	34-7-12	Hs~Ref:NM_007067.3~uORF:IOH21942	117	48	69
B34R12C08	34-8-12	Hs~Ref:NM_007067.3~uORF:IOH21942	84	47	37
B34R12C09	34-9-12	Hs~MGC:BC008405.1~uORF:IOH7536	164	48	116
B34R12C10	34-10-12	Hs~MGC:BC008405.1~uORF:IOH7536	111	45	66
B34R12C11	34-11-12	Hs~Ref:NM_001021.2~uORF:IOH27847	96	69	27
B34R12C12	34-12-12	Hs~Ref:NM_001021.2~uORF:IOH27847	95	49	46
B34R12C13	34-13-12	Hs~Ref:NM_006899.2~uORF:IOH4853	505	113	392
B34R12C14	34-14-12	Hs~Ref:NM_006899.2~uORF:IOH4853	473	100	373
B34R12C15	34-15-12	Hs~MGC:BC098161.1~uORF:IOH63328	105	45	60
B34R12C16	34-16-12	Hs~MGC:BC098161.1~uORF:IOH63328	183	48	135
B34R12C17	34-17-12	Hs~MGC:BC098318.1~uORF:IOH63345	129	46	83
B34R12C18	34-18-12	Hs~MGC:BC098318.1~uORF:IOH63345	124	49	75
B34R12C19	34-19-12	Hs~MGC:BC098302.1~uORF:IOH63362	477	159	318
B34R12C20	34-20-12	Hs~MGC:BC098302.1~uORF:IOH63362	223	53	170
B34R12C21	34-21-12	Hs~MGC:BC099845.1~uORF:IOH63294	113	62	51
B34R12C22	34-22-12	Hs~MGC:BC099845.1~uORF:IOH63294	154	65	89
B34R13C01	34-1-13	Hs~Ref:NM_005259.1~uORF:IOH44374	2365	82	2283
B34R13C02	34-2-13	Hs~Ref:NM_005259.1~uORF:IOH44374	2657	70	2587
B34R13C03	34-3-13	Hs~Ref:XM_374803.1~uORF:IOH42807	600	54	546
B34R13C04	34-4-13	Hs~Ref:XM_374803.1~uORF:IOH42807	561	49	512
B34R13C05	34-5-13	Hs~Ref:NM_003994.4~uORF:IOH44526	414	48	366
B34R13C06	34-6-13	Hs~Ref:NM_003994.4~uORF:IOH44526	420	46	374
B34R13C07	34-7-13	Hs~Ref:NM_022749.4~uORF:IOH42659	354	51	303
B34R13C08	34-8-13	Hs~Ref:NM_022749.4~uORF:IOH42659	139	66	73
B34R13C09	34-9-13	Hs~MGC:BC012084.1~uORF:IOH13025	313	63	250
B34R13C10	34-10-13	Hs~MGC:BC012084.1~uORF:IOH13025	312	59	253
B34R13C11	34-11-13	Hs~Ref:NM_015068.1~uORF:IOH27074	271	45	226
B34R13C12	34-12-13	Hs~Ref:NM_015068.1~uORF:IOH27074	449	105	344
B34R13C13	34-13-13	Hs~MGC:BC036099.1~uORF:IOH27225	9951	57	9894
B34R13C14	34-14-13	Hs~MGC:BC036099.1~uORF:IOH27225	10161	53	10108
B34R13C15	34-15-13	Hs~MGC:BC060042.1~uORF:IOH29484	366	48	318
B34R13C16	34-16-13	Hs~MGC:BC060042.1~uORF:IOH29484	387	99	288
B34R13C17	34-17-13	Hs~MGC:BC009621.1~uORF:IOH9897	406	52	354
B34R13C18	34-18-13	Hs~MGC:BC009621.1~uORF:IOH9897	434	83	351
B34R13C19	34-19-13	Hs~MGC:BC033622.1~uORF:IOH21694	258	48	210
B34R13C20	34-20-13	Hs~MGC:BC033622.1~uORF:IOH21694	344	44	300
B34R13C21	34-21-13	Hs~Ref:NM_031445.1~uORF:IOH5185	382	49	333
B34R13C22	34-22-13	Hs~Ref:NM_031445.1~uORF:IOH5185	330	40	290
B34R14C01	34-1-14	Hs~MGC:NM_181671.1~uORF:IOH6747	203	60	143
B34R14C02	34-2-14	Hs~MGC:NM_181671.1~uORF:IOH6747	360	73	287
B34R14C03	34-3-14	Hs~Ref:NM_006744.3~uORF:IOH54761	724	45	679
B34R14C04	34-4-14	Hs~Ref:NM_006744.3~uORF:IOH54761	779	45	734
B34R14C05	34-5-14	Hs~Ref:NM_001387.2~uORF:IOH54070	411	47	364
B34R14C06	34-6-14	Hs~Ref:NM_001387.2~uORF:IOH54070	398	45	353
B34R14C07	34-7-14	Hs~Ref:NM_000391.2~uORF:IOH54067	141	48	93
B34R14C08	34-8-14	Hs~Ref:NM_000391.2~uORF:IOH54067	44	50	-6
B34R14C09	34-9-14	Hs~Ref:NM_054114.3~uORF:IOH52723	424	46	378
B34R14C10	34-10-14	Hs~Ref:NM_054114.3~uORF:IOH52723	393	46	347
B34R14C11	34-11-14	Hs~Ref:NM_014288.2~uORF:IOH13691	510	44	466
B34R14C12	34-12-14	Hs~Ref:NM_014288.2~uORF:IOH13691	474	42	432
B34R14C13	34-13-14	Hs~MGC:BC001172.1~uORF:IOH4467	146	43	103
B34R14C14	34-14-14	Hs~MGC:BC001172.1~uORF:IOH4467	180	43	137
B34R14C15	34-15-14	Hs~Ref:NM_022488.2~uORF:IOH13623	128	85	43
B34R14C16	34-16-14	Hs~Ref:NM_022488.2~uORF:IOH13623	108	47	61
B34R14C17	34-17-14	Hs~Ref:NM_001638.1~uORF:IOH14362	97	43	54
B34R14C18	34-18-14	Hs~Ref:NM_001638.1~uORF:IOH14362	95	43	52
B34R14C19	34-19-14	Hs~MGC:BC103974.1~uORF:IOH63586	394	44	350
B34R14C20	34-20-14	Hs~MGC:BC103974.1~uORF:IOH63586	368	44	324
B34R14C21	34-21-14	Hs~Ref:NM_005508.4~uORF:IOH60827	267	45	222
B34R14C22	34-22-14	Hs~Ref:NM_005508.4~uORF:IOH60827	268	43	225
B34R15C01	34-1-15	Hs~MGC:BC101461.1~uORF:IOH63596	356	52	304
B34R15C02	34-2-15	Hs~MGC:BC101461.1~uORF:IOH63596	500	50	450
B34R15C03	34-3-15	Hs~Ref:NM_033199.1~uORF:IOH10099	600	45	555
B34R15C04	34-4-15	Hs~Ref:NM_033199.1~uORF:IOH10099	603	44	559
B34R15C05	34-5-15	Hs~Ref:NM_003193.2~uORF:IOH3395	240	45	195
B34R15C06	34-6-15	Hs~Ref:NM_003193.2~uORF:IOH3395	201	45	156
B34R15C07	34-7-15	Hs~Ref:NM_006807.2~uORF:IOH4111	103	48	55
B34R15C08	34-8-15	Hs~Ref:NM_006807.2~uORF:IOH4111	90	45	45
B34R15C09	34-9-15	Hs~MGC:BC010125.1~uORF:IOH13046	588	43	545
B34R15C10	34-10-15	Hs~MGC:BC010125.1~uORF:IOH13046	560	45	515
B34R15C11	34-11-15	Hs~Ref:NM_003295.1~uORF:IOH25767	103	56	47
B34R15C12	34-12-15	Hs~Ref:NM_003295.1~uORF:IOH25767	63	44	19
B34R15C13	34-13-15	Hs~IVGN:PM_2141~Ext:Histone_F2a2~N/A	84	45	39
B34R15C14	34-14-15	Hs~IVGN:PM_2141~Ext:Histone_F2a2~N/A	70	46	24
B34R15C15	34-15-15	Hs~Ref:NM_006374.2~CAT:PV3657	548	45	503
B34R15C16	34-16-15	Hs~Ref:NM_006374.2~CAT:PV3657	469	46	423
B34R15C17	34-17-15	Hs~Ref:NM_006293.2~CAT:PV3828	167	44	123
B34R15C18	34-18-15	Hs~Ref:NM_006293.2~CAT:PV3828	242	44	198
B34R15C19	34-19-15	Hs~Ref:NM_001015878.1~CAT:PV3856	81	42	39
B34R15C20	34-20-15	Hs~Ref:NM_001015878.1~CAT:PV3856	125	46	79
B34R15C21	34-21-15	Hs~Ref:NM_002093.2~CAT:PV3365	518	40	478
B34R15C22	34-22-15	Hs~Ref:NM_002093.2~CAT:PV3365	501	39	462
B34R16C01	34-1-16	Hs~Ref:NM_005546.3~CAT:PV3875	261	49	212
B34R16C02	34-2-16	Hs~Ref:NM_005546.3~CAT:PV3875	1013	63	950
B34R16C03	34-3-16	Hs~Ref:NM_033439~CAT_PHC9255	345	46	299
B34R16C04	34-4-16	Hs~Ref:NM_033439~CAT_PHC9255	62	43	19
B34R16C05	34-5-16	Hs~Ref:NP_005408~CAT:P3044	173	61	112
B34R16C06	34-6-16	Hs~Ref:NP_005408~CAT:P3044	236	51	185
B34R16C07	34-7-16	Hs~Ref:NM_153330.2~uORF:IOH22558	666	43	623
B34R16C08	34-8-16	Hs~Ref:NM_153330.2~uORF:IOH22558	547	44	503
B34R16C09	34-9-16	Hs~MGC:BC001028.1~uORF:IOH4227	124	43	81
B34R16C10	34-10-16	Hs~MGC:BC001028.1~uORF:IOH4227	181	60	121
B34R16C11	34-11-16	Hs~Ref:NM_012425.2~uORF:IOH3398	107	49	58
B34R16C12	34-12-16	Hs~Ref:NM_012425.2~uORF:IOH3398	94	49	45
B34R16C13	34-13-16	Hs~Ref:NM_004078.1~uORF:IOH1778	4471	52	4419
B34R16C14	34-14-16	Hs~Ref:NM_004078.1~uORF:IOH1778	4328	50	4278
B34R16C15	34-15-16	Hs~Ref:NM_001498.2~uORF:IOH26166	522	46	476
B34R16C16	34-16-16	Hs~Ref:NM_001498.2~uORF:IOH26166	476	45	431
B34R16C17	34-17-16	Hs~Ref:NM_002990.3~uORF:IOH50179	187	51	136
B34R16C18	34-18-16	Hs~Ref:NM_002990.3~uORF:IOH50179	535	46	489
B34R16C19	34-19-16	Hs~Ref:NM_022912.1~uORF:IOH40034	523	43	480
B34R16C20	34-20-16	Hs~Ref:NM_022912.1~uORF:IOH40034	491	45	446
B34R16C21	34-21-16	Hs~Ref:NM_001008535.1~uORF:IOH50159	128	66	62
B34R16C22	34-22-16	Hs~Ref:NM_001008535.1~uORF:IOH50159	89	43	46
B34R17C01	34-1-17	Hs~MGC:BC014888.1~uORF:IOH10012	242	65	177
B34R17C02	34-2-17	Hs~MGC:BC014888.1~uORF:IOH10012	89	66	23
B34R17C03	34-3-17	Hs~MGC:BC007289.1~uORF:IOH6909	107	52	55
B34R17C04	34-4-17	Hs~MGC:BC007289.1~uORF:IOH6909	209	49	160
B34R17C05	34-5-17	Hs~MGC:BC015047.1~uORF:IOH10054	129	48	81
B34R17C06	34-6-17	Hs~MGC:BC015047.1~uORF:IOH10054	177	47	130
B34R17C07	34-7-17	Hs~MGC:BC016854.1~uORF:IOH10430	179	44	135
B34R17C08	34-8-17	Hs~MGC:BC016854.1~uORF:IOH10430	187	82	105
B34R17C09	34-9-17	Hs~Ref:NM_031273.1~uORF:IOH35487	223	51	172
B34R17C10	34-10-17	Hs~Ref:NM_031273.1~uORF:IOH35487	279	113	166
B34R17C11	34-11-17	Hs~Ref:NM_152615.1~uORF:IOH35770	136	84	52
B34R17C12	34-12-17	Hs~Ref:NM_152615.1~uORF:IOH35770	101	48	53
B34R17C13	34-13-17	Hs~Ref:NM_144670.1~uORF:IOH35128	122	51	71
B34R17C14	34-14-17	Hs~Ref:NM_144670.1~uORF:IOH35128	110	43	67
B34R17C15	34-15-17	Hs~Ref:NM_002407.1~uORF:IOH40725	110	45	65
B34R17C16	34-16-17	Hs~Ref:NM_002407.1~uORF:IOH40725	115	45	70
B34R17C17	34-17-17	Hs~MGC:BC052602.1~uORF:IOH29373	122	73	49
B34R17C18	34-18-17	Hs~MGC:BC052602.1~uORF:IOH29373	101	43	58
B34R17C19	34-19-17	Hs~Ref:NM_194270.1~uORF:IOH43471	262	46	216
B34R17C20	34-20-17	Hs~Ref:NM_194270.1~uORF:IOH43471	267	47	220
B34R17C21	34-21-17	Hs~Ref:NM_004895.3~uORF:IOH43835	529	42	487
B34R17C22	34-22-17	Hs~Ref:NM_004895.3~uORF:IOH43835	514	39	475
B34R18C01	34-1-18	Hs~Ref:XM_378757.1~uORF:IOH43929	721	144	577
B34R18C02	34-2-18	Hs~Ref:XM_378757.1~uORF:IOH43929	505	48	457
B34R18C03	34-3-18	Hs~MGC:BC058823.1~uORF:IOH29422	144	63	81
B34R18C04	34-4-18	Hs~MGC:BC058823.1~uORF:IOH29422	156	68	88
B34R18C05	34-5-18	Hs~MGC:NM_173195.2~uORF:IOH29635	71	48	23
B34R18C06	34-6-18	Hs~MGC:NM_173195.2~uORF:IOH29635	65	47	18
B34R18C07	34-7-18	Hs~MGC:BC040630.1~uORF:IOH28784	147	45	102
B34R18C08	34-8-18	Hs~MGC:BC040630.1~uORF:IOH28784	153	43	110
B34R18C09	34-9-18	Hs~MGC:BC053998.1~uORF:IOH28976	309	49	260
B34R18C10	34-10-18	Hs~MGC:BC053998.1~uORF:IOH28976	987	226	761
B34R18C11	34-11-18	Hs~MGC:BC070047.1~uORF:IOH61704	111	49	62
B34R18C12	34-12-18	Hs~MGC:BC070047.1~uORF:IOH61704	323	51	272
B34R18C13	34-13-18	Hs~MGC:BC078147.1~uORF:IOH61810	387	47	340
B34R18C14	34-14-18	Hs~MGC:BC078147.1~uORF:IOH61810	353	44	309
B34R18C15	34-15-18	Hs~MGC:BC036636.2~uORF:IOH61621	412	45	367
B34R18C16	34-16-18	Hs~MGC:BC036636.2~uORF:IOH61621	265	46	219
B34R18C17	34-17-18	Hs~MGC:BC095453.1~uORF:IOH63185	495	44	451
B34R18C18	34-18-18	Hs~MGC:BC095453.1~uORF:IOH63185	486	41	445
B34R18C19	34-19-18	Hs~MGC:BC069432.1~uORF:IOH61876	492	39	453
B34R18C20	34-20-18	Hs~MGC:BC069432.1~uORF:IOH61876	539	40	499
B34R18C21	34-21-18	Hs~MGC:BC074956.2~uORF:IOH61932	396	42	354
B34R18C22	34-22-18	Hs~MGC:BC074956.2~uORF:IOH61932	335	40	295
B34R19C01	34-1-19	Hs~MGC:BC022538.1~uORF:IOH62047	179	71	108
B34R19C02	34-2-19	Hs~MGC:BC022538.1~uORF:IOH62047	64	51	13
B34R19C03	34-3-19	Hs~Ref:NM_182638.1~uORF:IOH59668	194	90	104
B34R19C04	34-4-19	Hs~Ref:NM_182638.1~uORF:IOH59668	158	75	83
B34R19C05	34-5-19	Hs~MGC:BC051843.1~uORF:IOH27014	116	62	54
B34R19C06	34-6-19	Hs~MGC:BC051843.1~uORF:IOH27014	82	53	29
B34R19C07	34-7-19	Hs~MGC:BC002645.1~uORF:IOH5243	66	51	15
B34R19C08	34-8-19	Hs~MGC:BC002645.1~uORF:IOH5243	133	47	86
B34R19C09	34-9-19	Hs~MGC:BC002897.1~uORF:IOH5695	190	47	143
B34R19C10	34-10-19	Hs~MGC:BC002897.1~uORF:IOH5695	137	48	89
B34R19C11	34-11-19	Hs~Ref:NM_030575.1~uORF:IOH5605	365	55	310
B34R19C12	34-12-19	Hs~Ref:NM_030575.1~uORF:IOH5605	424	49	375
B34R19C13	34-13-19	Hs~Ref:NM_000476.1~uORF:IOH53853	67	45	22
B34R19C14	34-14-19	Hs~Ref:NM_000476.1~uORF:IOH53853	163	55	108
B34R19C15	34-15-19	Hs~Ref:NM_181467.1~uORF:IOH58611	99	46	53
B34R19C16	34-16-19	Hs~Ref:NM_181467.1~uORF:IOH58611	79	47	32
B34R19C17	34-17-19	Hs~MGC:BC002869.2~uORF:IOH5705	382	60	322
B34R19C18	34-18-19	Hs~MGC:BC002869.2~uORF:IOH5705	339	47	292
B34R19C19	34-19-19	Hs~MGC:BC032954.2~uORF:IOH22415	380	40	340
B34R19C20	34-20-19	Hs~MGC:BC032954.2~uORF:IOH22415	421	43	378
B34R19C21	34-21-19	Hs~MGC:BC002493.1~uORF:IOH3967	360	44	316
B34R19C22	34-22-19	Hs~MGC:BC002493.1~uORF:IOH3967	372	43	329
B34R20C01	34-1-20	Hs~Ref:NM_024051.1~uORF:IOH4274	168	76	92
B34R20C02	34-2-20	Hs~Ref:NM_024051.1~uORF:IOH4274	216	113	103
B34R20C03	34-3-20	Hs~Ref:NM_014221.1~uORF:IOH4127	215	51	164
B34R20C04	34-4-20	Hs~Ref:NM_014221.1~uORF:IOH4127	215	50	165
B34R20C05	34-5-20	Hs~MGC:BC002616.1~uORF:IOH4117	288	54	234
B34R20C06	34-6-20	Hs~MGC:BC002616.1~uORF:IOH4117	260	58	202
B34R20C07	34-7-20	Hs~Ref:NM_001009584.1~uORF:IOH40585	569	47	522
B34R20C08	34-8-20	Hs~Ref:NM_001009584.1~uORF:IOH40585	540	45	495
B34R20C09	34-9-20	Hs~Ref:NM_017866.3~uORF:IOH40588	591	43	548
B34R20C10	34-10-20	Hs~Ref:NM_017866.3~uORF:IOH40588	627	45	582
B34R20C11	34-11-20	Hs~Ref:NM_004123.1~uORF:IOH40365	384	50	334
B34R20C12	34-12-20	Hs~Ref:NM_004123.1~uORF:IOH40365	368	47	321
B34R20C13	34-13-20	Hs~Ref:NM_006428.3~uORF:IOH40570	2239	43	2196
B34R20C14	34-14-20	Hs~Ref:NM_006428.3~uORF:IOH40570	2105	42	2063
B34R20C15	34-15-20	Hs~Ref:NM_006880.2~uORF:IOH50109	479	43	436
B34R20C16	34-16-20	Hs~Ref:NM_006880.2~uORF:IOH50109	543	47	496
B34R20C17	34-17-20	Hs~Ref:NM_207286.1~uORF:IOH50103	2342	45	2297
B34R20C18	34-18-20	Hs~Ref:NM_207286.1~uORF:IOH50103	2269	41	2228
B34R20C19	34-19-20	Hs~Ref:NM_001001870.1~uORF:IOH50090	1013	39	974
B34R20C20	34-20-20	Hs~Ref:NM_001001870.1~uORF:IOH50090	972	41	931
B34R20C21	34-21-20	Hs~Ref:NM_175620.1~uORF:IOH50081	529	42	487
B34R20C22	34-22-20	Hs~Ref:NM_175620.1~uORF:IOH50081	495	39	456
B34R21C01	34-1-21	Hs~Ref:NM_058202.1~uORF:IOH50141	764	46	718
B34R21C02	34-2-21	Hs~Ref:NM_058202.1~uORF:IOH50141	714	48	666
B34R21C03	34-3-21	Hs~Ref:NM_005988.2~uORF:IOH50118	679	49	630
B34R21C04	34-4-21	Hs~Ref:NM_005988.2~uORF:IOH50118	686	47	639
B34R21C05	34-5-21	Hs~Ref:NM_001548.2~uORF:IOH50068	728	45	683
B34R21C06	34-6-21	Hs~Ref:NM_001548.2~uORF:IOH50068	736	44	692
B34R21C07	34-7-21	Hs~Ref:NM_001005521.1~uORF:IOH50121	664	43	621
B34R21C08	34-8-21	Hs~Ref:NM_001005521.1~uORF:IOH50121	631	42	589
B34R21C09	34-9-21	Hs~Ref:NP_001234.2~CAT_10777-H08H-25	42	42	0
B34R21C10	34-10-21	Hs~Ref:NP_001234.2~CAT_10777-H08H-25	42	42	0
B34R21C11	34-11-21	Internal_1007209	52	44	8
B34R21C12	34-12-21	Internal_1007209	47	41	6
B34R21C13	34-13-21	Hs~Ref:NP_004419.2~CAT_10882-H08H-25	44	39	5
B34R21C14	34-14-21	Hs~Ref:NP_004419.2~CAT_10882-H08H-25	40	38	2
B34R21C15	34-15-21	Internal_1007209	46	40	6
B34R21C16	34-16-21	Internal_1007209	44	41	3
B34R21C17	34-17-21	Hs~Ref:P01040~CAT_10479-H07E-25	36	37	-1
B34R21C18	34-18-21	Hs~Ref:P01040~CAT_10479-H07E-25	36	36	0
B34R21C19	34-19-21	Internal_1007209	39	37	2
B34R21C20	34-20-21	Internal_1007209	41	39	2
B34R21C21	34-21-21	Internal_1007209	40	38	2
B34R21C22	34-22-21	Internal_1007209	40	37	3
B34R22C01	34-1-22	ERa~N/A	2218	45	2173
B34R22C02	34-2-22	ERa~N/A	2090	46	2044
B34R22C03	34-3-22	PKCeta~N/A	293	47	246
B34R22C04	34-4-22	PKCeta~N/A	274	50	224
B34R22C05	34-5-22	Calmodulin~N/A	96	49	47
B34R22C06	34-6-22	Calmodulin~N/A	65	43	22
B34R22C07	34-7-22	V5control5~N/A	212	43	169
B34R22C08	34-8-22	V5control5~N/A	258	48	210
B34R22C09	34-9-22	V5control4~N/A	194	46	148
B34R22C10	34-10-22	V5control4~N/A	183	47	136
B34R22C11	34-11-22	V5control3~N/A	95	56	39
B34R22C12	34-12-22	V5control3~N/A	90	45	45
B34R22C13	34-13-22	V5control2~N/A	104	58	46
B34R22C14	34-14-22	V5control2~N/A	53	47	6
B34R22C15	34-15-22	V5control1~N/A	78	43	35
B34R22C16	34-16-22	V5control1~N/A	55	47	8
B34R22C17	34-17-22	CMK2A~N/A	299	71	228
B34R22C18	34-18-22	CMK2A~N/A	285	38	247
B34R22C19	34-19-22	ERa~N/A	2050	38	2012
B34R22C20	34-20-22	ERa~N/A	2179	41	2138
B34R22C21	34-21-22	AlexaAntiMouseAb~N/A	10779	40	10739
B34R22C22	34-22-22	AlexaAntiMouseAb~N/A	10521	38	10483
B35R01C01	35-1-1	AlexaAntiMouseAb~N/A	31156	39	31117
B35R01C02	35-2-1	AlexaAntiMouseAb~N/A	35662	41	35621
B35R01C03	35-3-1	ERa~N/A	1627	40	1587
B35R01C04	35-4-1	ERa~N/A	1768	39	1729
B35R01C05	35-5-1	HumanIgG1~N/A	1290	39	1251
B35R01C06	35-6-1	HumanIgG1~N/A	1260	39	1221
B35R01C07	35-7-1	HumanIgG2~N/A	3004	40	2964
B35R01C08	35-8-1	HumanIgG2~N/A	2871	40	2831
B35R01C09	35-9-1	HumanIgG3~N/A	13568	42	13526
B35R01C10	35-10-1	HumanIgG3~N/A	13821	43	13778
B35R01C11	35-11-1	HumanIgG4~N/A	40470	43	40427
B35R01C12	35-12-1	HumanIgG4~N/A	41046	45	41001
B35R01C13	35-13-1	BiotinAb~N/A	287	42	245
B35R01C14	35-14-1	BiotinAb~N/A	311	40	271
B35R01C15	35-15-1	RanBP2deltaFG~N/A	364	39	325
B35R01C16	35-16-1	RanBP2deltaFG~N/A	362	39	323
B35R01C17	35-17-1	hMDM2~N/A	787	39	748
B35R01C18	35-18-1	hMDM2~N/A	810	41	769
B35R01C19	35-19-1	PKCeta~N/A	584	41	543
B35R01C20	35-20-1	PKCeta~N/A	617	41	576
B35R01C21	35-21-1	AlexaAntiMouseAb~N/A	36373	42	36331
B35R01C22	35-22-1	AlexaAntiMouseAb~N/A	32251	43	32208
B35R02C01	35-1-2	PKCeta~N/A	1714	39	1675
B35R02C02	35-2-2	PKCeta~N/A	1777	40	1737
B35R02C03	35-3-2	Buffer	490	39	451
B35R02C04	35-4-2	Buffer	471	39	432
B35R02C05	35-5-2	HumanIgA~N/A	20075	40	20035
B35R02C06	35-6-2	HumanIgA~N/A	18934	41	18893
B35R02C07	35-7-2	Buffer	146	43	103
B35R02C08	35-8-2	Buffer	236	78	158
B35R02C09	35-9-2	BSA~N/A	11832	42	11790
B35R02C10	35-10-2	BSA~N/A	11184	42	11142
B35R02C11	35-11-2	Hs~MGC:BC001454.1~uORF:IOH3989	451	43	408
B35R02C12	35-12-2	Hs~MGC:BC001454.1~uORF:IOH3989	460	44	416
B35R02C13	35-13-2	Hs~Ref:NM_005028.3~uORF:IOH11029	434	46	388
B35R02C14	35-14-2	Hs~Ref:NM_005028.3~uORF:IOH11029	426	43	383
B35R02C15	35-15-2	Hs~Ref:NM_021643.1~uORF:IOH21149	453	41	412
B35R02C16	35-16-2	Hs~Ref:NM_021643.1~uORF:IOH21149	466	42	424
B35R02C17	35-17-2	Hs~Ref:NM_024594.1~uORF:IOH10705	408	41	367
B35R02C18	35-18-2	Hs~Ref:NM_024594.1~uORF:IOH10705	475	43	432
B35R02C19	35-19-2	Hs~Ref:NM_030663.1~uORF:IOH11124	496	46	450
B35R02C20	35-20-2	Hs~Ref:NM_030663.1~uORF:IOH11124	483	51	432
B35R02C21	35-21-2	Hs~MGC:BC022004.2~uORF:IOH11222	395	47	348
B35R02C22	35-22-2	Hs~MGC:BC022004.2~uORF:IOH11222	399	45	354
B35R03C01	35-1-3	Hs~Ref:NM_000559.1~uORF:IOH13643	379	39	340
B35R03C02	35-2-3	Hs~Ref:NM_000559.1~uORF:IOH13643	363	41	322
B35R03C03	35-3-3	Hs~MGC:BC028672.1~uORF:IOH14574	41	40	1
B35R03C04	35-4-3	Hs~MGC:BC028672.1~uORF:IOH14574	38	39	-1
B35R03C05	35-5-3	Hs~MGC:BC009564.1~uORF:IOH9952	1177	42	1135
B35R03C06	35-6-3	Hs~MGC:BC009564.1~uORF:IOH9952	1113	45	1068
B35R03C07	35-7-3	Hs~Ref:NM_001613.1~uORF:IOH9991	433	62	371
B35R03C08	35-8-3	Hs~Ref:NM_001613.1~uORF:IOH9991	338	90	248
B35R03C09	35-9-3	Hs~Ref:NM_003345.1~uORF:IOH5997	441	45	396
B35R03C10	35-10-3	Hs~Ref:NM_003345.1~uORF:IOH5997	413	44	369
B35R03C11	35-11-3	Hs~Ref:NM_002614.2~uORF:IOH5807	521	42	479
B35R03C12	35-12-3	Hs~Ref:NM_002614.2~uORF:IOH5807	540	43	497
B35R03C13	35-13-3	Hs~MGC:BC046208.1~uORF:IOH26975	585	48	537
B35R03C14	35-14-3	Hs~MGC:BC046208.1~uORF:IOH26975	571	48	523
B35R03C15	35-15-3	Hs~MGC:NM_182556.1~uORF:IOH25901	93	64	29
B35R03C16	35-16-3	Hs~MGC:NM_182556.1~uORF:IOH25901	77	42	35
B35R03C17	35-17-3	Hs~MGC:BC050439.1~uORF:IOH26673	89	41	48
B35R03C18	35-18-3	Hs~MGC:BC050439.1~uORF:IOH26673	84	42	42
B35R03C19	35-19-3	Hs~MGC:BC045783.1~uORF:IOH26422	107	40	67
B35R03C20	35-20-3	Hs~MGC:BC045783.1~uORF:IOH26422	98	43	55
B35R03C21	35-21-3	Hs~MGC:BC008407.1~uORF:IOH7438	912	46	866
B35R03C22	35-22-3	Hs~MGC:BC008407.1~uORF:IOH7438	870	43	827
B35R04C01	35-1-4	Hs~Ref:NM_138793.1~uORF:IOH9933	869	41	828
B35R04C02	35-2-4	Hs~Ref:NM_138793.1~uORF:IOH9933	855	45	810
B35R04C03	35-3-4	Hs~MGC:BC005823.1~uORF:IOH5772	717	45	672
B35R04C04	35-4-4	Hs~MGC:BC005823.1~uORF:IOH5772	734	43	691
B35R04C05	35-5-4	Hs~MGC:BC005902.1~uORF:IOH7553	675	45	630
B35R04C06	35-6-4	Hs~MGC:BC005902.1~uORF:IOH7553	661	49	612
B35R04C07	35-7-4	Hs~MGC:BC022571.1~uORF:IOH22219	5933	68	5865
B35R04C08	35-8-4	Hs~MGC:BC022571.1~uORF:IOH22219	5570	84	5486
B35R04C09	35-9-4	Hs~Ref:NM_012388.1~uORF:IOH3029	529	132	397
B35R04C10	35-10-4	Hs~Ref:NM_012388.1~uORF:IOH3029	283	54	229
B35R04C11	35-11-4	Hs~MGC:BC030828.1~uORF:IOH22214	410	46	364
B35R04C12	35-12-4	Hs~MGC:BC030828.1~uORF:IOH22214	404	45	359
B35R04C13	35-13-4	Hs~MGC:BC034052.1~uORF:IOH22224	587	46	541
B35R04C14	35-14-4	Hs~MGC:BC034052.1~uORF:IOH22224	538	47	491
B35R04C15	35-15-4	Hs~Ref:NM_000709.2~uORF:IOH6690	374	45	329
B35R04C16	35-16-4	Hs~Ref:NM_000709.2~uORF:IOH6690	358	45	313
B35R04C17	35-17-4	Hs~MGC:NM_173809.2~uORF:IOH9955	448	44	404
B35R04C18	35-18-4	Hs~MGC:NM_173809.2~uORF:IOH9955	414	43	371
B35R04C19	35-19-4	Hs~MGC:BC003106.1~uORF:IOH4523	234	49	185
B35R04C20	35-20-4	Hs~MGC:BC003106.1~uORF:IOH4523	241	43	198
B35R04C21	35-21-4	Hs~Ref:NM_000626.1~uORF:IOH21963	302	48	254
B35R04C22	35-22-4	Hs~Ref:NM_000626.1~uORF:IOH21963	263	44	219
B35R05C01	35-1-5	Hs~Ref:NM_145702.1~uORF:IOH40861	634	68	566
B35R05C02	35-2-5	Hs~Ref:NM_145702.1~uORF:IOH40861	804	86	718
B35R05C03	35-3-5	Hs~MGC:BC010919.1~uORF:IOH27800	696	58	638
B35R05C04	35-4-5	Hs~MGC:BC010919.1~uORF:IOH27800	1548	178	1370
B35R05C05	35-5-5	Hs~Ref:NM_006699.3~uORF:IOH39822	1362	87	1275
B35R05C06	35-6-5	Hs~Ref:NM_006699.3~uORF:IOH39822	1704	57	1647
B35R05C07	35-7-5	Hs~Ref:NM_002815.2~uORF:IOH3459	1596	88	1508
B35R05C08	35-8-5	Hs~Ref:NM_002815.2~uORF:IOH3459	2042	773	1269
B35R05C09	35-9-5	Hs~Ref:NM_079422.1~uORF:IOH7150	1538	228	1310
B35R05C10	35-10-5	Hs~Ref:NM_079422.1~uORF:IOH7150	1772	126	1646
B35R05C11	35-11-5	Hs~MGC:BC006199.1~uORF:IOH5745	1834	111	1723
B35R05C12	35-12-5	Hs~MGC:BC006199.1~uORF:IOH5745	2267	75	2192
B35R05C13	35-13-5	Hs~Ref:NM_005716.1~uORF:IOH3617	814	53	761
B35R05C14	35-14-5	Hs~Ref:NM_005716.1~uORF:IOH3617	772	53	719
B35R05C15	35-15-5	Hs~MGC:BC013155.1~uORF:IOH9761	721	50	671
B35R05C16	35-16-5	Hs~MGC:BC013155.1~uORF:IOH9761	685	49	636
B35R05C17	35-17-5	Hs~MGC:NM_178509.3~uORF:IOH26305	142	43	99
B35R05C18	35-18-5	Hs~MGC:NM_178509.3~uORF:IOH26305	140	42	98
B35R05C19	35-19-5	Hs~MGC:BC047333.1~uORF:IOH26567	467	210	257
B35R05C20	35-20-5	Hs~MGC:BC047333.1~uORF:IOH26567	262	43	219
B35R05C21	35-21-5	Hs~MGC:BC044239.1~uORF:IOH26369	268	44	224
B35R05C22	35-22-5	Hs~MGC:BC044239.1~uORF:IOH26369	238	44	194
B35R06C01	35-1-6	Hs~MGC:BC039832.1~uORF:IOH26274	598	49	549
B35R06C02	35-2-6	Hs~MGC:BC039832.1~uORF:IOH26274	746	205	541
B35R06C03	35-3-6	Hs~Ref:NM_014046.2~uORF:IOH1899	407	140	267
B35R06C04	35-4-6	Hs~Ref:NM_014046.2~uORF:IOH1899	64	56	8
B35R06C05	35-5-6	Hs~Ref:NM_006118.2~uORF:IOH1939	223	50	173
B35R06C06	35-6-6	Hs~Ref:NM_006118.2~uORF:IOH1939	170	48	122
B35R06C07	35-7-6	Hs~MGC:NM_006857.1~uORF:IOH13197	366	50	316
B35R06C08	35-8-6	Hs~MGC:NM_006857.1~uORF:IOH13197	185	84	101
B35R06C09	35-9-6	Hs~Ref:NM_133480.1~uORF:IOH13139	1955	88	1867
B35R06C10	35-10-6	Hs~Ref:NM_133480.1~uORF:IOH13139	1774	74	1700
B35R06C11	35-11-6	Hs~Ref:NM_033069.1~uORF:IOH39981	77	60	17
B35R06C12	35-12-6	Hs~Ref:NM_033069.1~uORF:IOH39981	292	73	219
B35R06C13	35-13-6	Hs~Ref:NM_002822.3~uORF:IOH40883	12642	61	12581
B35R06C14	35-14-6	Hs~Ref:NM_002822.3~uORF:IOH40883	11683	65	11618
B35R06C15	35-15-6	Hs~Ref:NM_030636.1~uORF:IOH39935	1547	70	1477
B35R06C16	35-16-6	Hs~Ref:NM_030636.1~uORF:IOH39935	1388	75	1313
B35R06C17	35-17-6	Hs~Ref:NM_138959.1~uORF:IOH39982	1615	204	1411
B35R06C18	35-18-6	Hs~Ref:NM_138959.1~uORF:IOH39982	299	51	248
B35R06C19	35-19-6	Hs~Ref:NM_022101.1~uORF:IOH27781	2079	52	2027
B35R06C20	35-20-6	Hs~Ref:NM_022101.1~uORF:IOH27781	1880	49	1831
B35R06C21	35-21-6	Hs~MGC:BC040214.1~uORF:IOH27456	905	59	846
B35R06C22	35-22-6	Hs~MGC:BC040214.1~uORF:IOH27456	2317	65	2252
B35R07C01	35-1-7	Hs~MGC:BC010368.1~uORF:IOH27803	243	67	176
B35R07C02	35-2-7	Hs~MGC:BC010368.1~uORF:IOH27803	233	69	164
B35R07C03	35-3-7	Hs~MGC:BC012566.1~uORF:IOH27796	440	84	356
B35R07C04	35-4-7	Hs~MGC:BC012566.1~uORF:IOH27796	303	53	250
B35R07C05	35-5-7	Hs~MGC:BC003356.1~uORF:IOH2875	326	51	275
B35R07C06	35-6-7	Hs~MGC:BC003356.1~uORF:IOH2875	312	50	262
B35R07C07	35-7-7	Hs~MGC:BC000166.2~uORF:IOH2928	1389	49	1340
B35R07C08	35-8-7	Hs~MGC:BC000166.2~uORF:IOH2928	1295	52	1243
B35R07C09	35-9-7	Hs~Ref:NM_016303.1~uORF:IOH27824	2176	48	2128
B35R07C10	35-10-7	Hs~Ref:NM_016303.1~uORF:IOH27824	2092	46	2046
B35R07C11	35-11-7	Hs~MGC:BC003403.1~uORF:IOH3013	198	50	148
B35R07C12	35-12-7	Hs~MGC:BC003403.1~uORF:IOH3013	212	51	161
B35R07C13	35-13-7	Hs~Ref:NM_057749.1~uORF:IOH43526	1005	227	778
B35R07C14	35-14-7	Hs~Ref:NM_057749.1~uORF:IOH43526	907	449	458
B35R07C15	35-15-7	Hs~Ref:NM_006756.2~uORF:IOH42106	1749	61	1688
B35R07C16	35-16-7	Hs~Ref:NM_006756.2~uORF:IOH42106	1730	61	1669
B35R07C17	35-17-7	Hs~Ref:XM_114355.2~uORF:IOH44495	481	82	399
B35R07C18	35-18-7	Hs~Ref:XM_114355.2~uORF:IOH44495	448	50	398
B35R07C19	35-19-7	Hs~Ref:XM_374281.1~uORF:IOH43528	472	49	423
B35R07C20	35-20-7	Hs~Ref:XM_374281.1~uORF:IOH43528	511	50	461
B35R07C21	35-21-7	Hs~Ref:NM_003315.1~uORF:IOH14566	629	56	573
B35R07C22	35-22-7	Hs~Ref:NM_003315.1~uORF:IOH14566	707	104	603
B35R08C01	35-1-8	Hs~Ref:NM_052845.1~uORF:IOH13544	668	49	619
B35R08C02	35-2-8	Hs~Ref:NM_052845.1~uORF:IOH13544	643	60	583
B35R08C03	35-3-8	Hs~MGC:BC018667.1~uORF:IOH14819	742	73	669
B35R08C04	35-4-8	Hs~MGC:BC018667.1~uORF:IOH14819	665	141	524
B35R08C05	35-5-8	Hs~MGC:BC021253.2~uORF:IOH14624	202	104	98
B35R08C06	35-6-8	Hs~MGC:BC021253.2~uORF:IOH14624	318	243	75
B35R08C07	35-7-8	Hs~Ref:NM_031436.1~uORF:IOH5698	188	68	120
B35R08C08	35-8-8	Hs~Ref:NM_031436.1~uORF:IOH5698	412	265	147
B35R08C09	35-9-8	Hs~Ref:NM_020299.2~uORF:IOH6697	227	51	176
B35R08C10	35-10-8	Hs~Ref:NM_020299.2~uORF:IOH6697	223	48	175
B35R08C11	35-11-8	Hs~Ref:NM_003130.1~uORF:IOH13042	1376	135	1241
B35R08C12	35-12-8	Hs~Ref:NM_003130.1~uORF:IOH13042	1067	62	1005
B35R08C13	35-13-8	Hs~MGC:BC022305.1~uORF:IOH14446	299	55	244
B35R08C14	35-14-8	Hs~MGC:BC022305.1~uORF:IOH14446	514	128	386
B35R08C15	35-15-8	Hs~MGC:BC005253.1~uORF:IOH7296	352	46	306
B35R08C16	35-16-8	Hs~MGC:BC005253.1~uORF:IOH7296	386	46	340
B35R08C17	35-17-8	Hs~Ref:NM_000318.1~uORF:IOH7247	505	133	372
B35R08C18	35-18-8	Hs~Ref:NM_000318.1~uORF:IOH7247	250	49	201
B35R08C19	35-19-8	Hs~Ref:NM_003495.2~uORF:IOH12149	135	47	88
B35R08C20	35-20-8	Hs~Ref:NM_003495.2~uORF:IOH12149	150	47	103
B35R08C21	35-21-8	Hs~MGC:BC017770.1~uORF:IOH14871	521	54	467
B35R08C22	35-22-8	Hs~MGC:BC017770.1~uORF:IOH14871	554	55	499
B35R09C01	35-1-9	Hs~Ref:NM_153007.3~uORF:IOH35383	323	46	277
B35R09C02	35-2-9	Hs~Ref:NM_153007.3~uORF:IOH35383	271	57	214
B35R09C03	35-3-9	Hs~MGC:BC059174.1~uORF:IOH28851	2393	70	2323
B35R09C04	35-4-9	Hs~MGC:BC059174.1~uORF:IOH28851	2061	64	1997
B35R09C05	35-5-9	Hs~Ref:NM_175735.3~uORF:IOH35282	506	92	414
B35R09C06	35-6-9	Hs~Ref:NM_175735.3~uORF:IOH35282	315	119	196
B35R09C07	35-7-9	Hs~Ref:NM_005208.3~uORF:IOH35287	364	115	249
B35R09C08	35-8-9	Hs~Ref:NM_005208.3~uORF:IOH35287	180	171	9
B35R09C09	35-9-9	Hs~MGC:BC005395.1~uORF:IOH7260	194	125	69
B35R09C10	35-10-9	Hs~MGC:BC005395.1~uORF:IOH7260	292	63	229
B35R09C11	35-11-9	Hs~Ref:NM_004507.1~uORF:IOH7302	166	54	112
B35R09C12	35-12-9	Hs~Ref:NM_004507.1~uORF:IOH7302	141	58	83
B35R09C13	35-13-9	Hs~Ref:NM_016464.1~uORF:IOH7268	275	55	220
B35R09C14	35-14-9	Hs~Ref:NM_016464.1~uORF:IOH7268	224	62	162
B35R09C15	35-15-9	Hs~MGC:BC005248.1~uORF:IOH7358	411	51	360
B35R09C16	35-16-9	Hs~MGC:BC005248.1~uORF:IOH7358	335	51	284
B35R09C17	35-17-9	Hs~MGC:BC002827.1~uORF:IOH5413	741	56	685
B35R09C18	35-18-9	Hs~MGC:BC002827.1~uORF:IOH5413	663	60	603
B35R09C19	35-19-9	Hs~MGC:BC002863.2~uORF:IOH5708	356	55	301
B35R09C20	35-20-9	Hs~MGC:BC002863.2~uORF:IOH5708	318	54	264
B35R09C21	35-21-9	Hs~Ref:NM_003085.2~uORF:IOH5707	494	67	427
B35R09C22	35-22-9	Hs~Ref:NM_003085.2~uORF:IOH5707	92	184	-92
B35R10C01	35-1-10	Hs~MGC:BC004341.1~uORF:IOH5560	184	49	135
B35R10C02	35-2-10	Hs~MGC:BC004341.1~uORF:IOH5560	143	50	93
B35R10C03	35-3-10	Hs~MGC:BC001497.2~uORF:IOH12354	990	352	638
B35R10C04	35-4-10	Hs~MGC:BC001497.2~uORF:IOH12354	899	50	849
B35R10C05	35-5-10	Hs~Ref:NM_016069.8~uORF:IOH6645	691	187	504
B35R10C06	35-6-10	Hs~Ref:NM_016069.8~uORF:IOH6645	599	296	303
B35R10C07	35-7-10	Hs~MGC:BC007847.2~uORF:IOH6718	984	46	938
B35R10C08	35-8-10	Hs~MGC:BC007847.2~uORF:IOH6718	1184	49	1135
B35R10C09	35-9-10	Hs~Ref:NM_002732.2~uORF:IOH45130	628	56	572
B35R10C10	35-10-10	Hs~Ref:NM_002732.2~uORF:IOH45130	776	422	354
B35R10C11	35-11-10	GST1	52	41	11
B35R10C12	35-12-10	GST1	41	43	-2
B35R10C13	35-13-10	GST2	42	46	-4
B35R10C14	35-14-10	GST2	754	47	707
B35R10C15	35-15-10	GST3	46	42	4
B35R10C16	35-16-10	GST3	45	42	3
B35R10C17	35-17-10	GST4	538	47	491
B35R10C18	35-18-10	GST4	173	49	124
B35R10C19	35-19-10	Anti-HumanIgA1~N/A	7295	45	7250
B35R10C20	35-20-10	Anti-HumanIgA1~N/A	8004	44	7960
B35R10C21	35-21-10	Anti-HumanIgA2~N/A	14380	47	14333
B35R10C22	35-22-10	Anti-HumanIgA2~N/A	14125	45	14080
B35R11C01	35-1-11	AlexaAntiMouseAb~N/A	23751	42	23709
B35R11C02	35-2-11	AlexaAntiMouseAb~N/A	22729	44	22685
B35R11C03	35-3-11	MAPKAP~N/A	107	44	63
B35R11C04	35-4-11	MAPKAP~N/A	95	43	52
B35R11C05	35-5-11	Buffer	1933	41	1892
B35R11C06	35-6-11	Buffer	1857	41	1816
B35R11C07	35-7-11	BSA~N/A	9522	42	9480
B35R11C08	35-8-11	BSA~N/A	9903	41	9862
B35R11C09	35-9-11	Anti-HumanIgG1~N/A	1632	43	1589
B35R11C10	35-10-11	Anti-HumanIgG1~N/A	1721	43	1678
B35R11C11	35-11-11	Anti-HumanIgG2~N/A	3060	43	3017
B35R11C12	35-12-11	Anti-HumanIgG2~N/A	2922	44	2878
B35R11C13	35-13-11	Anti-HumanIgG3~N/A	4734	43	4691
B35R11C14	35-14-11	Anti-HumanIgG3~N/A	4275	44	4231
B35R11C15	35-15-11	Anti-HumanIgG4~N/A	7545	41	7504
B35R11C16	35-16-11	Anti-HumanIgG4~N/A	9704	41	9663
B35R11C17	35-17-11	AntiBiotinAb~N/A	10280	41	10239
B35R11C18	35-18-11	AntiBiotinAb~N/A	10324	41	10283
B35R11C19	35-19-11	Buffer	59	40	19
B35R11C20	35-20-11	Buffer	59	40	19
B35R11C21	35-21-11	Hs~MGC:BC000979.2~uORF:IOH2932	843	42	801
B35R11C22	35-22-11	Hs~MGC:BC000979.2~uORF:IOH2932	723	41	682
B35R12C01	35-1-12	Hs~Ref:NM_006694.1~uORF:IOH2941	566	44	522
B35R12C02	35-2-12	Hs~Ref:NM_006694.1~uORF:IOH2941	547	44	503
B35R12C03	35-3-12	Hs~Ref:NM_005900.1~uORF:IOH4970	1040	43	997
B35R12C04	35-4-12	Hs~Ref:NM_005900.1~uORF:IOH4970	978	43	935
B35R12C05	35-5-12	Hs~Ref:NM_006253.2~uORF:IOH3634	666	41	625
B35R12C06	35-6-12	Hs~Ref:NM_006253.2~uORF:IOH3634	713	41	672
B35R12C07	35-7-12	Hs~Ref:NM_001031694.1~uORF:IOH57086	169	45	124
B35R12C08	35-8-12	Hs~Ref:NM_001031694.1~uORF:IOH57086	81	41	40
B35R12C09	35-9-12	Hs~MGC:BC009930.2~uORF:IOH57115	298	45	253
B35R12C10	35-10-12	Hs~MGC:BC009930.2~uORF:IOH57115	287	45	242
B35R12C11	35-11-12	Hs~MGC:BC073163.1~uORF:IOH62548	364	51	313
B35R12C12	35-12-12	Hs~MGC:BC073163.1~uORF:IOH62548	345	70	275
B35R12C13	35-13-12	Hs~MGC:BC080187.1~uORF:IOH62553	1668	46	1622
B35R12C14	35-14-12	Hs~MGC:BC080187.1~uORF:IOH62553	1615	42	1573
B35R12C15	35-15-12	Hs~Ref:NM_133484.1~uORF:IOH2979	357	41	316
B35R12C16	35-16-12	Hs~Ref:NM_133484.1~uORF:IOH2979	373	41	332
B35R12C17	35-17-12	Hs~Ref:NM_017924.2~uORF:IOH10782	145	40	105
B35R12C18	35-18-12	Hs~Ref:NM_017924.2~uORF:IOH10782	127	41	86
B35R12C19	35-19-12	Hs~Ref:NM_002922.2~uORF:IOH10963	205	67	138
B35R12C20	35-20-12	Hs~Ref:NM_002922.2~uORF:IOH10963	84	41	43
B35R12C21	35-21-12	Hs~Ref:NM_007019.1~uORF:IOH10068	126	64	62
B35R12C22	35-22-12	Hs~Ref:NM_007019.1~uORF:IOH10068	107	56	51
B35R13C01	35-1-13	Hs~Ref:NM_015184.2~uORF:IOH22060	1694	41	1653
B35R13C02	35-2-13	Hs~Ref:NM_015184.2~uORF:IOH22060	1679	45	1634
B35R13C03	35-3-13	Hs~MGC:BC045768.1~uORF:IOH26324	690	42	648
B35R13C04	35-4-13	Hs~MGC:BC045768.1~uORF:IOH26324	719	41	678
B35R13C05	35-5-13	Hs~MGC:BC007424.2~uORF:IOH6160	1497	42	1455
B35R13C06	35-6-13	Hs~MGC:BC007424.2~uORF:IOH6160	1383	43	1340
B35R13C07	35-7-13	Hs~Ref:NM_002018.2~uORF:IOH14719	371	42	329
B35R13C08	35-8-13	Hs~Ref:NM_002018.2~uORF:IOH14719	328	41	287
B35R13C09	35-9-13	Hs~MGC:BC038960.1~uORF:IOH26165	318	44	274
B35R13C10	35-10-13	Hs~MGC:BC038960.1~uORF:IOH26165	324	47	277
B35R13C11	35-11-13	Hs~Ref:NM_170707.1~uORF:IOH41769	569	46	523
B35R13C12	35-12-13	Hs~Ref:NM_170707.1~uORF:IOH41769	557	45	512
B35R13C13	35-13-13	Hs~Ref:NM_207480.1~uORF:IOH50189	547	42	505
B35R13C14	35-14-13	Hs~Ref:NM_207480.1~uORF:IOH50189	601	47	554
B35R13C15	35-15-13	Hs~Ref:NM_004591.1~uORF:IOH50190	177	71	106
B35R13C16	35-16-13	Hs~Ref:NM_004591.1~uORF:IOH50190	75	50	25
B35R13C17	35-17-13	Hs~Ref:NM_001215.2~uORF:IOH59066	1616	45	1571
B35R13C18	35-18-13	Hs~Ref:NM_001215.2~uORF:IOH59066	1257	49	1208
B35R13C19	35-19-13	Hs~Ref:NM_013411.3~uORF:IOH59040	570	46	524
B35R13C20	35-20-13	Hs~Ref:NM_013411.3~uORF:IOH59040	562	44	518
B35R13C21	35-21-13	Hs~MGC:NM_178814.2~uORF:IOH11915	467	42	425
B35R13C22	35-22-13	Hs~MGC:NM_178814.2~uORF:IOH11915	422	42	380
B35R14C01	35-1-14	Hs~MGC:BC027989.1~uORF:IOH11526	389	41	348
B35R14C02	35-2-14	Hs~MGC:BC027989.1~uORF:IOH11526	414	48	366
B35R14C03	35-3-14	Hs~Ref:NM_001001936.1~uORF:IOH23258	409	45	364
B35R14C04	35-4-14	Hs~Ref:NM_001001936.1~uORF:IOH23258	404	44	360
B35R14C05	35-5-14	Hs~Ref:NM_001945.1~uORF:IOH23272	353	43	310
B35R14C06	35-6-14	Hs~Ref:NM_001945.1~uORF:IOH23272	379	44	335
B35R14C07	35-7-14	Hs~Ref:NM_002011.3~uORF:IOH13371	386	44	342
B35R14C08	35-8-14	Hs~Ref:NM_002011.3~uORF:IOH13371	289	41	248
B35R14C09	35-9-14	Hs~Ref:NM_006280.1~uORF:IOH2918	310	44	266
B35R14C10	35-10-14	Hs~Ref:NM_006280.1~uORF:IOH2918	347	43	304
B35R14C11	35-11-14	Hs~Ref:NM_018138.1~uORF:IOH11055	385	47	338
B35R14C12	35-12-14	Hs~Ref:NM_018138.1~uORF:IOH11055	363	55	308
B35R14C13	35-13-14	Hs~Ref:NM_031206.2~uORF:IOH14284	362	42	320
B35R14C14	35-14-14	Hs~Ref:NM_031206.2~uORF:IOH14284	354	46	308
B35R14C15	35-15-14	Hs~MGC:BC032656.1~uORF:IOH21979	684	99	585
B35R14C16	35-16-14	Hs~MGC:BC032656.1~uORF:IOH21979	805	219	586
B35R14C17	35-17-14	Hs~MGC:BC030997.1~uORF:IOH23173	464	248	216
B35R14C18	35-18-14	Hs~MGC:BC030997.1~uORF:IOH23173	347	114	233
B35R14C19	35-19-14	Hs~Ref:NM_021173.2~uORF:IOH45937	56	53	3
B35R14C20	35-20-14	Hs~Ref:NM_021173.2~uORF:IOH45937	435	44	391
B35R14C21	35-21-14	Hs~Ref:NM_173455.1~uORF:IOH45492	535	42	493
B35R14C22	35-22-14	Hs~Ref:NM_173455.1~uORF:IOH45492	511	41	470
B35R15C01	35-1-15	Hs~MGC:BC023549.2~uORF:IOH27821	2725	39	2686
B35R15C02	35-2-15	Hs~MGC:BC023549.2~uORF:IOH27821	2541	42	2499
B35R15C03	35-3-15	Hs~Ref:NM_080652.2~uORF:IOH7051	260	100	160
B35R15C04	35-4-15	Hs~Ref:NM_080652.2~uORF:IOH7051	123	45	78
B35R15C05	35-5-15	Hs~Ref:NM_021026.1~uORF:IOH43261	379	43	336
B35R15C06	35-6-15	Hs~Ref:NM_021026.1~uORF:IOH43261	351	42	309
B35R15C07	35-7-15	Hs~Ref:NM_001007529.1~uORF:IOH43417	342	43	299
B35R15C08	35-8-15	Hs~Ref:NM_001007529.1~uORF:IOH43417	346	43	303
B35R15C09	35-9-15	Hs~Ref:NM_181297.1~uORF:IOH43436	334	45	289
B35R15C10	35-10-15	Hs~Ref:NM_181297.1~uORF:IOH43436	251	44	207
B35R15C11	35-11-15	Hs~Ref:NM_022772.2~uORF:IOH44912	252	131	121
B35R15C12	35-12-15	Hs~Ref:NM_022772.2~uORF:IOH44912	112	44	68
B35R15C13	35-13-15	Hs~Ref:NM_152696.3~CAT:PV4561	193	48	145
B35R15C14	35-14-15	Hs~Ref:NM_152696.3~CAT:PV4561	177	52	125
B35R15C15	35-15-15	Hs~Ref:NM_002401.2~CAT:PV3876	394	54	340
B35R15C16	35-16-15	Hs~Ref:NM_002401.2~CAT:PV3876	593	64	529
B35R15C17	35-17-15	Hs~Ref:NM_004119.1~CAT:PV3967	116	46	70
B35R15C18	35-18-15	Hs~Ref:NM_004119.1~CAT:PV3967	110	44	66
B35R15C19	35-19-15	Hs~Ref:NM_002755.2~CAT:PV3303	98	43	55
B35R15C20	35-20-15	Hs~Ref:NM_002755.2~CAT:PV3303	99	41	58
B35R15C21	35-21-15	Hs~Ref:NM_005228.3~CAT:PV3872	48	44	4
B35R15C22	35-22-15	Hs~Ref:NM_005228.3~CAT:PV3872	104	43	61
B35R16C01	35-1-16	Hs~Ref:NM_002754.3~CAT:PV3656	89	38	51
B35R16C02	35-2-16	Hs~Ref:NM_002754.3~CAT:PV3656	83	40	43
B35R16C03	35-3-16	Hs~Ref:NM_005123.1~CAT:PV4835	193	41	152
B35R16C04	35-4-16	Hs~Ref:NM_005123.1~CAT:PV4835	192	139	53
B35R16C05	35-5-16	Hs~Ref:NM_000075.2~CAT:PV4400	72	40	32
B35R16C06	35-6-16	Hs~Ref:NM_000075.2~CAT:PV4400	65	41	24
B35R16C07	35-7-16	Hs~MGC:BC047901.2~uORF:IOH28877	710	41	669
B35R16C08	35-8-16	Hs~MGC:BC047901.2~uORF:IOH28877	693	41	652
B35R16C09	35-9-16	Hs~MGC:BC039904.1~uORF:IOH28768	1666	42	1624
B35R16C10	35-10-16	Hs~MGC:BC039904.1~uORF:IOH28768	1613	42	1571
B35R16C11	35-11-16	Hs~MGC:BC015358.1~uORF:IOH10311	1030	44	986
B35R16C12	35-12-16	Hs~MGC:BC015358.1~uORF:IOH10311	1052	47	1005
B35R16C13	35-13-16	Hs~MGC:BC043346.2~uORF:IOH28804	110	55	55
B35R16C14	35-14-16	Hs~MGC:BC043346.2~uORF:IOH28804	82	46	36
B35R16C15	35-15-16	Hs~Ref:NM_206833.1~uORF:IOH40736	690	49	641
B35R16C16	35-16-16	Hs~Ref:NM_206833.1~uORF:IOH40736	360	53	307
B35R16C17	35-17-16	Hs~Ref:NM_007375.3~uORF:IOH45677	388	45	343
B35R16C18	35-18-16	Hs~Ref:NM_007375.3~uORF:IOH45677	453	45	408
B35R16C19	35-19-16	Hs~Ref:NM_032342.1~uORF:IOH6569	461	48	413
B35R16C20	35-20-16	Hs~Ref:NM_032342.1~uORF:IOH6569	526	48	478
B35R16C21	35-21-16	Hs~MGC:BC012887.1~uORF:IOH25768	1215	45	1170
B35R16C22	35-22-16	Hs~MGC:BC012887.1~uORF:IOH25768	1260	44	1216
B35R17C01	35-1-17	Hs~MGC:BC041590.1~uORF:IOH28013	1020	40	980
B35R17C02	35-2-17	Hs~MGC:BC041590.1~uORF:IOH28013	982	42	940
B35R17C03	35-3-17	Hs~Ref:NM_138565.1~uORF:IOH6227	4151	42	4109
B35R17C04	35-4-17	Hs~Ref:NM_138565.1~uORF:IOH6227	4019	43	3976
B35R17C05	35-5-17	Hs~Ref:NM_002038.2~uORF:IOH14517	311	94	217
B35R17C06	35-6-17	Hs~Ref:NM_002038.2~uORF:IOH14517	283	44	239
B35R17C07	35-7-17	Hs~Ref:NM_030881.2~uORF:IOH1750	7551	41	7510
B35R17C08	35-8-17	Hs~Ref:NM_030881.2~uORF:IOH1750	6919	41	6878
B35R17C09	35-9-17	Hs~MGC:BC042179.1~uORF:IOH25923	823	41	782
B35R17C10	35-10-17	Hs~MGC:BC042179.1~uORF:IOH25923	771	41	730
B35R17C11	35-11-17	Hs~MGC:BC051820.1~uORF:IOH27009	494	44	450
B35R17C12	35-12-17	Hs~MGC:BC051820.1~uORF:IOH27009	488	45	443
B35R17C13	35-13-17	Hs~Ref:NM_020234.3~uORF:IOH21971	936	48	888
B35R17C14	35-14-17	Hs~Ref:NM_020234.3~uORF:IOH21971	947	45	902
B35R17C15	35-15-17	Hs~MGC:BC013791.1~uORF:IOH22123	459	45	414
B35R17C16	35-16-17	Hs~MGC:BC013791.1~uORF:IOH22123	429	47	382
B35R17C17	35-17-17	Hs~Ref:NM_032570.1~uORF:IOH12288	412	47	365
B35R17C18	35-18-17	Hs~Ref:NM_032570.1~uORF:IOH12288	407	53	354
B35R17C19	35-19-17	Hs~Ref:NM_144717.1~uORF:IOH10849	470	54	416
B35R17C20	35-20-17	Hs~Ref:NM_144717.1~uORF:IOH10849	227	45	182
B35R17C21	35-21-17	Hs~MGC:BC013103.1~uORF:IOH22117	828	46	782
B35R17C22	35-22-17	Hs~MGC:BC013103.1~uORF:IOH22117	107	48	59
B35R18C01	35-1-18	Hs~MGC:BC030597.1~uORF:IOH22318	502	110	392
B35R18C02	35-2-18	Hs~MGC:BC030597.1~uORF:IOH22318	460	65	395
B35R18C03	35-3-18	Hs~Ref:NM_014002.1~N/A	490	44	446
B35R18C04	35-4-18	Hs~Ref:NM_014002.1~N/A	502	43	459
B35R18C05	35-5-18	Hs~Ref:NM_005417.2~N/A	455	42	413
B35R18C06	35-6-18	Hs~Ref:NM_005417.2~N/A	464	44	420
B35R18C07	35-7-18	Hs~Ref:NM_015112.1~N/A	490	43	447
B35R18C08	35-8-18	Hs~Ref:NM_015112.1~N/A	524	45	479
B35R18C09	35-9-18	Hs~Ref:NM_007194.1~N/A	470	45	425
B35R18C10	35-10-18	Hs~Ref:NM_007194.1~N/A	455	43	412
B35R18C11	35-11-18	Hs~Ref:NM_004465.1~uORF:IOH40262	571	41	530
B35R18C12	35-12-18	Hs~Ref:NM_004465.1~uORF:IOH40262	540	42	498
B35R18C13	35-13-18	Hs~Ref:NM_000589.2~uORF:IOH40149	336	43	293
B35R18C14	35-14-18	Hs~Ref:NM_000589.2~uORF:IOH40149	336	44	292
B35R18C15	35-15-18	Hs~Ref:NM_000586.2~uORF:IOH40161	359	58	301
B35R18C16	35-16-18	Hs~Ref:NM_000586.2~uORF:IOH40161	308	46	262
B35R18C17	35-17-18	Hs~MGC:BC063311.1~uORF:IOH39797	444	43	401
B35R18C18	35-18-18	Hs~MGC:BC063311.1~uORF:IOH39797	514	50	464
B35R18C19	35-19-18	Hs~MGC:BC089417.1~uORF:IOH62693	21809	48	21761
B35R18C20	35-20-18	Hs~MGC:BC089417.1~uORF:IOH62693	21328	48	21280
B35R18C21	35-21-18	Hs~Ref:NM_019092.1~uORF:IOH29458	120	52	68
B35R18C22	35-22-18	Hs~Ref:NM_019092.1~uORF:IOH29458	126	52	74
B35R19C01	35-1-19	Hs~Ref:NM_005817.3~uORF:IOH27786	343	188	155
B35R19C02	35-2-19	Hs~Ref:NM_005817.3~uORF:IOH27786	181	88	93
B35R19C03	35-3-19	Hs~MGC:BC044586.1~uORF:IOH28860	2250	46	2204
B35R19C04	35-4-19	Hs~MGC:BC044586.1~uORF:IOH28860	2017	43	1974
B35R19C05	35-5-19	Hs~Ref:NM_001017431.1~uORF:IOH57340	635	42	593
B35R19C06	35-6-19	Hs~Ref:NM_001017431.1~uORF:IOH57340	633	42	591
B35R19C07	35-7-19	Hs~MGC:BC036089.1~uORF:IOH27267	1357	42	1315
B35R19C08	35-8-19	Hs~MGC:BC036089.1~uORF:IOH27267	1413	42	1371
B35R19C09	35-9-19	Hs~MGC:BC013186.1~uORF:IOH10890	431	42	389
B35R19C10	35-10-19	Hs~MGC:BC013186.1~uORF:IOH10890	418	41	377
B35R19C11	35-11-19	Hs~Ref:NM_003352.4~uORF:IOH5973	910	42	868
B35R19C12	35-12-19	Hs~Ref:NM_003352.4~uORF:IOH5973	905	44	861
B35R19C13	35-13-19	Hs~MGC:BC009793.1~uORF:IOH14418	343	46	297
B35R19C14	35-14-19	Hs~MGC:BC009793.1~uORF:IOH14418	378	45	333
B35R19C15	35-15-19	Hs~MGC:BC009106.1~uORF:IOH10263	408	52	356
B35R19C16	35-16-19	Hs~MGC:BC009106.1~uORF:IOH10263	418	46	372
B35R19C17	35-17-19	Hs~Ref:NM_023076.2~uORF:IOH2885	361	44	317
B35R19C18	35-18-19	Hs~Ref:NM_023076.2~uORF:IOH2885	400	46	354
B35R19C19	35-19-19	Hs~Ref:NM_014055.1~uORF:IOH23043	573	48	525
B35R19C20	35-20-19	Hs~Ref:NM_014055.1~uORF:IOH23043	564	49	515
B35R19C21	35-21-19	Hs~Ref:NM_002037.1~N/A	47	52	-5
B35R19C22	35-22-19	Hs~Ref:NM_002037.1~N/A	40	106	-66
B35R20C01	35-1-20	Hs~Ref:NM_001570.2~N/A	380	84	296
B35R20C02	35-2-20	Hs~Ref:NM_001570.2~N/A	363	88	275
B35R20C03	35-3-20	Hs~Ref:NM_000455.3~N/A	351	50	301
B35R20C04	35-4-20	Hs~Ref:NM_000455.3~N/A	323	46	277
B35R20C05	35-5-20	Hs~Ref:NM_006137.4~uORF:IOH14100	276	47	229
B35R20C06	35-6-20	Hs~Ref:NM_006137.4~uORF:IOH14100	227	44	183
B35R20C07	35-7-20	Hs~Ref:NM_015680.2~uORF:IOH3981	86	42	44
B35R20C08	35-8-20	Hs~Ref:NM_015680.2~uORF:IOH3981	94	42	52
B35R20C09	35-9-20	Hs~Ref:NM_000851.2~uORF:IOH54796	37	39	-2
B35R20C10	35-10-20	Hs~Ref:NM_000851.2~uORF:IOH54796	38	38	0
B35R20C11	35-11-20	Hs~Ref:NM_012205.1~uORF:IOH54935	349	40	309
B35R20C12	35-12-20	Hs~Ref:NM_012205.1~uORF:IOH54935	330	42	288
B35R20C13	35-13-20	Hs~Ref:NM_006109.3~uORF:IOH59120	580	42	538
B35R20C14	35-14-20	Hs~Ref:NM_006109.3~uORF:IOH59120	592	41	551
B35R20C15	35-15-20	Hs~Ref:NM_003263.3~uORF:IOH42640	210	43	167
B35R20C16	35-16-20	Hs~Ref:NM_003263.3~uORF:IOH42640	107	48	59
B35R20C17	35-17-20	Hs~Ref:NM_178011.2~uORF:IOH42698	276	77	199
B35R20C18	35-18-20	Hs~Ref:NM_178011.2~uORF:IOH42698	164	45	119
B35R20C19	35-19-20	Hs~Ref:NM_018051.2~uORF:IOH45784	159	43	116
B35R20C20	35-20-20	Hs~Ref:NM_018051.2~uORF:IOH45784	61	45	16
B35R20C21	35-21-20	Hs~Ref:NM_024881.3~uORF:IOH45923	66	54	12
B35R20C22	35-22-20	Hs~Ref:NM_024881.3~uORF:IOH45923	51	50	1
B35R21C01	35-1-21	Hs~Ref:XM_378700.1~uORF:IOH43394	468	40	428
B35R21C02	35-2-21	Hs~Ref:XM_378700.1~uORF:IOH43394	489	42	447
B35R21C03	35-3-21	Hs~Ref:NM_020817.1~uORF:IOH44854	748	44	704
B35R21C04	35-4-21	Hs~Ref:NM_020817.1~uORF:IOH44854	757	43	714
B35R21C05	35-5-21	Hs~Ref:NM_182976.1~uORF:IOH43088	336	44	292
B35R21C06	35-6-21	Hs~Ref:NM_182976.1~uORF:IOH43088	358	46	312
B35R21C07	35-7-21	Hs~Ref:NM_032566.2~uORF:IOH43032	143	44	99
B35R21C08	35-8-21	Hs~Ref:NM_032566.2~uORF:IOH43032	224	117	107
B35R21C09	35-9-21	Hs~Ref:NP_000751.1~CAT_10218-H08H-25	44	41	3
B35R21C10	35-10-21	Hs~Ref:NP_000751.1~CAT_10218-H08H-25	46	39	7
B35R21C11	35-11-21	Internal_1007209	40	39	1
B35R21C12	35-12-21	Internal_1007209	42	40	2
B35R21C13	35-13-21	Hs~Ref:NP_997468.1~CAT_10359-H08H-25	38	38	0
B35R21C14	35-14-21	Hs~Ref:NP_997468.1~CAT_10359-H08H-25	37	38	-1
B35R21C15	35-15-21	Internal_1007209	42	38	4
B35R21C16	35-16-21	Internal_1007209	42	39	3
B35R21C17	35-17-21	Hs~Ref:P51654-1~CAT_10088-H08H-25	38	39	-1
B35R21C18	35-18-21	Hs~Ref:P51654-1~CAT_10088-H08H-25	40	39	1
B35R21C19	35-19-21	Internal_1007209	40	39	1
B35R21C20	35-20-21	Internal_1007209	43	39	4
B35R21C21	35-21-21	Hs~IVGN:IL23_Recombinant~CAT_PHC9321~N/A	53	41	12
B35R21C22	35-22-21	Hs~IVGN:IL23_Recombinant~CAT_PHC9321~N/A	51	42	9
B35R22C01	35-1-22	ERa~N/A	1995	38	1957
B35R22C02	35-2-22	ERa~N/A	2156	39	2117
B35R22C03	35-3-22	PKCeta~N/A	194	68	126
B35R22C04	35-4-22	PKCeta~N/A	235	45	190
B35R22C05	35-5-22	Calmodulin~N/A	85	41	44
B35R22C06	35-6-22	Calmodulin~N/A	82	42	40
B35R22C07	35-7-22	V5control5~N/A	313	46	267
B35R22C08	35-8-22	V5control5~N/A	342	43	299
B35R22C09	35-9-22	V5control4~N/A	89	61	28
B35R22C10	35-10-22	V5control4~N/A	150	87	63
B35R22C11	35-11-22	V5control3~N/A	58	41	17
B35R22C12	35-12-22	V5control3~N/A	67	48	19
B35R22C13	35-13-22	V5control2~N/A	52	38	14
B35R22C14	35-14-22	V5control2~N/A	50	38	12
B35R22C15	35-15-22	V5control1~N/A	45	38	7
B35R22C16	35-16-22	V5control1~N/A	45	39	6
B35R22C17	35-17-22	CMK2A~N/A	326	38	288
B35R22C18	35-18-22	CMK2A~N/A	324	39	285
B35R22C19	35-19-22	ERa~N/A	1643	39	1604
B35R22C20	35-20-22	ERa~N/A	1601	39	1562
B35R22C21	35-21-22	AlexaAntiMouseAb~N/A	9359	40	9319
B35R22C22	35-22-22	AlexaAntiMouseAb~N/A	7744	41	7703
B36R01C01	36-1-1	AlexaAntiMouseAb~N/A	33410	41	33369
B36R01C02	36-2-1	AlexaAntiMouseAb~N/A	38687	40	38647
B36R01C03	36-3-1	ERa~N/A	1731	41	1690
B36R01C04	36-4-1	ERa~N/A	1545	41	1504
B36R01C05	36-5-1	HumanIgG1~N/A	1005	41	964
B36R01C06	36-6-1	HumanIgG1~N/A	1039	42	997
B36R01C07	36-7-1	HumanIgG2~N/A	2266	43	2223
B36R01C08	36-8-1	HumanIgG2~N/A	2385	43	2342
B36R01C09	36-9-1	HumanIgG3~N/A	12032	45	11987
B36R01C10	36-10-1	HumanIgG3~N/A	13333	51	13282
B36R01C11	36-11-1	HumanIgG4~N/A	41764	71	41693
B36R01C12	36-12-1	HumanIgG4~N/A	62671	70	62601
B36R01C13	36-13-1	BiotinAb~N/A	367	71	296
B36R01C14	36-14-1	BiotinAb~N/A	1512	55	1457
B36R01C15	36-15-1	RanBP2deltaFG~N/A	311	65	246
B36R01C16	36-16-1	RanBP2deltaFG~N/A	331	68	263
B36R01C17	36-17-1	hMDM2~N/A	1135	223	912
B36R01C18	36-18-1	hMDM2~N/A	349	54	295
B36R01C19	36-19-1	PKCeta~N/A	268	49	219
B36R01C20	36-20-1	PKCeta~N/A	348	129	219
B36R01C21	36-21-1	AlexaAntiMouseAb~N/A	30013	49	29964
B36R01C22	36-22-1	AlexaAntiMouseAb~N/A	30110	46	30064
B36R02C01	36-1-2	PKCeta~N/A	869	40	829
B36R02C02	36-2-2	PKCeta~N/A	885	41	844
B36R02C03	36-3-2	Buffer	307	79	228
B36R02C04	36-4-2	Buffer	239	89	150
B36R02C05	36-5-2	HumanIgA~N/A	17694	44	17650
B36R02C06	36-6-2	HumanIgA~N/A	17454	42	17412
B36R02C07	36-7-2	Buffer	73	43	30
B36R02C08	36-8-2	Buffer	418	74	344
B36R02C09	36-9-2	BSA~N/A	10929	48	10881
B36R02C10	36-10-2	BSA~N/A	12036	79	11957
B36R02C11	36-11-2	Hs~Ref:NM_020679.1~uORF:IOH21880	218	74	144
B36R02C12	36-12-2	Hs~Ref:NM_020679.1~uORF:IOH21880	172	69	103
B36R02C13	36-13-2	Hs~MGC:BC014451.1~uORF:IOH13490	233	65	168
B36R02C14	36-14-2	Hs~MGC:BC014451.1~uORF:IOH13490	263	79	184
B36R02C15	36-15-2	Hs~Ref:NM_005182.1~uORF:IOH21843	162	69	93
B36R02C16	36-16-2	Hs~Ref:NM_005182.1~uORF:IOH21843	170	71	99
B36R02C17	36-17-2	Hs~MGC:NM_153212.1~uORF:IOH22179	246	64	182
B36R02C18	36-18-2	Hs~MGC:NM_153212.1~uORF:IOH22179	180	67	113
B36R02C19	36-19-2	Hs~MGC:BC001370.2~uORF:IOH3980	1202	101	1101
B36R02C20	36-20-2	Hs~MGC:BC001370.2~uORF:IOH3980	2006	94	1912
B36R02C21	36-21-2	Hs~MGC:BC002733.2~uORF:IOH5365	17978	65	17913
B36R02C22	36-22-2	Hs~MGC:BC002733.2~uORF:IOH5365	17452	53	17399
B36R03C01	36-1-3	Hs~Ref:NM_001003396.1~uORF:IOH3597	974	41	933
B36R03C02	36-2-3	Hs~Ref:NM_001003396.1~uORF:IOH3597	950	43	907
B36R03C03	36-3-3	Hs~MGC:BC019315.1~uORF:IOH27769	1298	44	1254
B36R03C04	36-4-3	Hs~MGC:BC019315.1~uORF:IOH27769	1297	46	1251
B36R03C05	36-5-3	Hs~Ref:XM_374781.2~uORF:IOH43235	465	44	421
B36R03C06	36-6-3	Hs~Ref:XM_374781.2~uORF:IOH43235	488	46	442
B36R03C07	36-7-3	Hs~Ref:NM_138930.2~uORF:IOH42210	163	46	117
B36R03C08	36-8-3	Hs~Ref:NM_138930.2~uORF:IOH42210	170	50	120
B36R03C09	36-9-3	Hs~Ref:NM_012416.2~uORF:IOH43766	104	67	37
B36R03C10	36-10-3	Hs~Ref:NM_012416.2~uORF:IOH43766	145	283	-138
B36R03C11	36-11-3	Hs~Ref:NM_173799.2~uORF:IOH42215	202	76	126
B36R03C12	36-12-3	Hs~Ref:NM_173799.2~uORF:IOH42215	184	63	121
B36R03C13	36-13-3	Hs~Ref:XM_375456.2~uORF:IOH43380	352	65	287
B36R03C14	36-14-3	Hs~Ref:XM_375456.2~uORF:IOH43380	366	59	307
B36R03C15	36-15-3	Hs~Ref:NM_133629.1~uORF:IOH43384	150	60	90
B36R03C16	36-16-3	Hs~Ref:NM_133629.1~uORF:IOH43384	145	75	70
B36R03C17	36-17-3	Hs~Ref:XM_291016.2~uORF:IOH43715	355	89	266
B36R03C18	36-18-3	Hs~Ref:XM_291016.2~uORF:IOH43715	311	73	238
B36R03C19	36-19-3	Hs~Ref:NM_004218.1~uORF:IOH42139	469	138	331
B36R03C20	36-20-3	Hs~Ref:NM_004218.1~uORF:IOH42139	157	71	86
B36R03C21	36-21-3	Hs~Ref:NM_006183.2~uORF:IOH13686	344	55	289
B36R03C22	36-22-3	Hs~Ref:NM_006183.2~uORF:IOH13686	315	52	263
B36R04C01	36-1-4	Hs~MGC:BC019861.1~uORF:IOH11354	394	47	347
B36R04C02	36-2-4	Hs~MGC:BC019861.1~uORF:IOH11354	143	50	93
B36R04C03	36-3-4	Hs~MGC:BC021723.2~uORF:IOH11630	2650	46	2604
B36R04C04	36-4-4	Hs~MGC:BC021723.2~uORF:IOH11630	2596	46	2550
B36R04C05	36-5-4	Hs~Ref:NM_002000.2~uORF:IOH11326	605	51	554
B36R04C06	36-6-4	Hs~Ref:NM_002000.2~uORF:IOH11326	574	55	519
B36R04C07	36-7-4	Hs~Ref:NM_199328.1~uORF:IOH12281	6870	62	6808
B36R04C08	36-8-4	Hs~Ref:NM_199328.1~uORF:IOH12281	8880	64	8816
B36R04C09	36-9-4	Hs~MGC:BC030984.1~uORF:IOH23182	56894	96	56798
B36R04C10	36-10-4	Hs~MGC:BC030984.1~uORF:IOH23182	55520	144	55376
B36R04C11	36-11-4	Hs~Ref:NM_000159.2~uORF:IOH4104	3107	68	3039
B36R04C12	36-12-4	Hs~Ref:NM_000159.2~uORF:IOH4104	2874	55	2819
B36R04C13	36-13-4	Hs~MGC:BC025266.1~uORF:IOH23199	1629	715	914
B36R04C14	36-14-4	Hs~MGC:BC025266.1~uORF:IOH23199	1283	114	1169
B36R04C15	36-15-4	Hs~Ref:NM_058173.1~uORF:IOH42944	249	65	184
B36R04C16	36-16-4	Hs~Ref:NM_058173.1~uORF:IOH42944	260	88	172
B36R04C17	36-17-4	Hs~Ref:NM_000631.3~uORF:IOH41405	913	299	614
B36R04C18	36-18-4	Hs~Ref:NM_000631.3~uORF:IOH41405	907	162	745
B36R04C19	36-19-4	Hs~Ref:NM_178483.2~uORF:IOH43017	755	88	667
B36R04C20	36-20-4	Hs~Ref:NM_178483.2~uORF:IOH43017	659	86	573
B36R04C21	36-21-4	Hs~MGC:BC000442.1~N/A	683	212	471
B36R04C22	36-22-4	Hs~MGC:BC000442.1~N/A	416	60	356
B36R05C01	36-1-5	Hs~Ref:NM_152757.1~uORF:IOH43336	4304	47	4257
B36R05C02	36-2-5	Hs~Ref:NM_152757.1~uORF:IOH43336	5242	54	5188
B36R05C03	36-3-5	Hs~Ref:XM_378542.2~uORF:IOH43419	1391	113	1278
B36R05C04	36-4-5	Hs~Ref:XM_378542.2~uORF:IOH43419	1138	169	969
B36R05C05	36-5-5	Hs~Ref:NM_025000.1~uORF:IOH43428	770	198	572
B36R05C06	36-6-5	Hs~Ref:NM_025000.1~uORF:IOH43428	290	74	216
B36R05C07	36-7-5	Hs~Ref:NM_025261.1~uORF:IOH43145	517	75	442
B36R05C08	36-8-5	Hs~Ref:NM_025261.1~uORF:IOH43145	207	59	148
B36R05C09	36-9-5	Hs~Ref:NM_014424.3~uORF:IOH6462	433	51	382
B36R05C10	36-10-5	Hs~Ref:NM_014424.3~uORF:IOH6462	402	54	348
B36R05C11	36-11-5	Hs~Ref:NM_005499.2~uORF:IOH5085	143	54	89
B36R05C12	36-12-5	Hs~Ref:NM_005499.2~uORF:IOH5085	124	50	74
B36R05C13	36-13-5	Hs~Ref:NM_052937.1~uORF:IOH22000	206	51	155
B36R05C14	36-14-5	Hs~Ref:NM_052937.1~uORF:IOH22000	162	52	110
B36R05C15	36-15-5	Hs~MGC:BC026101.2~uORF:IOH10652	4173	62	4111
B36R05C16	36-16-5	Hs~MGC:BC026101.2~uORF:IOH10652	4193	73	4120
B36R05C17	36-17-5	Hs~Ref:XM_378514.1~uORF:IOH42688	27762	112	27650
B36R05C18	36-18-5	Hs~Ref:XM_378514.1~uORF:IOH42688	30010	88	29922
B36R05C19	36-19-5	Hs~Ref:NM_000270.1~uORF:IOH41122	688	62	626
B36R05C20	36-20-5	Hs~Ref:NM_000270.1~uORF:IOH41122	667	64	603
B36R05C21	36-21-5	Hs~Ref:NM_178587.1~uORF:IOH42153	140	54	86
B36R05C22	36-22-5	Hs~Ref:NM_178587.1~uORF:IOH42153	92	74	18
B36R06C01	36-1-6	Hs~Ref:NM_014904.1~uORF:IOH35890	1297	48	1249
B36R06C02	36-2-6	Hs~Ref:NM_014904.1~uORF:IOH35890	177	59	118
B36R06C03	36-3-6	Hs~MGC:BC025345.1~uORF:IOH14194	624	64	560
B36R06C04	36-4-6	Hs~MGC:BC025345.1~uORF:IOH14194	580	57	523
B36R06C05	36-5-6	Hs~Ref:NM_022458.2~uORF:IOH10735	105	63	42
B36R06C06	36-6-6	Hs~Ref:NM_022458.2~uORF:IOH10735	102	62	40
B36R06C07	36-7-6	Hs~MGC:BC007411.2~uORF:IOH5892	101	53	48
B36R06C08	36-8-6	Hs~MGC:BC007411.2~uORF:IOH5892	71	55	16
B36R06C09	36-9-6	Hs~Ref:NM_016144.2~uORF:IOH7226	72	48	24
B36R06C10	36-10-6	Hs~Ref:NM_016144.2~uORF:IOH7226	181	53	128
B36R06C11	36-11-6	Hs~Ref:NM_030773.1~uORF:IOH21834	315	50	265
B36R06C12	36-12-6	Hs~Ref:NM_030773.1~uORF:IOH21834	430	64	366
B36R06C13	36-13-6	Hs~MGC:BC001917.1~uORF:IOH5075	257	54	203
B36R06C14	36-14-6	Hs~MGC:BC001917.1~uORF:IOH5075	215	63	152
B36R06C15	36-15-6	Hs~MGC:BC001873.1~uORF:IOH4800	228	55	173
B36R06C16	36-16-6	Hs~MGC:BC001873.1~uORF:IOH4800	380	60	320
B36R06C17	36-17-6	Hs~MGC:BC022288.1~uORF:IOH12278	490	63	427
B36R06C18	36-18-6	Hs~MGC:BC022288.1~uORF:IOH12278	498	65	433
B36R06C19	36-19-6	Hs~MGC:BC096265.2~uORF:IOH63225	154	55	99
B36R06C20	36-20-6	Hs~MGC:BC096265.2~uORF:IOH63225	126	51	75
B36R06C21	36-21-6	Hs~MGC:BC096113.3~uORF:IOH63206	201	49	152
B36R06C22	36-22-6	Hs~MGC:BC096113.3~uORF:IOH63206	310	179	131
B36R07C01	36-1-7	Hs~MGC:BC096267.2~uORF:IOH63233	145	46	99
B36R07C02	36-2-7	Hs~MGC:BC096267.2~uORF:IOH63233	132	51	81
B36R07C03	36-3-7	Hs~MGC:BC089438.1~uORF:IOH62729	225	56	169
B36R07C04	36-4-7	Hs~MGC:BC089438.1~uORF:IOH62729	227	63	164
B36R07C05	36-5-7	Hs~Ref:NM_000462.2~uORF:IOH38426	998	93	905
B36R07C06	36-6-7	Hs~Ref:NM_000462.2~uORF:IOH38426	825	463	362
B36R07C07	36-7-7	Hs~Ref:NM_012443.2~uORF:IOH43583	147	63	84
B36R07C08	36-8-7	Hs~Ref:NM_012443.2~uORF:IOH43583	139	57	82
B36R07C09	36-9-7	Hs~Ref:NM_015124.2~uORF:IOH42418	123	51	72
B36R07C10	36-10-7	Hs~Ref:NM_015124.2~uORF:IOH42418	116	50	66
B36R07C11	36-11-7	Hs~Ref:NM_205840.1~uORF:IOH41387	304	50	254
B36R07C12	36-12-7	Hs~Ref:NM_205840.1~uORF:IOH41387	286	51	235
B36R07C13	36-13-7	Hs~MGC:BC065725.1~uORF:IOH62824	164	100	64
B36R07C14	36-14-7	Hs~MGC:BC065725.1~uORF:IOH62824	185	53	132
B36R07C15	36-15-7	Hs~MGC:BC047673.1~uORF:IOH26656	60	48	12
B36R07C16	36-16-7	Hs~MGC:BC047673.1~uORF:IOH26656	101	68	33
B36R07C17	36-17-7	Hs~Ref:NM_016417.2~uORF:IOH26709	157	60	97
B36R07C18	36-18-7	Hs~Ref:NM_016417.2~uORF:IOH26709	146	60	86
B36R07C19	36-19-7	Hs~Ref:NM_017886.1~N/A	136	60	76
B36R07C20	36-20-7	Hs~Ref:NM_017886.1~N/A	114	60	54
B36R07C21	36-21-7	Hs~Ref:NM_015939.2~uORF:IOH3137	570	48	522
B36R07C22	36-22-7	Hs~Ref:NM_015939.2~uORF:IOH3137	517	44	473
B36R08C01	36-1-8	Hs~Ref:NM_144498.1~uORF:IOH6030	72	48	24
B36R08C02	36-2-8	Hs~Ref:NM_144498.1~uORF:IOH6030	69	50	19
B36R08C03	36-3-8	Hs~Ref:NM_003041.1~uORF:IOH38149	1001	65	936
B36R08C04	36-4-8	Hs~Ref:NM_003041.1~uORF:IOH38149	291	74	217
B36R08C05	36-5-8	Hs~MGC:BC031620.1~uORF:IOH27386	293	53	240
B36R08C06	36-6-8	Hs~MGC:BC031620.1~uORF:IOH27386	279	54	225
B36R08C07	36-7-8	Hs~MGC:BC000306.1~uORF:IOH3456	934	510	424
B36R08C08	36-8-8	Hs~MGC:BC000306.1~uORF:IOH3456	492	72	420
B36R08C09	36-9-8	Hs~Ref:NM_004632.2~uORF:IOH3569	408	58	350
B36R08C10	36-10-8	Hs~Ref:NM_004632.2~uORF:IOH3569	600	53	547
B36R08C11	36-11-8	Hs~MGC:BC000238.1~uORF:IOH4394	4245	53	4192
B36R08C12	36-12-8	Hs~MGC:BC000238.1~uORF:IOH4394	3727	55	3672
B36R08C13	36-13-8	Hs~Ref:NM_000284.1~uORF:IOH3633	456	57	399
B36R08C14	36-14-8	Hs~Ref:NM_000284.1~uORF:IOH3633	430	50	380
B36R08C15	36-15-8	Hs~MGC:BC021680.1~uORF:IOH12084	171	75	96
B36R08C16	36-16-8	Hs~MGC:BC021680.1~uORF:IOH12084	636	140	496
B36R08C17	36-17-8	Hs~MGC:BC013935.1~uORF:IOH12458	458	97	361
B36R08C18	36-18-8	Hs~MGC:BC013935.1~uORF:IOH12458	349	69	280
B36R08C19	36-19-8	Hs~Ref:NM_138794.1~uORF:IOH13353	500	71	429
B36R08C20	36-20-8	Hs~Ref:NM_138794.1~uORF:IOH13353	582	341	241
B36R08C21	36-21-8	Hs~Ref:NM_138573.1~uORF:IOH13075	374	49	325
B36R08C22	36-22-8	Hs~Ref:NM_138573.1~uORF:IOH13075	525	47	478
B36R09C01	36-1-9	Hs~Ref:NM_031473.2~uORF:IOH40581	202	48	154
B36R09C02	36-2-9	Hs~Ref:NM_031473.2~uORF:IOH40581	225	50	175
B36R09C03	36-3-9	Hs~Ref:NM_152850.2~uORF:IOH40494	360	65	295
B36R09C04	36-4-9	Hs~Ref:NM_152850.2~uORF:IOH40494	144	50	94
B36R09C05	36-5-9	Hs~MGC:BC002723.2~uORF:IOH40582	162	52	110
B36R09C06	36-6-9	Hs~MGC:BC002723.2~uORF:IOH40582	289	52	237
B36R09C07	36-7-9	Hs~Ref:NM_001501.1~uORF:IOH40386	388	51	337
B36R09C08	36-8-9	Hs~Ref:NM_001501.1~uORF:IOH40386	62	138	-76
B36R09C09	36-9-9	Hs~Ref:NM_014033.1~uORF:IOH3148	93	48	45
B36R09C10	36-10-9	Hs~Ref:NM_014033.1~uORF:IOH3148	142	63	79
B36R09C11	36-11-9	Hs~MGC:BC000314.1~uORF:IOH3485	211	50	161
B36R09C12	36-12-9	Hs~MGC:BC000314.1~uORF:IOH3485	342	131	211
B36R09C13	36-13-9	Hs~Ref:NM_002857.1~uORF:IOH3467	113	48	65
B36R09C14	36-14-9	Hs~Ref:NM_002857.1~uORF:IOH3467	113	48	65
B36R09C15	36-15-9	Hs~Ref:NM_012111.1~uORF:IOH3527	297	74	223
B36R09C16	36-16-9	Hs~Ref:NM_012111.1~uORF:IOH3527	199	92	107
B36R09C17	36-17-9	Hs~Ref:NM_130782.1~uORF:IOH12138	1080	417	663
B36R09C18	36-18-9	Hs~Ref:NM_130782.1~uORF:IOH12138	882	58	824
B36R09C19	36-19-9	Hs~MGC:BC020620.1~uORF:IOH12057	779	61	718
B36R09C20	36-20-9	Hs~MGC:BC020620.1~uORF:IOH12057	873	466	407
B36R09C21	36-21-9	Hs~MGC:BC022257.1~uORF:IOH12061	2771	57	2714
B36R09C22	36-22-9	Hs~MGC:BC022257.1~uORF:IOH12061	2609	45	2564
B36R10C01	36-1-10	Hs~MGC:BC020835.1~uORF:IOH13388	655	49	606
B36R10C02	36-2-10	Hs~MGC:BC020835.1~uORF:IOH13388	689	318	371
B36R10C03	36-3-10	Hs~MGC:BC008201.1~uORF:IOH3360	216	45	171
B36R10C04	36-4-10	Hs~MGC:BC008201.1~uORF:IOH3360	251	45	206
B36R10C05	36-5-10	Hs~MGC:BC060844.1~uORF:IOH29182	416	51	365
B36R10C06	36-6-10	Hs~MGC:BC060844.1~uORF:IOH29182	274	53	221
B36R10C07	36-7-10	Hs~MGC:BC040502.1~uORF:IOH28661	257	53	204
B36R10C08	36-8-10	Hs~MGC:BC040502.1~uORF:IOH28661	206	45	161
B36R10C09	36-9-10	Hs~MGC:BC053664.1~uORF:IOH28996	512	47	465
B36R10C10	36-10-10	Hs~MGC:BC053664.1~uORF:IOH28996	479	52	427
B36R10C11	36-11-10	GST1	48	43	5
B36R10C12	36-12-10	GST1	45	43	2
B36R10C13	36-13-10	GST2	43	40	3
B36R10C14	36-14-10	GST2	41	45	-4
B36R10C15	36-15-10	GST3	74	67	7
B36R10C16	36-16-10	GST3	75	71	4
B36R10C17	36-17-10	GST4	76	58	18
B36R10C18	36-18-10	GST4	70	51	19
B36R10C19	36-19-10	Anti-HumanIgA1~N/A	7959	52	7907
B36R10C20	36-20-10	Anti-HumanIgA1~N/A	7728	56	7672
B36R10C21	36-21-10	Anti-HumanIgA2~N/A	15910	51	15859
B36R10C22	36-22-10	Anti-HumanIgA2~N/A	14863	46	14817
B36R11C01	36-1-11	AlexaAntiMouseAb~N/A	21322	43	21279
B36R11C02	36-2-11	AlexaAntiMouseAb~N/A	19883	44	19839
B36R11C03	36-3-11	MAPKAP~N/A	95	42	53
B36R11C04	36-4-11	MAPKAP~N/A	94	42	52
B36R11C05	36-5-11	Buffer	1589	46	1543
B36R11C06	36-6-11	Buffer	1486	45	1441
B36R11C07	36-7-11	BSA~N/A	7214	45	7169
B36R11C08	36-8-11	BSA~N/A	7065	44	7021
B36R11C09	36-9-11	Anti-HumanIgG1~N/A	1303	44	1259
B36R11C10	36-10-11	Anti-HumanIgG1~N/A	1326	44	1282
B36R11C11	36-11-11	Anti-HumanIgG2~N/A	2474	42	2432
B36R11C12	36-12-11	Anti-HumanIgG2~N/A	2564	43	2521
B36R11C13	36-13-11	Anti-HumanIgG3~N/A	4933	43	4890
B36R11C14	36-14-11	Anti-HumanIgG3~N/A	4764	51	4713
B36R11C15	36-15-11	Anti-HumanIgG4~N/A	10166	69	10097
B36R11C16	36-16-11	Anti-HumanIgG4~N/A	10608	68	10540
B36R11C17	36-17-11	AntiBiotinAb~N/A	12490	59	12431
B36R11C18	36-18-11	AntiBiotinAb~N/A	13159	54	13105
B36R11C19	36-19-11	Buffer	58	53	5
B36R11C20	36-20-11	Buffer	52	53	-1
B36R11C21	36-21-11	Hs~MGC:BC000932.2~uORF:IOH2990	1050	52	998
B36R11C22	36-22-11	Hs~MGC:BC000932.2~uORF:IOH2990	1020	46	974
B36R12C01	36-1-12	Hs~Ref:NM_002823.2~uORF:IOH27923	340	65	275
B36R12C02	36-2-12	Hs~Ref:NM_002823.2~uORF:IOH27923	151	43	108
B36R12C03	36-3-12	Hs~MGC:BC000797.1~uORF:IOH3049	386	49	337
B36R12C04	36-4-12	Hs~MGC:BC000797.1~uORF:IOH3049	209	45	164
B36R12C05	36-5-12	Hs~MGC:BC012539.1~uORF:IOH12758	740	412	328
B36R12C06	36-6-12	Hs~MGC:BC012539.1~uORF:IOH12758	512	51	461
B36R12C07	36-7-12	Hs~MGC:NM_182623.1~uORF:IOH27355	72	45	27
B36R12C08	36-8-12	Hs~MGC:NM_182623.1~uORF:IOH27355	72	44	28
B36R12C09	36-9-12	Hs~Ref:NM_002262.2~uORF:IOH11597	64	43	21
B36R12C10	36-10-12	Hs~Ref:NM_002262.2~uORF:IOH11597	78	56	22
B36R12C11	36-11-12	Hs~MGC:BC014140.2~uORF:IOH12771	630	50	580
B36R12C12	36-12-12	Hs~MGC:BC014140.2~uORF:IOH12771	559	48	511
B36R12C13	36-13-12	Hs~MGC:BC016470.2~uORF:IOH11948	625	47	578
B36R12C14	36-14-12	Hs~MGC:BC016470.2~uORF:IOH11948	827	567	260
B36R12C15	36-15-12	Hs~MGC:BC100767.1~uORF:IOH63423	266	70	196
B36R12C16	36-16-12	Hs~MGC:BC100767.1~uORF:IOH63423	248	61	187
B36R12C17	36-17-12	Hs~MGC:BC098334.1~uORF:IOH63288	126	58	68
B36R12C18	36-18-12	Hs~MGC:BC098334.1~uORF:IOH63288	141	81	60
B36R12C19	36-19-12	Hs~MGC:BC100932.1~uORF:IOH63371	96	54	42
B36R12C20	36-20-12	Hs~MGC:BC100932.1~uORF:IOH63371	95	57	38
B36R12C21	36-21-12	Hs~MGC:BC100879.2~uORF:IOH63368	227	142	85
B36R12C22	36-22-12	Hs~MGC:BC100879.2~uORF:IOH63368	196	115	81
B36R13C01	36-1-13	Hs~Ref:NM_183060.1~uORF:IOH44379	432	43	389
B36R13C02	36-2-13	Hs~Ref:NM_183060.1~uORF:IOH44379	436	44	392
B36R13C03	36-3-13	Hs~Ref:NM_033111.2~uORF:IOH44850	974	54	920
B36R13C04	36-4-13	Hs~Ref:NM_033111.2~uORF:IOH44850	638	66	572
B36R13C05	36-5-13	Hs~Ref:NM_000698.2~uORF:IOH42560	1895	94	1801
B36R13C06	36-6-13	Hs~Ref:NM_000698.2~uORF:IOH42560	652	55	597
B36R13C07	36-7-13	Hs~Ref:NM_018553.1~uORF:IOH44546	1195	50	1145
B36R13C08	36-8-13	Hs~Ref:NM_018553.1~uORF:IOH44546	1223	48	1175
B36R13C09	36-9-13	Hs~MGC:NM_178014.2~uORF:IOH6917	367	47	320
B36R13C10	36-10-13	Hs~MGC:NM_178014.2~uORF:IOH6917	409	268	141
B36R13C11	36-11-13	Hs~MGC:BC031830.1~uORF:IOH25818	663	45	618
B36R13C12	36-12-13	Hs~MGC:BC031830.1~uORF:IOH25818	666	45	621
B36R13C13	36-13-13	Hs~MGC:BC015848.1~uORF:IOH27935	494	72	422
B36R13C14	36-14-13	Hs~MGC:BC015848.1~uORF:IOH27935	298	52	246
B36R13C15	36-15-13	Hs~MGC:BC052802.1~uORF:IOH29404	132	64	68
B36R13C16	36-16-13	Hs~MGC:BC052802.1~uORF:IOH29404	133	54	79
B36R13C17	36-17-13	Hs~Ref:NM_138446.1~uORF:IOH13334	397	59	338
B36R13C18	36-18-13	Hs~Ref:NM_138446.1~uORF:IOH13334	142	52	90
B36R13C19	36-19-13	Hs~MGC:BC004219.1~uORF:IOH5155	800	59	741
B36R13C20	36-20-13	Hs~MGC:BC004219.1~uORF:IOH5155	720	60	660
B36R13C21	36-21-13	Hs~MGC:BC000742.1~uORF:IOH4675	66	64	2
B36R13C22	36-22-13	Hs~MGC:BC000742.1~uORF:IOH4675	49	66	-17
B36R14C01	36-1-14	Hs~MGC:NM_031448.2~uORF:IOH5544	156	45	111
B36R14C02	36-2-14	Hs~MGC:NM_031448.2~uORF:IOH5544	627	51	576
B36R14C03	36-3-14	Hs~Ref:NM_173060.1~uORF:IOH52621	822	94	728
B36R14C04	36-4-14	Hs~Ref:NM_173060.1~uORF:IOH52621	665	93	572
B36R14C05	36-5-14	Hs~Ref:NM_032207.1~uORF:IOH52563	478	69	409
B36R14C06	36-6-14	Hs~Ref:NM_032207.1~uORF:IOH52563	479	49	430
B36R14C07	36-7-14	Hs~Ref:NM_002930.1~uORF:IOH54792	841	58	783
B36R14C08	36-8-14	Hs~Ref:NM_002930.1~uORF:IOH54792	807	53	754
B36R14C09	36-9-14	Hs~Ref:NM_022149.4~uORF:IOH59309	250	50	200
B36R14C10	36-10-14	Hs~Ref:NM_022149.4~uORF:IOH59309	332	48	284
B36R14C11	36-11-14	Hs~Ref:NM_004944.1~uORF:IOH14823	146	43	103
B36R14C12	36-12-14	Hs~Ref:NM_004944.1~uORF:IOH14823	140	44	96
B36R14C13	36-13-14	Hs~Ref:NM_006708.1~uORF:IOH10090	146	47	99
B36R14C14	36-14-14	Hs~Ref:NM_006708.1~uORF:IOH10090	163	53	110
B36R14C15	36-15-14	Hs~Ref:NM_016581.2~uORF:IOH4404	220	60	160
B36R14C16	36-16-14	Hs~Ref:NM_016581.2~uORF:IOH4404	155	51	104
B36R14C17	36-17-14	Hs~Ref:NM_031443.1~uORF:IOH5157	307	55	252
B36R14C18	36-18-14	Hs~Ref:NM_031443.1~uORF:IOH5157	376	85	291
B36R14C19	36-19-14	Hs~MGC:BC025776.1~uORF:IOH11913	1261	72	1189
B36R14C20	36-20-14	Hs~MGC:BC025776.1~uORF:IOH11913	1235	57	1178
B36R14C21	36-21-14	Hs~Ref:NM_002651.1~uORF:IOH44432	323	48	275
B36R14C22	36-22-14	Hs~Ref:NM_002651.1~uORF:IOH44432	302	51	251
B36R15C01	36-1-15	Hs~MGC:BC104039.1~uORF:IOH63578	216	50	166
B36R15C02	36-2-15	Hs~MGC:BC104039.1~uORF:IOH63578	209	47	162
B36R15C03	36-3-15	Hs~MGC:BC101406.1~uORF:IOH63592	542	57	485
B36R15C04	36-4-15	Hs~MGC:BC101406.1~uORF:IOH63592	503	46	457
B36R15C05	36-5-15	Hs~MGC:BC004514.1~uORF:IOH5664	85	47	38
B36R15C06	36-6-15	Hs~MGC:BC004514.1~uORF:IOH5664	76	49	27
B36R15C07	36-7-15	Hs~Ref:NM_006819.1~uORF:IOH5061	445	170	275
B36R15C08	36-8-15	Hs~Ref:NM_006819.1~uORF:IOH5061	403	60	343
B36R15C09	36-9-15	Hs~Ref:NM_024588.2~uORF:IOH6887	48	44	4
B36R15C10	36-10-15	Hs~Ref:NM_024588.2~uORF:IOH6887	54	53	1
B36R15C11	36-11-15	Hs~Ref:NM_014060.1~uORF:IOH4208	781	57	724
B36R15C12	36-12-15	Hs~Ref:NM_014060.1~uORF:IOH4208	508	59	449
B36R15C13	36-13-15	Hs~Ref:NM_001292.1~CAT:PV3826	449	46	403
B36R15C14	36-14-15	Hs~Ref:NM_001292.1~CAT:PV3826	393	52	341
B36R15C15	36-15-15	Hs~Ref:NM_001004056.1~CAT:PV3807	320	218	102
B36R15C16	36-16-15	Hs~Ref:NM_001004056.1~CAT:PV3807	277	48	229
B36R15C17	36-17-15	Hs~Ref:NM_002005.2~CAT:PV3354	389	50	339
B36R15C18	36-18-15	Hs~Ref:NM_002005.2~CAT:PV3354	365	52	313
B36R15C19	36-19-15	Hs~Ref:NM_002730.1~CAT:P2912	263	108	155
B36R15C20	36-20-15	Hs~Ref:NM_002730.1~CAT:P2912	79	60	19
B36R15C21	36-21-15	Hs~Ref:NM_002609.2~CAT:P3082	152	47	105
B36R15C22	36-22-15	Hs~Ref:NM_002609.2~CAT:P3082	47	54	-7
B36R16C01	36-1-16	Hs~Ref:NM_000588.3~CAT_PHC0035	47	42	5
B36R16C02	36-2-16	Hs~Ref:NM_000588.3~CAT_PHC0035	61	42	19
B36R16C03	36-3-16	Hs~Ref:NM_002985.1~CAT_PHC1055	48	44	4
B36R16C04	36-4-16	Hs~Ref:NM_002985.1~CAT_PHC1055	54	41	13
B36R16C05	36-5-16	Hs~IVGN:NM_000612~CAT_PHG0084~N/A	1264	46	1218
B36R16C06	36-6-16	Hs~IVGN:NM_000612~CAT_PHG0084~N/A	1019	49	970
B36R16C07	36-7-16	Hs~MGC:BC053878.1~uORF:IOH28978	480	51	429
B36R16C08	36-8-16	Hs~MGC:BC053878.1~uORF:IOH28978	498	49	449
B36R16C09	36-9-16	Hs~MGC:BC008212.1~uORF:IOH3386	68	42	26
B36R16C10	36-10-16	Hs~MGC:BC008212.1~uORF:IOH3386	68	43	25
B36R16C11	36-11-16	Hs~Ref:NM_016065.2~uORF:IOH12629	1052	90	962
B36R16C12	36-12-16	Hs~Ref:NM_016065.2~uORF:IOH12629	540	111	429
B36R16C13	36-13-16	Hs~Ref:NM_002476.2~uORF:IOH1793	164	96	68
B36R16C14	36-14-16	Hs~Ref:NM_002476.2~uORF:IOH1793	248	55	193
B36R16C15	36-15-16	Hs~Ref:NM_003341.3~uORF:IOH43236	520	76	444
B36R16C16	36-16-16	Hs~Ref:NM_003341.3~uORF:IOH43236	347	88	259
B36R16C17	36-17-16	Hs~Ref:NM_005950.1~uORF:IOH57335	384	66	318
B36R16C18	36-18-16	Hs~Ref:NM_005950.1~uORF:IOH57335	479	58	421
B36R16C19	36-19-16	Hs~Ref:NM_000614.2~uORF:IOH40046	479	58	421
B36R16C20	36-20-16	Hs~Ref:NM_000614.2~uORF:IOH40046	496	274	222
B36R16C21	36-21-16	Hs~MGC:BC036899.1~uORF:IOH25951	781	57	724
B36R16C22	36-22-16	Hs~MGC:BC036899.1~uORF:IOH25951	743	50	693
B36R17C01	36-1-17	Hs~MGC:BC017115.1~uORF:IOH10111	146	78	68
B36R17C02	36-2-17	Hs~MGC:BC017115.1~uORF:IOH10111	111	43	68
B36R17C03	36-3-17	Hs~Ref:NM_014878.2~uORF:IOH10030	85	43	42
B36R17C04	36-4-17	Hs~Ref:NM_014878.2~uORF:IOH10030	79	47	32
B36R17C05	36-5-17	Hs~Ref:NM_001902.2~uORF:IOH10106	44	54	-10
B36R17C06	36-6-17	Hs~Ref:NM_001902.2~uORF:IOH10106	50	53	-3
B36R17C07	36-7-17	Hs~MGC:BC007224.1~uORF:IOH6896	173	52	121
B36R17C08	36-8-17	Hs~MGC:BC007224.1~uORF:IOH6896	289	54	235
B36R17C09	36-9-17	Hs~Ref:NM_058244.1~uORF:IOH35591	117	42	75
B36R17C10	36-10-17	Hs~Ref:NM_058244.1~uORF:IOH35591	125	42	83
B36R17C11	36-11-17	Hs~Ref:NM_014496.1~uORF:IOH36120	4296	60	4236
B36R17C12	36-12-17	Hs~Ref:NM_014496.1~uORF:IOH36120	4196	73	4123
B36R17C13	36-13-17	Hs~Ref:NM_033277.1~uORF:IOH40715	105	47	58
B36R17C14	36-14-17	Hs~Ref:NM_033277.1~uORF:IOH40715	119	43	76
B36R17C15	36-15-17	Hs~Ref:NM_032357.2~uORF:IOH40902	250	56	194
B36R17C16	36-16-17	Hs~Ref:NM_032357.2~uORF:IOH40902	119	57	62
B36R17C17	36-17-17	Hs~Ref:NM_206824.1~uORF:IOH42079	381	238	143
B36R17C18	36-18-17	Hs~Ref:NM_206824.1~uORF:IOH42079	464	141	323
B36R17C19	36-19-17	Hs~Ref:XM_379194.1~uORF:IOH43490	795	47	748
B36R17C20	36-20-17	Hs~Ref:XM_379194.1~uORF:IOH43490	869	47	822
B36R17C21	36-21-17	Hs~Ref:NM_080612.1~uORF:IOH42263	207	104	103
B36R17C22	36-22-17	Hs~Ref:NM_080612.1~uORF:IOH42263	53	57	-4
B36R18C01	36-1-18	Hs~Ref:NM_001008220.1~uORF:IOH42361	1777	43	1734
B36R18C02	36-2-18	Hs~Ref:NM_001008220.1~uORF:IOH42361	1696	45	1651
B36R18C03	36-3-18	Hs~Ref:NM_145331.1~uORF:IOH29760	273	72	201
B36R18C04	36-4-18	Hs~Ref:NM_145331.1~uORF:IOH29760	124	45	79
B36R18C05	36-5-18	Hs~Ref:NM_000727.2~uORF:IOH29633	48	59	-11
B36R18C06	36-6-18	Hs~Ref:NM_000727.2~uORF:IOH29633	83	58	25
B36R18C07	36-7-18	Hs~MGC:BC056918.1~uORF:IOH29061	263	57	206
B36R18C08	36-8-18	Hs~MGC:BC056918.1~uORF:IOH29061	136	42	94
B36R18C09	36-9-18	Hs~MGC:BC021585.1~uORF:IOH29349	103	41	62
B36R18C10	36-10-18	Hs~MGC:BC021585.1~uORF:IOH29349	106	43	63
B36R18C11	36-11-18	Hs~MGC:BC067768.1~uORF:IOH61696	405	54	351
B36R18C12	36-12-18	Hs~MGC:BC067768.1~uORF:IOH61696	410	53	357
B36R18C13	36-13-18	Hs~MGC:BC047316.1~uORF:IOH62412	292	60	232
B36R18C14	36-14-18	Hs~MGC:BC047316.1~uORF:IOH62412	214	46	168
B36R18C15	36-15-18	Hs~MGC:BC071598.1~uORF:IOH62479	578	213	365
B36R18C16	36-16-18	Hs~MGC:BC071598.1~uORF:IOH62479	82	57	25
B36R18C17	36-17-18	Hs~MGC:BC073949.1~uORF:IOH61794	419	151	268
B36R18C18	36-18-18	Hs~MGC:BC073949.1~uORF:IOH61794	569	50	519
B36R18C19	36-19-18	Hs~MGC:BC037778.1~uORF:IOH62207	127	48	79
B36R18C20	36-20-18	Hs~MGC:BC037778.1~uORF:IOH62207	104	46	58
B36R18C21	36-21-18	Hs~MGC:BC035321.1~uORF:IOH62028	156	50	106
B36R18C22	36-22-18	Hs~MGC:BC035321.1~uORF:IOH62028	440	60	380
B36R19C01	36-1-19	Hs~Ref:NM_014440.1~uORF:IOH35127	103	43	60
B36R19C02	36-2-19	Hs~Ref:NM_014440.1~uORF:IOH35127	99	45	54
B36R19C03	36-3-19	Hs~MGC:BC036434.1~uORF:IOH62212	493	48	445
B36R19C04	36-4-19	Hs~MGC:BC036434.1~uORF:IOH62212	337	47	290
B36R19C05	36-5-19	Hs~MGC:BC051698.1~uORF:IOH26805	104	70	34
B36R19C06	36-6-19	Hs~MGC:BC051698.1~uORF:IOH26805	515	50	465
B36R19C07	36-7-19	Hs~MGC:BC002832.1~uORF:IOH5425	407	43	364
B36R19C08	36-8-19	Hs~MGC:BC002832.1~uORF:IOH5425	407	48	359
B36R19C09	36-9-19	Hs~Ref:NM_004414.3~uORF:IOH5722	569	46	523
B36R19C10	36-10-19	Hs~Ref:NM_004414.3~uORF:IOH5722	586	47	539
B36R19C11	36-11-19	Hs~Ref:NM_020368.1~uORF:IOH6359	450	51	399
B36R19C12	36-12-19	Hs~Ref:NM_020368.1~uORF:IOH6359	463	51	412
B36R19C13	36-13-19	Hs~Ref:NM_206898.1~uORF:IOH58589	204	136	68
B36R19C14	36-14-19	Hs~Ref:NM_206898.1~uORF:IOH58589	173	53	120
B36R19C15	36-15-19	Hs~MGC:BC070334.1~uORF:IOH40810	15425	54	15371
B36R19C16	36-16-19	Hs~MGC:BC070334.1~uORF:IOH40810	17880	57	17823
B36R19C17	36-17-19	Hs~Ref:NM_145176.1~uORF:IOH40813	97	81	16
B36R19C18	36-18-19	Hs~Ref:NM_145176.1~uORF:IOH40813	51	88	-37
B36R19C19	36-19-19	Hs~MGC:BC005182.1~uORF:IOH7280	65	71	-6
B36R19C20	36-20-19	Hs~MGC:BC005182.1~uORF:IOH7280	215	53	162
B36R19C21	36-21-19	Hs~Ref:NM_018124.2~uORF:IOH4130	256	53	203
B36R19C22	36-22-19	Hs~Ref:NM_018124.2~uORF:IOH4130	43	52	-9
B36R20C01	36-1-20	Hs~MGC:BC000993.2~uORF:IOH3015	255	50	205
B36R20C02	36-2-20	Hs~MGC:BC000993.2~uORF:IOH3015	61	68	-7
B36R20C03	36-3-20	Hs~MGC:BC001550.1~uORF:IOH11681	124	51	73
B36R20C04	36-4-20	Hs~MGC:BC001550.1~uORF:IOH11681	132	50	82
B36R20C05	36-5-20	Hs~MGC:BC000885.1~uORF:IOH3237	72	70	2
B36R20C06	36-6-20	Hs~MGC:BC000885.1~uORF:IOH3237	299	72	227
B36R20C07	36-7-20	Hs~Ref:NM_005517.2~uORF:IOH40568	40	42	-2
B36R20C08	36-8-20	Hs~Ref:NM_005517.2~uORF:IOH40568	39	42	-3
B36R20C09	36-9-20	Hs~MGC:BC012584.1~uORF:IOH40613	407	46	361
B36R20C10	36-10-20	Hs~MGC:BC012584.1~uORF:IOH40613	469	57	412
B36R20C11	36-11-20	Hs~MGC:BC069421.1~uORF:IOH40393	527	52	475
B36R20C12	36-12-20	Hs~MGC:BC069421.1~uORF:IOH40393	508	49	459
B36R20C13	36-13-20	Hs~Ref:NM_032563.1~uORF:IOH40397	622	48	574
B36R20C14	36-14-20	Hs~Ref:NM_032563.1~uORF:IOH40397	723	51	672
B36R20C15	36-15-20	Hs~Ref:NM_178338.2~uORF:IOH50134	1637	51	1586
B36R20C16	36-16-20	Hs~Ref:NM_178338.2~uORF:IOH50134	1619	51	1568
B36R20C17	36-17-20	Hs~Ref:NM_001003714.1~uORF:IOH50089	195	55	140
B36R20C18	36-18-20	Hs~Ref:NM_001003714.1~uORF:IOH50089	198	68	130
B36R20C19	36-19-20	Hs~Ref:NM_001002919.1~uORF:IOH50167	906	484	422
B36R20C20	36-20-20	Hs~Ref:NM_001002919.1~uORF:IOH50167	694	54	640
B36R20C21	36-21-20	Hs~Ref:ENST00000382378~uORF:IOH50135	1020	56	964
B36R20C22	36-22-20	Hs~Ref:ENST00000382378~uORF:IOH50135	1977	839	1138
B36R21C01	36-1-21	Hs~Ref:NM_206998.1~uORF:IOH50145	938	43	895
B36R21C02	36-2-21	Hs~Ref:NM_206998.1~uORF:IOH50145	1204	289	915
B36R21C03	36-3-21	Hs~Ref:NM_181285.1~uORF:IOH50177	1121	53	1068
B36R21C04	36-4-21	Hs~Ref:NM_181285.1~uORF:IOH50177	1023	48	975
B36R21C05	36-5-21	Hs~Ref:ENST00000412703~uORF:IOH50097	527	45	482
B36R21C06	36-6-21	Hs~Ref:ENST00000412703~uORF:IOH50097	467	45	422
B36R21C07	36-7-21	Hs~Ref:NM_001004722.1~uORF:IOH50143	1086	44	1042
B36R21C08	36-8-21	Hs~Ref:NM_001004722.1~uORF:IOH50143	1106	43	1063
B36R21C09	36-9-21	Hs~Ref:NP_079045.1~CAT_10794-H08H-25	39	40	-1
B36R21C10	36-10-21	Hs~Ref:NP_079045.1~CAT_10794-H08H-25	39	42	-3
B36R21C11	36-11-21	Internal_1007209	322	67	255
B36R21C12	36-12-21	Internal_1007209	308	50	258
B36R21C13	36-13-21	Hs~Ref:NP_005935.4~CAT_10886-H08H-25	47	43	4
B36R21C14	36-14-21	Hs~Ref:NP_005935.4~CAT_10886-H08H-25	43	43	0
B36R21C15	36-15-21	Internal_1007209	109	46	63
B36R21C16	36-16-21	Internal_1007209	1665	56	1609
B36R21C17	36-17-21	Hs~Ref:NP_003318.1~CAT_10481-H08H-25	114	79	35
B36R21C18	36-18-21	Hs~Ref:NP_003318.1~CAT_10481-H08H-25	52	52	0
B36R21C19	36-19-21	Internal_1007209	46	52	-6
B36R21C20	36-20-21	Internal_1007209	52	45	7
B36R21C21	36-21-21	Internal_1007209	45	44	1
B36R21C22	36-22-21	Internal_1007209	43	43	0
B36R22C01	36-1-22	ERa~N/A	2569	40	2529
B36R22C02	36-2-22	ERa~N/A	2735	42	2693
B36R22C03	36-3-22	PKCeta~N/A	209	42	167
B36R22C04	36-4-22	PKCeta~N/A	309	50	259
B36R22C05	36-5-22	Calmodulin~N/A	76	48	28
B36R22C06	36-6-22	Calmodulin~N/A	56	41	15
B36R22C07	36-7-22	V5control5~N/A	450	64	386
B36R22C08	36-8-22	V5control5~N/A	402	99	303
B36R22C09	36-9-22	V5control4~N/A	89	43	46
B36R22C10	36-10-22	V5control4~N/A	111	90	21
B36R22C11	36-11-22	V5control3~N/A	66	43	23
B36R22C12	36-12-22	V5control3~N/A	69	42	27
B36R22C13	36-13-22	V5control2~N/A	59	41	18
B36R22C14	36-14-22	V5control2~N/A	45	43	2
B36R22C15	36-15-22	V5control1~N/A	49	46	3
B36R22C16	36-16-22	V5control1~N/A	1638	73	1565
B36R22C17	36-17-22	CMK2A~N/A	1936	66	1870
B36R22C18	36-18-22	CMK2A~N/A	715	51	664
B36R22C19	36-19-22	ERa~N/A	1981	46	1935
B36R22C20	36-20-22	ERa~N/A	2239	46	2193
B36R22C21	36-21-22	AlexaAntiMouseAb~N/A	8175	45	8130
B36R22C22	36-22-22	AlexaAntiMouseAb~N/A	8496	50	8446
B37R01C01	37-1-1	AlexaAntiMouseAb~N/A	27996	43	27953
B37R01C02	37-2-1	AlexaAntiMouseAb~N/A	26386	46	26340
B37R01C03	37-3-1	ERa~N/A	1725	41	1684
B37R01C04	37-4-1	ERa~N/A	1525	41	1484
B37R01C05	37-5-1	HumanIgG1~N/A	999	41	958
B37R01C06	37-6-1	HumanIgG1~N/A	1019	41	978
B37R01C07	37-7-1	HumanIgG2~N/A	2524	39	2485
B37R01C08	37-8-1	HumanIgG2~N/A	2384	39	2345
B37R01C09	37-9-1	HumanIgG3~N/A	13649	39	13610
B37R01C10	37-10-1	HumanIgG3~N/A	13929	39	13890
B37R01C11	37-11-1	HumanIgG4~N/A	35309	42	35267
B37R01C12	37-12-1	HumanIgG4~N/A	34919	39	34880
B37R01C13	37-13-1	BiotinAb~N/A	418	35	383
B37R01C14	37-14-1	BiotinAb~N/A	375	35	340
B37R01C15	37-15-1	RanBP2deltaFG~N/A	361	36	325
B37R01C16	37-16-1	RanBP2deltaFG~N/A	382	36	346
B37R01C17	37-17-1	hMDM2~N/A	959	36	923
B37R01C18	37-18-1	hMDM2~N/A	977	36	941
B37R01C19	37-19-1	PKCeta~N/A	943	36	907
B37R01C20	37-20-1	PKCeta~N/A	1019	41	978
B37R01C21	37-21-1	AlexaAntiMouseAb~N/A	31225	51	31174
B37R01C22	37-22-1	AlexaAntiMouseAb~N/A	41834	51	41783
B37R02C01	37-1-2	PKCeta~N/A	1488	50	1438
B37R02C02	37-2-2	PKCeta~N/A	1705	61	1644
B37R02C03	37-3-2	Buffer	694	64	630
B37R02C04	37-4-2	Buffer	770	50	720
B37R02C05	37-5-2	HumanIgA~N/A	18690	46	18644
B37R02C06	37-6-2	HumanIgA~N/A	20351	44	20307
B37R02C07	37-7-2	Buffer	311	167	144
B37R02C08	37-8-2	Buffer	254	40	214
B37R02C09	37-9-2	BSA~N/A	10723	40	10683
B37R02C10	37-10-2	BSA~N/A	11228	44	11184
B37R02C11	37-11-2	Hs~Ref:NM_012094.3~uORF:IOH42322	477	144	333
B37R02C12	37-12-2	Hs~Ref:NM_012094.3~uORF:IOH42322	438	49	389
B37R02C13	37-13-2	Hs~Ref:NM_080414.1~uORF:IOH42243	544	37	507
B37R02C14	37-14-2	Hs~Ref:NM_080414.1~uORF:IOH42243	507	39	468
B37R02C15	37-15-2	Hs~Ref:NM_002484.1~uORF:IOH41188	283	121	162
B37R02C16	37-16-2	Hs~Ref:NM_002484.1~uORF:IOH41188	198	44	154
B37R02C17	37-17-2	Hs~Ref:NM_032237.2~uORF:IOH42245	462	42	420
B37R02C18	37-18-2	Hs~Ref:NM_032237.2~uORF:IOH42245	440	41	399
B37R02C19	37-19-2	Hs~Ref:XM_373573.2~uORF:IOH44770	321	39	282
B37R02C20	37-20-2	Hs~Ref:XM_373573.2~uORF:IOH44770	185	44	141
B37R02C21	37-21-2	Hs~Ref:NM_001018116.1~uORF:IOH42980	904	57	847
B37R02C22	37-22-2	Hs~Ref:NM_001018116.1~uORF:IOH42980	826	53	773
B37R03C01	37-1-3	Hs~Ref:XM_378462.2~uORF:IOH41559	4950	52	4898
B37R03C02	37-2-3	Hs~Ref:XM_378462.2~uORF:IOH41559	5112	57	5055
B37R03C03	37-3-3	Hs~Ref:NM_033671.1~uORF:IOH43039	8441	71	8370
B37R03C04	37-4-3	Hs~Ref:NM_033671.1~uORF:IOH43039	8250	63	8187
B37R03C05	37-5-3	Hs~MGC:BC018953.1~uORF:IOH13650	621	88	533
B37R03C06	37-6-3	Hs~MGC:BC018953.1~uORF:IOH13650	254	46	208
B37R03C07	37-7-3	Hs~MGC:BC013687.1~uORF:IOH10463	605	273	332
B37R03C08	37-8-3	Hs~MGC:BC013687.1~uORF:IOH10463	648	43	605
B37R03C09	37-9-3	Hs~Ref:NM_004102.2~uORF:IOH7163	282	49	233
B37R03C10	37-10-3	Hs~Ref:NM_004102.2~uORF:IOH7163	273	54	219
B37R03C11	37-11-3	Hs~Ref:NM_015878.2~uORF:IOH12717	1224	57	1167
B37R03C12	37-12-3	Hs~Ref:NM_015878.2~uORF:IOH12717	1131	50	1081
B37R03C13	37-13-3	Hs~MGC:BC007639.1~uORF:IOH6968	439	38	401
B37R03C14	37-14-3	Hs~MGC:BC007639.1~uORF:IOH6968	415	41	374
B37R03C15	37-15-3	Hs~MGC:NM_152773.2~uORF:IOH11669	414	176	238
B37R03C16	37-16-3	Hs~MGC:NM_152773.2~uORF:IOH11669	214	49	165
B37R03C17	37-17-3	Hs~Ref:NM_032308.1~uORF:IOH5031	222	50	172
B37R03C18	37-18-3	Hs~Ref:NM_032308.1~uORF:IOH5031	226	47	179
B37R03C19	37-19-3	Hs~MGC:BC005319.1~uORF:IOH7353	318	43	275
B37R03C20	37-20-3	Hs~MGC:BC005319.1~uORF:IOH7353	899	80	819
B37R03C21	37-21-3	Hs~MGC:BC004967.1~uORF:IOH4830	372	294	78
B37R03C22	37-22-3	Hs~MGC:BC004967.1~uORF:IOH4830	504	88	416
B37R04C01	37-1-4	Hs~MGC:BC007347.2~uORF:IOH5863	1095	40	1055
B37R04C02	37-2-4	Hs~MGC:BC007347.2~uORF:IOH5863	1074	41	1033
B37R04C03	37-3-4	Hs~MGC:BC008344.1~uORF:IOH6969	168	43	125
B37R04C04	37-4-4	Hs~MGC:BC008344.1~uORF:IOH6969	149	47	102
B37R04C05	37-5-4	Hs~Ref:NM_000483.2~uORF:IOH1565	101	50	51
B37R04C06	37-6-4	Hs~Ref:NM_000483.2~uORF:IOH1565	90	49	41
B37R04C07	37-7-4	Hs~MGC:BC020750.1~uORF:IOH14535	196	48	148
B37R04C08	37-8-4	Hs~MGC:BC020750.1~uORF:IOH14535	142	55	87
B37R04C09	37-9-4	Hs~Ref:NM_024736.2~uORF:IOH7017	308	45	263
B37R04C10	37-10-4	Hs~Ref:NM_024736.2~uORF:IOH7017	381	256	125
B37R04C11	37-11-4	Hs~MGC:BC017504.1~uORF:IOH12256	255	66	189
B37R04C12	37-12-4	Hs~MGC:BC017504.1~uORF:IOH12256	454	96	358
B37R04C13	37-13-4	Hs~MGC:BC005270.1~uORF:IOH7330	553	40	513
B37R04C14	37-14-4	Hs~MGC:BC005270.1~uORF:IOH7330	571	38	533
B37R04C15	37-15-4	Hs~MGC:BC004888.2~uORF:IOH5668	466	41	425
B37R04C16	37-16-4	Hs~MGC:BC004888.2~uORF:IOH5668	420	41	379
B37R04C17	37-17-4	Hs~Ref:NM_024322.1~uORF:IOH5713	465	43	422
B37R04C18	37-18-4	Hs~Ref:NM_024322.1~uORF:IOH5713	461	42	419
B37R04C19	37-19-4	Hs~Ref:NM_003801.2~uORF:IOH4597	542	47	495
B37R04C20	37-20-4	Hs~Ref:NM_003801.2~uORF:IOH4597	255	50	205
B37R04C21	37-21-4	Hs~Ref:NM_032704.1~uORF:IOH5513	262	59	203
B37R04C22	37-22-4	Hs~Ref:NM_032704.1~uORF:IOH5513	404	112	292
B37R05C01	37-1-5	Hs~Ref:NM_013246.1~uORF:IOH11263	1458	40	1418
B37R05C02	37-2-5	Hs~Ref:NM_013246.1~uORF:IOH11263	1429	42	1387
B37R05C03	37-3-5	Hs~MGC:BC019337.1~uORF:IOH12297	57947	45	57902
B37R05C04	37-4-5	Hs~MGC:BC019337.1~uORF:IOH12297	58722	45	58677
B37R05C05	37-5-5	Hs~Ref:NM_003986.1~uORF:IOH12345	689	46	643
B37R05C06	37-6-5	Hs~Ref:NM_003986.1~uORF:IOH12345	691	46	645
B37R05C07	37-7-5	Hs~MGC:BC010901.1~uORF:IOH13498	273	48	225
B37R05C08	37-8-5	Hs~MGC:BC010901.1~uORF:IOH13498	257	51	206
B37R05C09	37-9-5	Hs~MGC:BC026362.1~uORF:IOH11217	341	45	296
B37R05C10	37-10-5	Hs~MGC:BC026362.1~uORF:IOH11217	470	44	426
B37R05C11	37-11-5	Hs~Ref:NM_018282.1~uORF:IOH12080	38	36	2
B37R05C12	37-12-5	Hs~Ref:NM_018282.1~uORF:IOH12080	68	42	26
B37R05C13	37-13-5	Hs~MGC:BC050614.1~uORF:IOH27013	201	40	161
B37R05C14	37-14-5	Hs~MGC:BC050614.1~uORF:IOH27013	310	174	136
B37R05C15	37-15-5	Hs~MGC:BC047567.1~uORF:IOH26429	533	41	492
B37R05C16	37-16-5	Hs~MGC:BC047567.1~uORF:IOH26429	553	46	507
B37R05C17	37-17-5	Hs~MGC:BC009308.1~uORF:IOH13455	570	63	507
B37R05C18	37-18-5	Hs~MGC:BC009308.1~uORF:IOH13455	468	48	420
B37R05C19	37-19-5	Hs~Ref:NM_005253.1~uORF:IOH13117	305	52	253
B37R05C20	37-20-5	Hs~Ref:NM_005253.1~uORF:IOH13117	6441	210	6231
B37R05C21	37-21-5	Hs~MGC:BC000526.1~uORF:IOH3637	157	105	52
B37R05C22	37-22-5	Hs~MGC:BC000526.1~uORF:IOH3637	176	113	63
B37R06C01	37-1-6	Hs~Ref:NM_006263.1~uORF:IOH3647	257	46	211
B37R06C02	37-2-6	Hs~Ref:NM_006263.1~uORF:IOH3647	238	48	190
B37R06C03	37-3-6	Hs~Ref:NM_203457.1~uORF:IOH45842	1535	46	1489
B37R06C04	37-4-6	Hs~Ref:NM_203457.1~uORF:IOH45842	1542	44	1498
B37R06C05	37-5-6	Hs~Ref:NM_001006615.1~uORF:IOH45776	142	42	100
B37R06C06	37-6-6	Hs~Ref:NM_001006615.1~uORF:IOH45776	120	41	79
B37R06C07	37-7-6	Hs~Ref:NM_177953.1~uORF:IOH45824	148	41	107
B37R06C08	37-8-6	Hs~Ref:NM_177953.1~uORF:IOH45824	129	44	85
B37R06C09	37-9-6	Hs~Ref:NM_006903.3~uORF:IOH45750	279	85	194
B37R06C10	37-10-6	Hs~Ref:NM_006903.3~uORF:IOH45750	243	48	195
B37R06C11	37-11-6	Hs~Ref:NM_004470.2~uORF:IOH2972	441	41	400
B37R06C12	37-12-6	Hs~Ref:NM_004470.2~uORF:IOH2972	519	51	468
B37R06C13	37-13-6	Hs~MGC:BC004226.1~uORF:IOH22896	502	64	438
B37R06C14	37-14-6	Hs~MGC:BC004226.1~uORF:IOH22896	626	65	561
B37R06C15	37-15-6	Hs~MGC:BC032466.1~uORF:IOH21695	2612	46	2566
B37R06C16	37-16-6	Hs~MGC:BC032466.1~uORF:IOH21695	2931	45	2886
B37R06C17	37-17-6	Hs~MGC:BC031650.1~uORF:IOH22742	38765	53	38712
B37R06C18	37-18-6	Hs~MGC:BC031650.1~uORF:IOH22742	38127	47	38080
B37R06C19	37-19-6	Hs~Ref:NM_001002756.1~uORF:IOH58634	224	51	173
B37R06C20	37-20-6	Hs~Ref:NM_001002756.1~uORF:IOH58634	228	81	147
B37R06C21	37-21-6	Hs~Ref:NM_024667.1~uORF:IOH56912	443	222	221
B37R06C22	37-22-6	Hs~Ref:NM_024667.1~uORF:IOH56912	371	74	297
B37R07C01	37-1-7	Hs~Ref:NM_001008211.1~uORF:IOH57143	282	41	241
B37R07C02	37-2-7	Hs~Ref:NM_001008211.1~uORF:IOH57143	264	47	217
B37R07C03	37-3-7	Hs~Ref:NM_000314.3~uORF:IOH56926	716	46	670
B37R07C04	37-4-7	Hs~Ref:NM_000314.3~uORF:IOH56926	350	45	305
B37R07C05	37-5-7	Hs~Ref:NM_016282.2~uORF:IOH11046	266	45	221
B37R07C06	37-6-7	Hs~Ref:NM_016282.2~uORF:IOH11046	222	45	177
B37R07C07	37-7-7	Hs~Ref:NM_145025.1~uORF:IOH10918	111	42	69
B37R07C08	37-8-7	Hs~Ref:NM_145025.1~uORF:IOH10918	210	55	155
B37R07C09	37-9-7	Hs~MGC:BC020221.1~uORF:IOH13291	346	49	297
B37R07C10	37-10-7	Hs~MGC:BC020221.1~uORF:IOH13291	337	47	290
B37R07C11	37-11-7	Hs~Ref:NM_001625.1~uORF:IOH14360	279	113	166
B37R07C12	37-12-7	Hs~Ref:NM_001625.1~uORF:IOH14360	198	72	126
B37R07C13	37-13-7	Hs~Ref:NM_000723.3~uORF:IOH39502	3237	75	3162
B37R07C14	37-14-7	Hs~Ref:NM_000723.3~uORF:IOH39502	3046	55	2991
B37R07C15	37-15-7	Hs~Ref:NM_001686.3~uORF:IOH11843	627	43	584
B37R07C16	37-16-7	Hs~Ref:NM_001686.3~uORF:IOH11843	589	41	548
B37R07C17	37-17-7	Hs~MGC:BC028301.1~uORF:IOH11759	664	39	625
B37R07C18	37-18-7	Hs~MGC:BC028301.1~uORF:IOH11759	623	41	582
B37R07C19	37-19-7	Hs~MGC:BC025784.2~uORF:IOH11964	377	72	305
B37R07C20	37-20-7	Hs~MGC:BC025784.2~uORF:IOH11964	85	70	15
B37R07C21	37-21-7	Hs~Ref:NM_002756.2~N/A	598	79	519
B37R07C22	37-22-7	Hs~Ref:NM_002756.2~N/A	597	52	545
B37R08C01	37-1-8	Hs~Ref:NM_001204.3~N/A	720	39	681
B37R08C02	37-2-8	Hs~Ref:NM_001204.3~N/A	794	44	750
B37R08C03	37-3-8	Hs~Ref:NM_001982.1~N/A	570	180	390
B37R08C04	37-4-8	Hs~Ref:NM_001982.1~N/A	484	50	434
B37R08C05	37-5-8	Hs~Ref:NM_001259.2~N/A	472	50	422
B37R08C06	37-6-8	Hs~Ref:NM_001259.2~N/A	542	54	488
B37R08C07	37-7-8	Hs~MGC:NM_015381.1~uORF:IOH25888	455	45	410
B37R08C08	37-8-8	Hs~MGC:NM_015381.1~uORF:IOH25888	534	64	470
B37R08C09	37-9-8	Hs~MGC:BC018080.1~uORF:IOH26802	848	96	752
B37R08C10	37-10-8	Hs~MGC:BC018080.1~uORF:IOH26802	790	67	723
B37R08C11	37-11-8	Hs~MGC:BC039172.1~uORF:IOH25808	454	145	309
B37R08C12	37-12-8	Hs~MGC:BC039172.1~uORF:IOH25808	338	115	223
B37R08C13	37-13-8	Hs~MGC:NM_174889.2~uORF:IOH25846	1025	70	955
B37R08C14	37-14-8	Hs~MGC:NM_174889.2~uORF:IOH25846	995	51	944
B37R08C15	37-15-8	Hs~Ref:NM_005024.1~uORF:IOH35680	729	41	688
B37R08C16	37-16-8	Hs~Ref:NM_005024.1~uORF:IOH35680	724	38	686
B37R08C17	37-17-8	Hs~Ref:NM_006217.2~uORF:IOH11838	672	41	631
B37R08C18	37-18-8	Hs~Ref:NM_006217.2~uORF:IOH11838	658	41	617
B37R08C19	37-19-8	Hs~Ref:NM_000987.2~uORF:IOH45675	2996	50	2946
B37R08C20	37-20-8	Hs~Ref:NM_000987.2~uORF:IOH45675	3012	60	2952
B37R08C21	37-21-8	Hs~MGC:NM_172159.2~uORF:IOH25842	16981	56	16925
B37R08C22	37-22-8	Hs~MGC:NM_172159.2~uORF:IOH25842	18669	53	18616
B37R09C01	37-1-9	Hs~Ref:NM_025243.2~uORF:IOH22813	60	40	20
B37R09C02	37-2-9	Hs~Ref:NM_025243.2~uORF:IOH22813	127	38	89
B37R09C03	37-3-9	Hs~Ref:NM_138612.1~uORF:IOH11074	607	191	416
B37R09C04	37-4-9	Hs~Ref:NM_138612.1~uORF:IOH11074	507	58	449
B37R09C05	37-5-9	Hs~Ref:NM_016823.2~uORF:IOH3182	226	46	180
B37R09C06	37-6-9	Hs~Ref:NM_016823.2~uORF:IOH3182	221	50	171
B37R09C07	37-7-9	Hs~MGC:BC000132.2~uORF:IOH2877	372	44	328
B37R09C08	37-8-9	Hs~MGC:BC000132.2~uORF:IOH2877	513	70	443
B37R09C09	37-9-9	Hs~MGC:BC001327.1~uORF:IOH3125	1757	138	1619
B37R09C10	37-10-9	Hs~MGC:BC001327.1~uORF:IOH3125	1628	56	1572
B37R09C11	37-11-9	Hs~Ref:NM_032662.1~uORF:IOH5669	279	52	227
B37R09C12	37-12-9	Hs~Ref:NM_032662.1~uORF:IOH5669	268	77	191
B37R09C13	37-13-9	Hs~MGC:BC003549.1~uORF:IOH4987	2856	68	2788
B37R09C14	37-14-9	Hs~MGC:BC003549.1~uORF:IOH4987	2827	44	2783
B37R09C15	37-15-9	Hs~MGC:BC004985.1~uORF:IOH6071	142	38	104
B37R09C16	37-16-9	Hs~MGC:BC004985.1~uORF:IOH6071	141	38	103
B37R09C17	37-17-9	Hs~Ref:NM_080588.1~uORF:IOH46132	2886	39	2847
B37R09C18	37-18-9	Hs~Ref:NM_080588.1~uORF:IOH46132	2821	40	2781
B37R09C19	37-19-9	Hs~MGC:BC028348.2~uORF:IOH46079	414	48	366
B37R09C20	37-20-9	Hs~MGC:BC028348.2~uORF:IOH46079	572	379	193
B37R09C21	37-21-9	Hs~Ref:NM_004728.2~uORF:IOH46173	6629	56	6573
B37R09C22	37-22-9	Hs~Ref:NM_004728.2~uORF:IOH46173	6404	51	6353
B37R10C01	37-1-10	Hs~Ref:NM_032284.2~uORF:IOH46080	248	40	208
B37R10C02	37-2-10	Hs~Ref:NM_032284.2~uORF:IOH46080	1010	240	770
B37R10C03	37-3-10	Hs~MGC:BC062688.1~uORF:IOH40726	477	45	432
B37R10C04	37-4-10	Hs~MGC:BC062688.1~uORF:IOH40726	459	269	190
B37R10C05	37-5-10	Hs~Ref:NM_053067.1~uORF:IOH40632	89	50	39
B37R10C06	37-6-10	Hs~Ref:NM_053067.1~uORF:IOH40632	113	62	51
B37R10C07	37-7-10	Hs~Ref:NM_033293.1~uORF:IOH40681	199	46	153
B37R10C08	37-8-10	Hs~Ref:NM_033293.1~uORF:IOH40681	422	49	373
B37R10C09	37-9-10	Hs~Ref:NM_001322.2~uORF:IOH40727	634	43	591
B37R10C10	37-10-10	Hs~Ref:NM_001322.2~uORF:IOH40727	630	42	588
B37R10C11	37-11-10	GST1	45	41	4
B37R10C12	37-12-10	GST1	47	42	5
B37R10C13	37-13-10	GST2	46	40	6
B37R10C14	37-14-10	GST2	45	39	6
B37R10C15	37-15-10	GST3	48	39	9
B37R10C16	37-16-10	GST3	46	38	8
B37R10C17	37-17-10	GST4	57	35	22
B37R10C18	37-18-10	GST4	64	36	28
B37R10C19	37-19-10	Anti-HumanIgA1~N/A	8932	39	8893
B37R10C20	37-20-10	Anti-HumanIgA1~N/A	9144	46	9098
B37R10C21	37-21-10	Anti-HumanIgA2~N/A	20348	58	20290
B37R10C22	37-22-10	Anti-HumanIgA2~N/A	20132	56	20076
B37R11C01	37-1-11	AlexaAntiMouseAb~N/A	20384	41	20343
B37R11C02	37-2-11	AlexaAntiMouseAb~N/A	17270	39	17231
B37R11C03	37-3-11	MAPKAP~N/A	69	37	32
B37R11C04	37-4-11	MAPKAP~N/A	65	40	25
B37R11C05	37-5-11	Buffer	630	40	590
B37R11C06	37-6-11	Buffer	714	56	658
B37R11C07	37-7-11	BSA~N/A	8559	81	8478
B37R11C08	37-8-11	BSA~N/A	9143	54	9089
B37R11C09	37-9-11	Anti-HumanIgG1~N/A	1555	44	1511
B37R11C10	37-10-11	Anti-HumanIgG1~N/A	1616	43	1573
B37R11C11	37-11-11	Anti-HumanIgG2~N/A	3026	43	2983
B37R11C12	37-12-11	Anti-HumanIgG2~N/A	3120	44	3076
B37R11C13	37-13-11	Anti-HumanIgG3~N/A	5752	42	5710
B37R11C14	37-14-11	Anti-HumanIgG3~N/A	5520	42	5478
B37R11C15	37-15-11	Anti-HumanIgG4~N/A	10669	43	10626
B37R11C16	37-16-11	Anti-HumanIgG4~N/A	10576	40	10536
B37R11C17	37-17-11	AntiBiotinAb~N/A	12604	37	12567
B37R11C18	37-18-11	AntiBiotinAb~N/A	12864	37	12827
B37R11C19	37-19-11	Buffer	80	37	43
B37R11C20	37-20-11	Buffer	87	42	45
B37R11C21	37-21-11	Hs~Ref:NM_003348.3~uORF:IOH3538	368	91	277
B37R11C22	37-22-11	Hs~Ref:NM_003348.3~uORF:IOH3538	59	203	-144
B37R12C01	37-1-12	Hs~Ref:NM_024296.2~uORF:IOH4214	40	51	-11
B37R12C02	37-2-12	Hs~Ref:NM_024296.2~uORF:IOH4214	142	39	103
B37R12C03	37-3-12	Hs~Ref:NM_000712.3~uORF:IOH7401	459	39	420
B37R12C04	37-4-12	Hs~Ref:NM_000712.3~uORF:IOH7401	447	39	408
B37R12C05	37-5-12	Hs~Ref:NM_016059.3~uORF:IOH4932	742	37	705
B37R12C06	37-6-12	Hs~Ref:NM_016059.3~uORF:IOH4932	779	44	735
B37R12C07	37-7-12	Hs~MGC:NM_021218.1~uORF:IOH10009	1188	120	1068
B37R12C08	37-8-12	Hs~MGC:NM_021218.1~uORF:IOH10009	1185	63	1122
B37R12C09	37-9-12	Hs~Ref:NM_005423.1~uORF:IOH21844	288	170	118
B37R12C10	37-10-12	Hs~Ref:NM_005423.1~uORF:IOH21844	312	57	255
B37R12C11	37-11-12	Hs~Ref:NM_145028.1~uORF:IOH22492	394	47	347
B37R12C12	37-12-12	Hs~Ref:NM_145028.1~uORF:IOH22492	433	49	384
B37R12C13	37-13-12	Hs~Ref:NM_005641.2~uORF:IOH11381	626	46	580
B37R12C14	37-14-12	Hs~Ref:NM_005641.2~uORF:IOH11381	653	44	609
B37R12C15	37-15-12	Hs~Ref:NM_181294.1~uORF:IOH50058	892	42	850
B37R12C16	37-16-12	Hs~Ref:NM_181294.1~uORF:IOH50058	881	41	840
B37R12C17	37-17-12	Hs~Ref:NM_152724.2~uORF:IOH45576	785	39	746
B37R12C18	37-18-12	Hs~Ref:NM_152724.2~uORF:IOH45576	813	39	774
B37R12C19	37-19-12	Hs~MGC:NM_174922.3~uORF:IOH44655	907	40	867
B37R12C20	37-20-12	Hs~MGC:NM_174922.3~uORF:IOH44655	995	64	931
B37R12C21	37-21-12	Hs~Ref:XM_085833.5~uORF:IOH43266	5230	74	5156
B37R12C22	37-22-12	Hs~Ref:XM_085833.5~uORF:IOH43266	4898	64	4834
B37R13C01	37-1-13	Hs~MGC:BC038976.1~uORF:IOH28763	129	71	58
B37R13C02	37-2-13	Hs~MGC:BC038976.1~uORF:IOH28763	138	44	94
B37R13C03	37-3-13	Hs~MGC:BC053582.1~uORF:IOH28938	145	38	107
B37R13C04	37-4-13	Hs~MGC:BC053582.1~uORF:IOH28938	115	38	77
B37R13C05	37-5-13	Hs~MGC:BC040546.1~uORF:IOH28687	112	36	76
B37R13C06	37-6-13	Hs~MGC:BC040546.1~uORF:IOH28687	149	41	108
B37R13C07	37-7-13	Hs~Ref:NM_000367.1~uORF:IOH27812	531	41	490
B37R13C08	37-8-13	Hs~Ref:NM_000367.1~uORF:IOH27812	526	40	486
B37R13C09	37-9-13	Hs~MGC:BC009078.1~uORF:IOH3357	529	43	486
B37R13C10	37-10-13	Hs~MGC:BC009078.1~uORF:IOH3357	607	46	561
B37R13C11	37-11-13	Hs~Ref:NM_181801.1~uORF:IOH45863	200	50	150
B37R13C12	37-12-13	Hs~Ref:NM_181801.1~uORF:IOH45863	407	52	355
B37R13C13	37-13-13	Hs~Ref:NM_021824.2~uORF:IOH45864	419	48	371
B37R13C14	37-14-13	Hs~Ref:NM_021824.2~uORF:IOH45864	492	47	445
B37R13C15	37-15-13	Hs~Ref:NM_203430.1~uORF:IOH45825	110	49	61
B37R13C16	37-16-13	Hs~Ref:NM_203430.1~uORF:IOH45825	107	49	58
B37R13C17	37-17-13	Hs~MGC:BC011941.2~uORF:IOH13067	282	49	233
B37R13C18	37-18-13	Hs~MGC:BC011941.2~uORF:IOH13067	290	52	238
B37R13C19	37-19-13	Hs~MGC:BC018630.1~uORF:IOH12072	672	54	618
B37R13C20	37-20-13	Hs~MGC:BC018630.1~uORF:IOH12072	185	71	114
B37R13C21	37-21-13	Hs~MGC:BC016992.1~uORF:IOH11870	312	64	248
B37R13C22	37-22-13	Hs~MGC:BC016992.1~uORF:IOH11870	515	147	368
B37R14C01	37-1-14	Hs~MGC:BC020712.1~uORF:IOH13788	614	43	571
B37R14C02	37-2-14	Hs~MGC:BC020712.1~uORF:IOH13788	709	42	667
B37R14C03	37-3-14	Hs~Ref:NM_016011.2~uORF:IOH53949	6177	41	6136
B37R14C04	37-4-14	Hs~Ref:NM_016011.2~uORF:IOH53949	6292	39	6253
B37R14C05	37-5-14	Hs~Ref:NM_006568.2~uORF:IOH53926	108	37	71
B37R14C06	37-6-14	Hs~Ref:NM_006568.2~uORF:IOH53926	215	61	154
B37R14C07	37-7-14	Hs~Ref:NM_182717.1~uORF:IOH58667	203	54	149
B37R14C08	37-8-14	Hs~Ref:NM_182717.1~uORF:IOH58667	447	42	405
B37R14C09	37-9-14	Hs~Ref:NM_001912.2~uORF:IOH53927	579	112	467
B37R14C10	37-10-14	Hs~Ref:NM_001912.2~uORF:IOH53927	401	59	342
B37R14C11	37-11-14	Hs~Ref:NM_005109.1~uORF:IOH21155	897	57	840
B37R14C12	37-12-14	Hs~Ref:NM_005109.1~uORF:IOH21155	960	53	907
B37R14C13	37-13-14	Hs~MGC:NM_178588.1~uORF:IOH13592	344	46	298
B37R14C14	37-14-14	Hs~MGC:NM_178588.1~uORF:IOH13592	341	49	292
B37R14C15	37-15-14	Hs~Ref:NM_021131.1~uORF:IOH4040	291	50	241
B37R14C16	37-16-14	Hs~Ref:NM_021131.1~uORF:IOH4040	348	48	300
B37R14C17	37-17-14	Hs~Ref:NM_001791.2~uORF:IOH10262	155	41	114
B37R14C18	37-18-14	Hs~Ref:NM_001791.2~uORF:IOH10262	174	40	134
B37R14C19	37-19-14	Hs~MGC:BC067091.1~uORF:IOH62840	58883	50	58833
B37R14C20	37-20-14	Hs~MGC:BC067091.1~uORF:IOH62840	65535	65	65470
B37R14C21	37-21-14	Hs~MGC:BC036511.1~uORF:IOH62268	1078	60	1018
B37R14C22	37-22-14	Hs~MGC:BC036511.1~uORF:IOH62268	1036	55	981
B37R15C01	37-1-15	Hs~MGC:BC041345.1~uORF:IOH62289	222	37	185
B37R15C02	37-2-15	Hs~MGC:BC041345.1~uORF:IOH62289	214	40	174
B37R15C03	37-3-15	Hs~MGC:BC073759.1~uORF:IOH63088	118	52	66
B37R15C04	37-4-15	Hs~MGC:BC073759.1~uORF:IOH63088	377	58	319
B37R15C05	37-5-15	Hs~MGC:BC000177.2~uORF:IOH2886	324	39	285
B37R15C06	37-6-15	Hs~MGC:BC000177.2~uORF:IOH2886	318	39	279
B37R15C07	37-7-15	Hs~MGC:BC016634.1~uORF:IOH28617	407	38	369
B37R15C08	37-8-15	Hs~MGC:BC016634.1~uORF:IOH28617	425	37	388
B37R15C09	37-9-15	Hs~MGC:BC060773.1~uORF:IOH29187	2911	38	2873
B37R15C10	37-10-15	Hs~MGC:BC060773.1~uORF:IOH29187	2869	42	2827
B37R15C11	37-11-15	Hs~MGC:BC021739.1~uORF:IOH28646	647	53	594
B37R15C12	37-12-15	Hs~MGC:BC021739.1~uORF:IOH28646	649	47	602
B37R15C13	37-13-15	Hs~IVGN:PM_2144~Ext:TRANSGLUTAMINASE~N/A	52	42	10
B37R15C14	37-14-15	Hs~IVGN:PM_2144~Ext:TRANSGLUTAMINASE~N/A	54	45	9
B37R15C15	37-15-15	Hs~Ref:NM_001556.1~CAT:PV3836	266	47	219
B37R15C16	37-16-15	Hs~Ref:NM_001556.1~CAT:PV3836	231	163	68
B37R15C17	37-17-15	Hs~Ref:NM_013254.2~CAT:PV3504	420	41	379
B37R15C18	37-18-15	Hs~Ref:NM_013254.2~CAT:PV3504	423	39	384
B37R15C19	37-19-15	Hs~Ref:AAH59394~CAT:P2907	162	43	119
B37R15C20	37-20-15	Hs~Ref:AAH59394~CAT:P2907	494	59	435
B37R15C21	37-21-15	Hs~Ref:NM_005211.1~CAT:PV3249	508	56	452
B37R15C22	37-22-15	Hs~Ref:NM_005211.1~CAT:PV3249	484	48	436
B37R16C01	37-1-16	Hs~Ref:NM_001396.2~CAT:PV3785	1310	39	1271
B37R16C02	37-2-16	Hs~Ref:NM_001396.2~CAT:PV3785	1180	39	1141
B37R16C03	37-3-16	Hs~Ref:NM_000376.1~CAT:PV4552	102	36	66
B37R16C04	37-4-16	Hs~Ref:NM_000376.1~CAT:PV4552	180	50	130
B37R16C05	37-5-16	Hs~Ref:NM_001105.2~CAT:PV4877	243	116	127
B37R16C06	37-6-16	Hs~Ref:NM_001105.2~CAT:PV4877	238	48	190
B37R16C07	37-7-16	Hs~Ref:NM_022135.2~uORF:IOH26334	492	37	455
B37R16C08	37-8-16	Hs~Ref:NM_022135.2~uORF:IOH26334	496	36	460
B37R16C09	37-9-16	Hs~Ref:NM_152328.3~uORF:IOH26952	683	36	647
B37R16C10	37-10-16	Hs~Ref:NM_152328.3~uORF:IOH26952	735	38	697
B37R16C11	37-11-16	Hs~MGC:BC046163.1~uORF:IOH28869	503	44	459
B37R16C12	37-12-16	Hs~MGC:BC046163.1~uORF:IOH28869	478	45	433
B37R16C13	37-13-16	Hs~Ref:NM_021640.2~uORF:IOH28884	415	43	372
B37R16C14	37-14-16	Hs~Ref:NM_021640.2~uORF:IOH28884	418	52	366
B37R16C15	37-15-16	Hs~MGC:BC059384.1~uORF:IOH29284	364	65	299
B37R16C16	37-16-16	Hs~MGC:BC059384.1~uORF:IOH29284	440	60	380
B37R16C17	37-17-16	Hs~MGC:BC053901.1~uORF:IOH29032	835	43	792
B37R16C18	37-18-16	Hs~MGC:BC053901.1~uORF:IOH29032	850	44	806
B37R16C19	37-19-16	Hs~Ref:NM_002190.1~uORF:IOH29641	276	50	226
B37R16C20	37-20-16	Hs~Ref:NM_002190.1~uORF:IOH29641	423	110	313
B37R16C21	37-21-16	Hs~MGC:BC053675.1~uORF:IOH29030	484	62	422
B37R16C22	37-22-16	Hs~MGC:BC053675.1~uORF:IOH29030	416	52	364
B37R17C01	37-1-17	Hs~MGC:BC067848.1~uORF:IOH61625	48	40	8
B37R17C02	37-2-17	Hs~MGC:BC067848.1~uORF:IOH61625	42	57	-15
B37R17C03	37-3-17	Hs~MGC:BC016841.1~uORF:IOH10737	594	37	557
B37R17C04	37-4-17	Hs~MGC:BC016841.1~uORF:IOH10737	560	37	523
B37R17C05	37-5-17	Hs~MGC:BC028935.1~uORF:IOH22836	659	36	623
B37R17C06	37-6-17	Hs~MGC:BC028935.1~uORF:IOH22836	635	38	597
B37R17C07	37-7-17	Hs~MGC:BC033734.1~uORF:IOH21809	543	37	506
B37R17C08	37-8-17	Hs~MGC:BC033734.1~uORF:IOH21809	564	36	528
B37R17C09	37-9-17	Hs~MGC:BC010739.1~uORF:IOH9887	842	36	806
B37R17C10	37-10-17	Hs~MGC:BC010739.1~uORF:IOH9887	837	38	799
B37R17C11	37-11-17	Hs~Ref:NM_016096.1~uORF:IOH10050	646	42	604
B37R17C12	37-12-17	Hs~Ref:NM_016096.1~uORF:IOH10050	620	45	575
B37R17C13	37-13-17	Hs~Ref:NM_000266.1~uORF:IOH22822	185	59	126
B37R17C14	37-14-17	Hs~Ref:NM_000266.1~uORF:IOH22822	210	71	139
B37R17C15	37-15-17	Hs~Ref:NM_005901.2~uORF:IOH22138	382	233	149
B37R17C16	37-16-17	Hs~Ref:NM_005901.2~uORF:IOH22138	249	114	135
B37R17C17	37-17-17	Hs~Ref:NM_020954.1~uORF:IOH25742	329	90	239
B37R17C18	37-18-17	Hs~Ref:NM_020954.1~uORF:IOH25742	280	247	33
B37R17C19	37-19-17	Hs~Ref:NM_003476.2~uORF:IOH7398	816	62	754
B37R17C20	37-20-17	Hs~Ref:NM_003476.2~uORF:IOH7398	959	167	792
B37R17C21	37-21-17	Hs~MGC:BC039014.1~uORF:IOH26125	484	196	288
B37R17C22	37-22-17	Hs~MGC:BC039014.1~uORF:IOH26125	433	63	370
B37R18C01	37-1-18	Hs~Ref:NM_012321.1~uORF:IOH3488	13643	49	13594
B37R18C02	37-2-18	Hs~Ref:NM_012321.1~uORF:IOH3488	14604	48	14556
B37R18C03	37-3-18	Hs~Ref:NM_016319.1~uORF:IOH14433	501	39	462
B37R18C04	37-4-18	Hs~Ref:NM_016319.1~uORF:IOH14433	476	40	436
B37R18C05	37-5-18	Hs~Ref:NM_024760.1~uORF:IOH13956	389	53	336
B37R18C06	37-6-18	Hs~Ref:NM_024760.1~uORF:IOH13956	350	39	311
B37R18C07	37-7-18	Hs~MGC:BC001433.1~uORF:IOH4012	408	38	370
B37R18C08	37-8-18	Hs~MGC:BC001433.1~uORF:IOH4012	430	40	390
B37R18C09	37-9-18	Hs~Ref:NM_021945.1~uORF:IOH21442	465	40	425
B37R18C10	37-10-18	Hs~Ref:NM_021945.1~uORF:IOH21442	466	41	425
B37R18C11	37-11-18	Hs~Ref:NM_001928.2~uORF:IOH29270	237	51	186
B37R18C12	37-12-18	Hs~Ref:NM_001928.2~uORF:IOH29270	290	54	236
B37R18C13	37-13-18	Hs~MGC:BC050546.1~uORF:IOH26928	456	47	409
B37R18C14	37-14-18	Hs~MGC:BC050546.1~uORF:IOH26928	379	45	334
B37R18C15	37-15-18	Hs~MGC:BC010634.1~uORF:IOH9775	364	61	303
B37R18C16	37-16-18	Hs~MGC:BC010634.1~uORF:IOH9775	183	50	133
B37R18C17	37-17-18	Hs~Ref:NM_003590.2~uORF:IOH26262	395	53	342
B37R18C18	37-18-18	Hs~Ref:NM_003590.2~uORF:IOH26262	199	57	142
B37R18C19	37-19-18	Hs~Ref:NM_017588.1~uORF:IOH4895	1197	69	1128
B37R18C20	37-20-18	Hs~Ref:NM_017588.1~uORF:IOH4895	1176	83	1093
B37R18C21	37-21-18	Hs~MGC:BC010152.1~uORF:IOH27838	537	184	353
B37R18C22	37-22-18	Hs~MGC:BC010152.1~uORF:IOH27838	600	76	524
B37R19C01	37-1-19	Hs~MGC:BC000758.1~uORF:IOH3735	738	104	634
B37R19C02	37-2-19	Hs~MGC:BC000758.1~uORF:IOH3735	686	56	630
B37R19C03	37-3-19	Hs~MGC:BC014385.1~uORF:IOH29333	730	42	688
B37R19C04	37-4-19	Hs~MGC:BC014385.1~uORF:IOH29333	723	38	685
B37R19C05	37-5-19	Hs~Ref:NM_032676.1~uORF:IOH5559	359	39	320
B37R19C06	37-6-19	Hs~Ref:NM_032676.1~uORF:IOH5559	401	150	251
B37R19C07	37-7-19	Hs~Ref:NM_001353.3~uORF:IOH14162	331	38	293
B37R19C08	37-8-19	Hs~Ref:NM_001353.3~uORF:IOH14162	401	44	357
B37R19C09	37-9-19	Hs~MGC:BC023152.1~uORF:IOH21475	266	56	210
B37R19C10	37-10-19	Hs~MGC:BC023152.1~uORF:IOH21475	358	54	304
B37R19C11	37-11-19	Hs~MGC:BC027729.1~uORF:IOH14530	7433	42	7391
B37R19C12	37-12-19	Hs~MGC:BC027729.1~uORF:IOH14530	7155	41	7114
B37R19C13	37-13-19	Hs~Ref:NM_005051.1~uORF:IOH3529	599	44	555
B37R19C14	37-14-19	Hs~Ref:NM_005051.1~uORF:IOH3529	580	44	536
B37R19C15	37-15-19	Hs~Ref:NM_014408.3~uORF:IOH5925	116	49	67
B37R19C16	37-16-19	Hs~Ref:NM_014408.3~uORF:IOH5925	116	53	63
B37R19C17	37-17-19	Hs~Ref:NM_022827.2~uORF:IOH12469	2548	50	2498
B37R19C18	37-18-19	Hs~Ref:NM_022827.2~uORF:IOH12469	2410	53	2357
B37R19C19	37-19-19	Hs~Ref:NM_014412.2~uORF:IOH7484	484	70	414
B37R19C20	37-20-19	Hs~Ref:NM_014412.2~uORF:IOH7484	567	143	424
B37R19C21	37-21-19	Hs~MGC:BC000772.1~uORF:IOH4704	1261	73	1188
B37R19C22	37-22-19	Hs~MGC:BC000772.1~uORF:IOH4704	1234	62	1172
B37R20C01	37-1-20	Hs~Ref:NM_004965.3~uORF:IOH4772	2143	45	2098
B37R20C02	37-2-20	Hs~Ref:NM_004965.3~uORF:IOH4772	2228	40	2188
B37R20C03	37-3-20	Hs~MGC:BC001132.1~uORF:IOH3853	2004	37	1967
B37R20C04	37-4-20	Hs~MGC:BC001132.1~uORF:IOH3853	1992	35	1957
B37R20C05	37-5-20	Hs~MGC:BC003604.1~uORF:IOH4978	1131	37	1094
B37R20C06	37-6-20	Hs~MGC:BC003604.1~uORF:IOH4978	1165	38	1127
B37R20C07	37-7-20	Hs~Ref:NM_005694.1~uORF:IOH12906	192	38	154
B37R20C08	37-8-20	Hs~Ref:NM_005694.1~uORF:IOH12906	273	181	92
B37R20C09	37-9-20	Hs~MGC:BC014298.1~uORF:IOH13449	10262	54	10208
B37R20C10	37-10-20	Hs~MGC:BC014298.1~uORF:IOH13449	9923	44	9879
B37R20C11	37-11-20	Hs~Ref:NM_005097.1~uORF:IOH10604	337	40	297
B37R20C12	37-12-20	Hs~Ref:NM_005097.1~uORF:IOH10604	326	41	285
B37R20C13	37-13-20	Hs~MGC:BC004239.1~uORF:IOH5526	561	37	524
B37R20C14	37-14-20	Hs~MGC:BC004239.1~uORF:IOH5526	550	37	513
B37R20C15	37-15-20	Hs~MGC:BC020905.1~uORF:IOH13058	208	110	98
B37R20C16	37-16-20	Hs~MGC:BC020905.1~uORF:IOH13058	166	44	122
B37R20C17	37-17-20	Hs~Ref:NM_003973.2~uORF:IOH4249	168	44	124
B37R20C18	37-18-20	Hs~Ref:NM_003973.2~uORF:IOH4249	454	104	350
B37R20C19	37-19-20	Hs~Ref:NM_144567.1~uORF:IOH10733	419	59	360
B37R20C20	37-20-20	Hs~Ref:NM_144567.1~uORF:IOH10733	492	68	424
B37R20C21	37-21-20	Hs~MGC:BC015858.1~uORF:IOH12148	117	60	57
B37R20C22	37-22-20	Hs~MGC:BC015858.1~uORF:IOH12148	163	110	53
B37R21C01	37-1-21	Hs~MGC:NM_152697.2~uORF:IOH11708	69	36	33
B37R21C02	37-2-21	Hs~MGC:NM_152697.2~uORF:IOH11708	129	37	92
B37R21C03	37-3-21	Hs~Ref:NM_031934.2~uORF:IOH29793	164	62	102
B37R21C04	37-4-21	Hs~Ref:NM_031934.2~uORF:IOH29793	99	35	64
B37R21C05	37-5-21	Hs~MGC:BC025409.1~uORF:IOH27105	220	51	169
B37R21C06	37-6-21	Hs~MGC:BC025409.1~uORF:IOH27105	225	76	149
B37R21C07	37-7-21	Hs~Ref:NM_033412.1~uORF:IOH7441	96	36	60
B37R21C08	37-8-21	Hs~Ref:NM_033412.1~uORF:IOH7441	104	36	68
B37R21C09	37-9-21	Hs~Ref:NP_005009.2~CAT_10377-H03H-25	33	34	-1
B37R21C10	37-10-21	Hs~Ref:NP_005009.2~CAT_10377-H03H-25	33	34	-1
B37R21C11	37-11-21	Internal_1007209	234	86	148
B37R21C12	37-12-21	Internal_1007209	150	35	115
B37R21C13	37-13-21	Hs~Ref:NP_003225.2~CAT_11020-H07H-25	52	34	18
B37R21C14	37-14-21	Hs~Ref:NP_003225.2~CAT_11020-H07H-25	59	35	24
B37R21C15	37-15-21	Internal_1007209	74	39	35
B37R21C16	37-16-21	Internal_1007209	50	38	12
B37R21C17	37-17-21	Hs~Ref:NP_002178.2~CAT_10052-H08H-25	43	40	3
B37R21C18	37-18-21	Hs~Ref:NP_002178.2~CAT_10052-H08H-25	45	44	1
B37R21C19	37-19-21	Internal_1007209	638	52	586
B37R21C20	37-20-21	Internal_1007209	1297	545	752
B37R21C21	37-21-21	Hs~IVGN:FGF2_Recombinant~CAT_13256029~N/A	4416	64	4352
B37R21C22	37-22-21	Hs~IVGN:FGF2_Recombinant~CAT_13256029~N/A	4425	59	4366
B37R22C01	37-1-22	ERa~N/A	2236	37	2199
B37R22C02	37-2-22	ERa~N/A	2370	40	2330
B37R22C03	37-3-22	PKCeta~N/A	420	52	368
B37R22C04	37-4-22	PKCeta~N/A	287	43	244
B37R22C05	37-5-22	Calmodulin~N/A	137	51	86
B37R22C06	37-6-22	Calmodulin~N/A	94	39	55
B37R22C07	37-7-22	V5control5~N/A	501	47	454
B37R22C08	37-8-22	V5control5~N/A	475	44	431
B37R22C09	37-9-22	V5control4~N/A	72	41	31
B37R22C10	37-10-22	V5control4~N/A	145	35	110
B37R22C11	37-11-22	V5control3~N/A	83	56	27
B37R22C12	37-12-22	V5control3~N/A	64	39	25
B37R22C13	37-13-22	V5control2~N/A	72	35	37
B37R22C14	37-14-22	V5control2~N/A	156	66	90
B37R22C15	37-15-22	V5control1~N/A	71	42	29
B37R22C16	37-16-22	V5control1~N/A	104	45	59
B37R22C17	37-17-22	CMK2A~N/A	497	39	458
B37R22C18	37-18-22	CMK2A~N/A	522	42	480
B37R22C19	37-19-22	ERa~N/A	2410	54	2356
B37R22C20	37-20-22	ERa~N/A	1965	60	1905
B37R22C21	37-21-22	AlexaAntiMouseAb~N/A	10543	57	10486
B37R22C22	37-22-22	AlexaAntiMouseAb~N/A	12409	55	12354
B38R01C01	38-1-1	AlexaAntiMouseAb~N/A	41682	47	41635
B38R01C02	38-2-1	AlexaAntiMouseAb~N/A	36564	47	36517
B38R01C03	38-3-1	ERa~N/A	1539	47	1492
B38R01C04	38-4-1	ERa~N/A	1515	45	1470
B38R01C05	38-5-1	HumanIgG1~N/A	1169	45	1124
B38R01C06	38-6-1	HumanIgG1~N/A	1204	45	1159
B38R01C07	38-7-1	HumanIgG2~N/A	2870	45	2825
B38R01C08	38-8-1	HumanIgG2~N/A	2708	45	2663
B38R01C09	38-9-1	HumanIgG3~N/A	13234	46	13188
B38R01C10	38-10-1	HumanIgG3~N/A	13074	46	13028
B38R01C11	38-11-1	HumanIgG4~N/A	44136	49	44087
B38R01C12	38-12-1	HumanIgG4~N/A	42796	49	42747
B38R01C13	38-13-1	BiotinAb~N/A	455	47	408
B38R01C14	38-14-1	BiotinAb~N/A	403	44	359
B38R01C15	38-15-1	RanBP2deltaFG~N/A	527	42	485
B38R01C16	38-16-1	RanBP2deltaFG~N/A	505	44	461
B38R01C17	38-17-1	hMDM2~N/A	910	42	868
B38R01C18	38-18-1	hMDM2~N/A	821	39	782
B38R01C19	38-19-1	PKCeta~N/A	641	39	602
B38R01C20	38-20-1	PKCeta~N/A	729	41	688
B38R01C21	38-21-1	AlexaAntiMouseAb~N/A	36673	43	36630
B38R01C22	38-22-1	AlexaAntiMouseAb~N/A	40986	42	40944
B38R02C01	38-1-2	PKCeta~N/A	1446	45	1401
B38R02C02	38-2-2	PKCeta~N/A	1455	46	1409
B38R02C03	38-3-2	Buffer	543	48	495
B38R02C04	38-4-2	Buffer	540	47	493
B38R02C05	38-5-2	HumanIgA~N/A	25657	48	25609
B38R02C06	38-6-2	HumanIgA~N/A	25111	47	25064
B38R02C07	38-7-2	Buffer	204	49	155
B38R02C08	38-8-2	Buffer	270	54	216
B38R02C09	38-9-2	BSA~N/A	14208	48	14160
B38R02C10	38-10-2	BSA~N/A	13964	47	13917
B38R02C11	38-11-2	Hs~MGC:BC030800.2~uORF:IOH28622	611	48	563
B38R02C12	38-12-2	Hs~MGC:BC030800.2~uORF:IOH28622	584	47	537
B38R02C13	38-13-2	Hs~Ref:NM_004892.2~uORF:IOH3957	635	48	587
B38R02C14	38-14-2	Hs~Ref:NM_004892.2~uORF:IOH3957	610	46	564
B38R02C15	38-15-2	Hs~MGC:BC058920.1~uORF:IOH29109	618	47	571
B38R02C16	38-16-2	Hs~MGC:BC058920.1~uORF:IOH29109	671	52	619
B38R02C17	38-17-2	Hs~MGC:BC013990.1~uORF:IOH14082	1135	50	1085
B38R02C18	38-18-2	Hs~MGC:BC013990.1~uORF:IOH14082	1077	43	1034
B38R02C19	38-19-2	Hs~MGC:NM_176826.1~uORF:IOH4631	311	44	267
B38R02C20	38-20-2	Hs~MGC:NM_176826.1~uORF:IOH4631	335	45	290
B38R02C21	38-21-2	Hs~Ref:NM_015991.1~uORF:IOH23091	487	45	442
B38R02C22	38-22-2	Hs~Ref:NM_015991.1~uORF:IOH23091	462	42	420
B38R03C01	38-1-3	Hs~Ref:NM_033261.2~uORF:IOH12134	473	46	427
B38R03C02	38-2-3	Hs~Ref:NM_033261.2~uORF:IOH12134	448	51	397
B38R03C03	38-3-3	Hs~MGC:BC003651.1~uORF:IOH5212	499	54	445
B38R03C04	38-4-3	Hs~MGC:BC003651.1~uORF:IOH5212	472	53	419
B38R03C05	38-5-3	Hs~Ref:NM_153612.2~uORF:IOH35580	170	50	120
B38R03C06	38-6-3	Hs~Ref:NM_153612.2~uORF:IOH35580	335	53	282
B38R03C07	38-7-3	Hs~Ref:NM_173065.1~uORF:IOH40989	292	52	240
B38R03C08	38-8-3	Hs~Ref:NM_173065.1~uORF:IOH40989	396	134	262
B38R03C09	38-9-3	Hs~Ref:NM_153031.1~uORF:IOH40991	287	54	233
B38R03C10	38-10-3	Hs~Ref:NM_153031.1~uORF:IOH40991	306	47	259
B38R03C11	38-11-3	Hs~Ref:NM_178176.2~uORF:IOH40964	385	76	309
B38R03C12	38-12-3	Hs~Ref:NM_178176.2~uORF:IOH40964	208	47	161
B38R03C13	38-13-3	Hs~Ref:NM_002309.2~uORF:IOH34705	1219	48	1171
B38R03C14	38-14-3	Hs~Ref:NM_002309.2~uORF:IOH34705	1115	48	1067
B38R03C15	38-15-3	Hs~Ref:NM_000139.2~uORF:IOH44387	231	73	158
B38R03C16	38-16-3	Hs~Ref:NM_000139.2~uORF:IOH44387	273	53	220
B38R03C17	38-17-3	Hs~Ref:NM_202467.1~uORF:IOH45902	287	50	237
B38R03C18	38-18-3	Hs~Ref:NM_202467.1~uORF:IOH45902	336	144	192
B38R03C19	38-19-3	Hs~Ref:NM_000606.1~uORF:IOH44341	333	59	274
B38R03C20	38-20-3	Hs~Ref:NM_000606.1~uORF:IOH44341	319	117	202
B38R03C21	38-21-3	Hs~MGC:BC016942.1~uORF:IOH10309	1327	46	1281
B38R03C22	38-22-3	Hs~MGC:BC016942.1~uORF:IOH10309	1295	42	1253
B38R04C01	38-1-4	Hs~MGC:BC017724.1~uORF:IOH10317	626	50	576
B38R04C02	38-2-4	Hs~MGC:BC017724.1~uORF:IOH10317	681	63	618
B38R04C03	38-3-4	Hs~MGC:BC015329.1~uORF:IOH10328	484	254	230
B38R04C04	38-4-4	Hs~MGC:BC015329.1~uORF:IOH10328	409	69	340
B38R04C05	38-5-4	Hs~Ref:NM_007260.2~uORF:IOH10346	377	64	313
B38R04C06	38-6-4	Hs~Ref:NM_007260.2~uORF:IOH10346	341	79	262
B38R04C07	38-7-4	Hs~Ref:NM_005155.5~uORF:IOH3929	393	50	343
B38R04C08	38-8-4	Hs~Ref:NM_005155.5~uORF:IOH3929	430	51	379
B38R04C09	38-9-4	Hs~MGC:NM_152587.2~uORF:IOH22568	496	51	445
B38R04C10	38-10-4	Hs~MGC:NM_152587.2~uORF:IOH22568	516	50	466
B38R04C11	38-11-4	Hs~MGC:BC007047.1~uORF:IOH7319	501	50	451
B38R04C12	38-12-4	Hs~MGC:BC007047.1~uORF:IOH7319	579	60	519
B38R04C13	38-13-4	Hs~Ref:NM_144654.1~uORF:IOH12733	541	51	490
B38R04C14	38-14-4	Hs~Ref:NM_144654.1~uORF:IOH12733	586	51	535
B38R04C15	38-15-4	Hs~MGC:BC021934.1~uORF:IOH27957	358	51	307
B38R04C16	38-16-4	Hs~MGC:BC021934.1~uORF:IOH27957	400	84	316
B38R04C17	38-17-4	Hs~Ref:NM_017629.2~uORF:IOH38411	626	50	576
B38R04C18	38-18-4	Hs~Ref:NM_017629.2~uORF:IOH38411	639	48	591
B38R04C19	38-19-4	Hs~Ref:NM_001098.2~uORF:IOH22985	557	46	511
B38R04C20	38-20-4	Hs~Ref:NM_001098.2~uORF:IOH22985	540	46	494
B38R04C21	38-21-4	Hs~Ref:NM_002235.2~uORF:IOH37901	541	44	497
B38R04C22	38-22-4	Hs~Ref:NM_002235.2~uORF:IOH37901	568	45	523
B38R05C01	38-1-5	Hs~MGC:BC013031.1~uORF:IOH13433	428	52	376
B38R05C02	38-2-5	Hs~MGC:BC013031.1~uORF:IOH13433	484	63	421
B38R05C03	38-3-5	Hs~MGC:BC007199.1~uORF:IOH6547	647	60	587
B38R05C04	38-4-5	Hs~MGC:BC007199.1~uORF:IOH6547	509	56	453
B38R05C05	38-5-5	Hs~MGC:BC031079.1~uORF:IOH22556	969	54	915
B38R05C06	38-6-5	Hs~MGC:BC031079.1~uORF:IOH22556	983	53	930
B38R05C07	38-7-5	Hs~MGC:BC017347.1~uORF:IOH13256	682	48	634
B38R05C08	38-8-5	Hs~MGC:BC017347.1~uORF:IOH13256	697	52	645
B38R05C09	38-9-5	Hs~Ref:NM_013392.1~N/A	478	222	256
B38R05C10	38-10-5	Hs~Ref:NM_013392.1~N/A	371	224	147
B38R05C11	38-11-5	Hs~Ref:NM_003674.1~N/A	552	55	497
B38R05C12	38-12-5	Hs~Ref:NM_003674.1~N/A	647	89	558
B38R05C13	38-13-5	Hs~Ref:NM_006374.2~N/A	484	58	426
B38R05C14	38-14-5	Hs~Ref:NM_006374.2~N/A	517	54	463
B38R05C15	38-15-5	Hs~Ref:NM_005044.1~N/A	442	50	392
B38R05C16	38-16-5	Hs~Ref:NM_005044.1~N/A	474	55	419
B38R05C17	38-17-5	Hs~MGC:BC068460.1~uORF:IOH40106	489	52	437
B38R05C18	38-18-5	Hs~MGC:BC068460.1~uORF:IOH40106	511	50	461
B38R05C19	38-19-5	Hs~Ref:NM_021803.1~uORF:IOH40163	1267	47	1220
B38R05C20	38-20-5	Hs~Ref:NM_021803.1~uORF:IOH40163	1119	47	1072
B38R05C21	38-21-5	Hs~Ref:NM_000519.2~uORF:IOH40232	1397	50	1347
B38R05C22	38-22-5	Hs~Ref:NM_000519.2~uORF:IOH40232	1417	45	1372
B38R06C01	38-1-6	Hs~Ref:NM_178813.5~uORF:IOH40109	590	47	543
B38R06C02	38-2-6	Hs~Ref:NM_178813.5~uORF:IOH40109	636	51	585
B38R06C03	38-3-6	Hs~MGC:BC017956.1~uORF:IOH12293	1263	51	1212
B38R06C04	38-4-6	Hs~MGC:BC017956.1~uORF:IOH12293	1190	58	1132
B38R06C05	38-5-6	Hs~Ref:NM_031491.1~uORF:IOH23163	771	408	363
B38R06C06	38-6-6	Hs~Ref:NM_031491.1~uORF:IOH23163	483	94	389
B38R06C07	38-7-6	Hs~MGC:BC031799.1~uORF:IOH22193	931	52	879
B38R06C08	38-8-6	Hs~MGC:BC031799.1~uORF:IOH22193	793	55	738
B38R06C09	38-9-6	Hs~MGC:NM_175870.3~uORF:IOH5318	761	64	697
B38R06C10	38-10-6	Hs~MGC:NM_175870.3~uORF:IOH5318	792	60	732
B38R06C11	38-11-6	Hs~Ref:NM_001015509.1~uORF:IOH54713	664	55	609
B38R06C12	38-12-6	Hs~Ref:NM_001015509.1~uORF:IOH54713	673	54	619
B38R06C13	38-13-6	Hs~Ref:NM_020137.3~uORF:IOH52884	853	54	799
B38R06C14	38-14-6	Hs~Ref:NM_020137.3~uORF:IOH52884	819	51	768
B38R06C15	38-15-6	Hs~Ref:NM_002154.3~uORF:IOH52882	256	48	208
B38R06C16	38-16-6	Hs~Ref:NM_002154.3~uORF:IOH52882	248	53	195
B38R06C17	38-17-6	Hs~Ref:NM_013393.1~uORF:IOH59783	742	61	681
B38R06C18	38-18-6	Hs~Ref:NM_013393.1~uORF:IOH59783	731	50	681
B38R06C19	38-19-6	Hs~Ref:NM_152324.1~uORF:IOH22764	500	51	449
B38R06C20	38-20-6	Hs~Ref:NM_152324.1~uORF:IOH22764	572	263	309
B38R06C21	38-21-6	Hs~Ref:NM_152772.1~uORF:IOH21739	1396	64	1332
B38R06C22	38-22-6	Hs~Ref:NM_152772.1~uORF:IOH21739	1410	49	1361
B38R07C01	38-1-7	Hs~Ref:NM_032509.2~uORF:IOH26995	315	48	267
B38R07C02	38-2-7	Hs~Ref:NM_032509.2~uORF:IOH26995	537	50	487
B38R07C03	38-3-7	Hs~Ref:NM_006337.3~uORF:IOH12378	767	47	720
B38R07C04	38-4-7	Hs~Ref:NM_006337.3~uORF:IOH12378	846	50	796
B38R07C05	38-5-7	Hs~MGC:BC026038.1~uORF:IOH13982	65535	66	65469
B38R07C06	38-6-7	Hs~MGC:BC026038.1~uORF:IOH13982	65535	62	65473
B38R07C07	38-7-7	Hs~Ref:NM_003018.1~uORF:IOH7453	321	64	257
B38R07C08	38-8-7	Hs~Ref:NM_003018.1~uORF:IOH7453	1790	135	1655
B38R07C09	38-9-7	Hs~MGC:NM_181526.1~uORF:IOH5278	449	190	259
B38R07C10	38-10-7	Hs~MGC:NM_181526.1~uORF:IOH5278	283	64	219
B38R07C11	38-11-7	Hs~MGC:BC000044.1~uORF:IOH4604	1709	60	1649
B38R07C12	38-12-7	Hs~MGC:BC000044.1~uORF:IOH4604	1731	59	1672
B38R07C13	38-13-7	Hs~Ref:NM_002737.1~N/A	532	52	480
B38R07C14	38-14-7	Hs~Ref:NM_002737.1~N/A	441	55	386
B38R07C15	38-15-7	Hs~Ref:NM_006206.2~N/A	600	51	549
B38R07C16	38-16-7	Hs~Ref:NM_006206.2~N/A	495	51	444
B38R07C17	38-17-7	Hs~Ref:NM_000222.1~N/A	1168	51	1117
B38R07C18	38-18-7	Hs~Ref:NM_000222.1~N/A	857	50	807
B38R07C19	38-19-7	Hs~Ref:NM_005734.1~N/A	4032	50	3982
B38R07C20	38-20-7	Hs~Ref:NM_005734.1~N/A	3131	49	3082
B38R07C21	38-21-7	Hs~Ref:NM_017785.2~uORF:IOH12118	3494	52	3442
B38R07C22	38-22-7	Hs~Ref:NM_017785.2~uORF:IOH12118	3334	43	3291
B38R08C01	38-1-8	Hs~MGC:BC014428.1~uORF:IOH14661	389	58	331
B38R08C02	38-2-8	Hs~MGC:BC014428.1~uORF:IOH14661	470	55	415
B38R08C03	38-3-8	Hs~MGC:BC016929.1~uORF:IOH11225	992	50	942
B38R08C04	38-4-8	Hs~MGC:BC016929.1~uORF:IOH11225	990	50	940
B38R08C05	38-5-8	Hs~MGC:BC041037.1~uORF:IOH28003	65535	53	65482
B38R08C06	38-6-8	Hs~MGC:BC041037.1~uORF:IOH28003	65535	52	65483
B38R08C07	38-7-8	Hs~MGC:BC033181.1~uORF:IOH23240	675	52	623
B38R08C08	38-8-8	Hs~MGC:BC033181.1~uORF:IOH23240	660	52	608
B38R08C09	38-9-8	Hs~Ref:NM_145701.1~uORF:IOH12253	436	54	382
B38R08C10	38-10-8	Hs~Ref:NM_145701.1~uORF:IOH12253	548	147	401
B38R08C11	38-11-8	Hs~Ref:NM_006586.2~uORF:IOH5802	348	183	165
B38R08C12	38-12-8	Hs~Ref:NM_006586.2~uORF:IOH5802	254	195	59
B38R08C13	38-13-8	Hs~MGC:BC010084.2~uORF:IOH13070	283	58	225
B38R08C14	38-14-8	Hs~MGC:BC010084.2~uORF:IOH13070	274	55	219
B38R08C15	38-15-8	Hs~Ref:NM_031899.2~uORF:IOH45679	392	53	339
B38R08C16	38-16-8	Hs~Ref:NM_031899.2~uORF:IOH45679	329	54	275
B38R08C17	38-17-8	Hs~Ref:NM_006877.1~uORF:IOH6246	465	44	421
B38R08C18	38-18-8	Hs~Ref:NM_006877.1~uORF:IOH6246	482	44	438
B38R08C19	38-19-8	Hs~Ref:NM_003153.3~uORF:IOH45683	757	47	710
B38R08C20	38-20-8	Hs~Ref:NM_003153.3~uORF:IOH45683	734	43	691
B38R08C21	38-21-8	Hs~Ref:NM_018325.1~uORF:IOH45695	474	43	431
B38R08C22	38-22-8	Hs~Ref:NM_018325.1~uORF:IOH45695	441	41	400
B38R09C01	38-1-9	Hs~Ref:NM_000983.3~uORF:IOH58958	655	58	597
B38R09C02	38-2-9	Hs~Ref:NM_000983.3~uORF:IOH58958	608	59	549
B38R09C03	38-3-9	Hs~Ref:NM_001001715.1~uORF:IOH58728	444	57	387
B38R09C04	38-4-9	Hs~Ref:NM_001001715.1~uORF:IOH58728	392	74	318
B38R09C05	38-5-9	Hs~Ref:NM_024060.2~uORF:IOH54639	182	52	130
B38R09C06	38-6-9	Hs~Ref:NM_024060.2~uORF:IOH54639	260	68	192
B38R09C07	38-7-9	Hs~Ref:NM_007079.2~uORF:IOH4497	863	52	811
B38R09C08	38-8-9	Hs~Ref:NM_007079.2~uORF:IOH4497	768	52	716
B38R09C09	38-9-9	Hs~Ref:NM_006554.3~uORF:IOH56609	368	71	297
B38R09C10	38-10-9	Hs~Ref:NM_006554.3~uORF:IOH56609	389	195	194
B38R09C11	38-11-9	Hs~Ref:NM_004042.3~uORF:IOH55502	197	49	148
B38R09C12	38-12-9	Hs~Ref:NM_004042.3~uORF:IOH55502	179	54	125
B38R09C13	38-13-9	Hs~MGC:BC008403.1~uORF:IOH57068	305	66	239
B38R09C14	38-14-9	Hs~MGC:BC008403.1~uORF:IOH57068	185	107	78
B38R09C15	38-15-9	Hs~Ref:NM_020190.2~uORF:IOH57096	130	47	83
B38R09C16	38-16-9	Hs~Ref:NM_020190.2~uORF:IOH57096	134	78	56
B38R09C17	38-17-9	Hs~MGC:BC013172.1~uORF:IOH11965	327	54	273
B38R09C18	38-18-9	Hs~MGC:BC013172.1~uORF:IOH11965	293	69	224
B38R09C19	38-19-9	Hs~Ref:NM_013416.1~uORF:IOH5398	407	47	360
B38R09C20	38-20-9	Hs~Ref:NM_013416.1~uORF:IOH5398	477	51	426
B38R09C21	38-21-9	Hs~MGC:BC025708.1~uORF:IOH11251	129	46	83
B38R09C22	38-22-9	Hs~MGC:BC025708.1~uORF:IOH11251	133	43	90
B38R10C01	38-1-10	Hs~MGC:BC020225.1~uORF:IOH13323	204	89	115
B38R10C02	38-2-10	Hs~MGC:BC020225.1~uORF:IOH13323	132	51	81
B38R10C03	38-3-10	Hs~Ref:NM_000714.3~uORF:IOH3897	449	47	402
B38R10C04	38-4-10	Hs~Ref:NM_000714.3~uORF:IOH3897	477	53	424
B38R10C05	38-5-10	Hs~MGC:BC016715.1~uORF:IOH27895	411	52	359
B38R10C06	38-6-10	Hs~MGC:BC016715.1~uORF:IOH27895	586	88	498
B38R10C07	38-7-10	Hs~Ref:NM_003929.1~uORF:IOH4101	670	58	612
B38R10C08	38-8-10	Hs~Ref:NM_003929.1~uORF:IOH4101	598	51	547
B38R10C09	38-9-10	Hs~Ref:NM_001029.2~uORF:IOH4114	554	50	504
B38R10C10	38-10-10	Hs~Ref:NM_001029.2~uORF:IOH4114	602	46	556
B38R10C11	38-11-10	GST1	182	46	136
B38R10C12	38-12-10	GST1	62	46	16
B38R10C13	38-13-10	GST2	118	49	69
B38R10C14	38-14-10	GST2	131	50	81
B38R10C15	38-15-10	GST3	57	46	11
B38R10C16	38-16-10	GST3	58	45	13
B38R10C17	38-17-10	GST4	59	39	20
B38R10C18	38-18-10	GST4	59	41	18
B38R10C19	38-19-10	Anti-HumanIgA1~N/A	8817	43	8774
B38R10C20	38-20-10	Anti-HumanIgA1~N/A	9923	47	9876
B38R10C21	38-21-10	Anti-HumanIgA2~N/A	15358	47	15311
B38R10C22	38-22-10	Anti-HumanIgA2~N/A	15665	41	15624
B38R11C01	38-1-11	AlexaAntiMouseAb~N/A	26599	62	26537
B38R11C02	38-2-11	AlexaAntiMouseAb~N/A	28028	55	27973
B38R11C03	38-3-11	MAPKAP~N/A	93	45	48
B38R11C04	38-4-11	MAPKAP~N/A	93	47	46
B38R11C05	38-5-11	Buffer	291	52	239
B38R11C06	38-6-11	Buffer	259	83	176
B38R11C07	38-7-11	BSA~N/A	11940	51	11889
B38R11C08	38-8-11	BSA~N/A	12158	48	12110
B38R11C09	38-9-11	Anti-HumanIgG1~N/A	2049	47	2002
B38R11C10	38-10-11	Anti-HumanIgG1~N/A	1911	44	1867
B38R11C11	38-11-11	Anti-HumanIgG2~N/A	3620	43	3577
B38R11C12	38-12-11	Anti-HumanIgG2~N/A	3673	45	3628
B38R11C13	38-13-11	Anti-HumanIgG3~N/A	6486	46	6440
B38R11C14	38-14-11	Anti-HumanIgG3~N/A	6452	47	6405
B38R11C15	38-15-11	Anti-HumanIgG4~N/A	11979	49	11930
B38R11C16	38-16-11	Anti-HumanIgG4~N/A	12225	46	12179
B38R11C17	38-17-11	AntiBiotinAb~N/A	13570	41	13529
B38R11C18	38-18-11	AntiBiotinAb~N/A	13383	42	13341
B38R11C19	38-19-11	Buffer	60	41	19
B38R11C20	38-20-11	Buffer	62	44	18
B38R11C21	38-21-11	Hs~MGC:BC000417.1~uORF:IOH3651	710	46	664
B38R11C22	38-22-11	Hs~MGC:BC000417.1~uORF:IOH3651	659	40	619
B38R12C01	38-1-12	Hs~Ref:NM_001023.2~uORF:IOH6083	952	60	892
B38R12C02	38-2-12	Hs~Ref:NM_001023.2~uORF:IOH6083	929	57	872
B38R12C03	38-3-12	Hs~Ref:NM_001537.1~uORF:IOH6103	725	48	677
B38R12C04	38-4-12	Hs~Ref:NM_001537.1~uORF:IOH6103	729	49	680
B38R12C05	38-5-12	Hs~Ref:NM_020189.1~uORF:IOH6776	313	66	247
B38R12C06	38-6-12	Hs~Ref:NM_020189.1~uORF:IOH6776	528	355	173
B38R12C07	38-7-12	Hs~Ref:NM_004103.2~N/A	756	58	698
B38R12C08	38-8-12	Hs~Ref:NM_004103.2~N/A	674	54	620
B38R12C09	38-9-12	Hs~Ref:NM_013355.1~N/A	636	50	586
B38R12C10	38-10-12	Hs~Ref:NM_013355.1~N/A	585	48	537
B38R12C11	38-11-12	Hs~Ref:NM_001396.2~N/A	1633	48	1585
B38R12C12	38-12-12	Hs~Ref:NM_001396.2~N/A	1604	48	1556
B38R12C13	38-13-12	Hs~Ref:NM_003010.1~N/A	542	48	494
B38R12C14	38-14-12	Hs~Ref:NM_003010.1~N/A	519	46	473
B38R12C15	38-15-12	Hs~Ref:NM_005867.2~uORF:IOH40378	121	49	72
B38R12C16	38-16-12	Hs~Ref:NM_005867.2~uORF:IOH40378	146	51	95
B38R12C17	38-17-12	Hs~Ref:NM_002854.2~uORF:IOH40404	113	44	69
B38R12C18	38-18-12	Hs~Ref:NM_002854.2~uORF:IOH40404	142	76	66
B38R12C19	38-19-12	Hs~Ref:NM_001002762.1~uORF:IOH39966	355	44	311
B38R12C20	38-20-12	Hs~Ref:NM_001002762.1~uORF:IOH39966	423	62	361
B38R12C21	38-21-12	Hs~Ref:NM_001004307.1~uORF:IOH40197	245	48	197
B38R12C22	38-22-12	Hs~Ref:NM_001004307.1~uORF:IOH40197	74	43	31
B38R13C01	38-1-13	Hs~Ref:NM_020665.2~uORF:IOH12463	213	51	162
B38R13C02	38-2-13	Hs~Ref:NM_020665.2~uORF:IOH12463	203	48	155
B38R13C03	38-3-13	Hs~Ref:NM_024557.2~uORF:IOH10980	268	55	213
B38R13C04	38-4-13	Hs~Ref:NM_024557.2~uORF:IOH10980	288	243	45
B38R13C05	38-5-13	Hs~MGC:BC017572.1~uORF:IOH14665	1956	302	1654
B38R13C06	38-6-13	Hs~MGC:BC017572.1~uORF:IOH14665	353	251	102
B38R13C07	38-7-13	Hs~Ref:NM_000801.2~uORF:IOH4623	503	246	257
B38R13C08	38-8-13	Hs~Ref:NM_000801.2~uORF:IOH4623	3209	258	2951
B38R13C09	38-9-13	Hs~Ref:XM_374026.1~uORF:IOH44789	551	190	361
B38R13C10	38-10-13	Hs~Ref:XM_374026.1~uORF:IOH44789	383	69	314
B38R13C11	38-11-13	Hs~Ref:NM_002072.1~uORF:IOH29692	557	205	352
B38R13C12	38-12-13	Hs~Ref:NM_002072.1~uORF:IOH29692	441	54	387
B38R13C13	38-13-13	Hs~Ref:NM_003877.3~uORF:IOH13865	623	50	573
B38R13C14	38-14-13	Hs~Ref:NM_003877.3~uORF:IOH13865	567	49	518
B38R13C15	38-15-13	Hs~Ref:NM_000294.1~uORF:IOH4032	64121	49	64072
B38R13C16	38-16-13	Hs~Ref:NM_000294.1~uORF:IOH4032	58462	56	58406
B38R13C17	38-17-13	Hs~MGC:BC022045.1~uORF:IOH14841	1220	48	1172
B38R13C18	38-18-13	Hs~MGC:BC022045.1~uORF:IOH14841	1168	42	1126
B38R13C19	38-19-13	Hs~MGC:BC020975.1~uORF:IOH10376	720	43	677
B38R13C20	38-20-13	Hs~MGC:BC020975.1~uORF:IOH10376	681	46	635
B38R13C21	38-21-13	Hs~MGC:BC020662.1~uORF:IOH12844	305	59	246
B38R13C22	38-22-13	Hs~MGC:BC020662.1~uORF:IOH12844	375	48	327
B38R14C01	38-1-14	Hs~Ref:NM_002737.1~uORF:IOH29644	169	61	108
B38R14C02	38-2-14	Hs~Ref:NM_002737.1~uORF:IOH29644	115	61	54
B38R14C03	38-3-14	Hs~MGC:AK055306.1~uORF:IOH21180	624	62	562
B38R14C04	38-4-14	Hs~MGC:AK055306.1~uORF:IOH21180	100	63	37
B38R14C05	38-5-14	Hs~MGC:BC047733.1~uORF:IOH26736	409	52	357
B38R14C06	38-6-14	Hs~MGC:BC047733.1~uORF:IOH26736	271	59	212
B38R14C07	38-7-14	Hs~Ref:NM_206852.1~uORF:IOH40898	1055	59	996
B38R14C08	38-8-14	Hs~Ref:NM_206852.1~uORF:IOH40898	1071	57	1014
B38R14C09	38-9-14	Hs~Ref:NM_030673.2~uORF:IOH40899	336	72	264
B38R14C10	38-10-14	Hs~Ref:NM_030673.2~uORF:IOH40899	405	260	145
B38R14C11	38-11-14	Hs~Ref:NM_198560.1~uORF:IOH59787	161	52	109
B38R14C12	38-12-14	Hs~Ref:NM_198560.1~uORF:IOH59787	235	90	145
B38R14C13	38-13-14	Hs~Ref:NM_001004327.1~uORF:IOH59740	525	49	476
B38R14C14	38-14-14	Hs~Ref:NM_001004327.1~uORF:IOH59740	546	49	497
B38R14C15	38-15-14	Hs~Ref:NM_182772.1~uORF:IOH53451	703	47	656
B38R14C16	38-16-14	Hs~Ref:NM_182772.1~uORF:IOH53451	666	62	604
B38R14C17	38-17-14	Hs~Ref:NM_199169.1~uORF:IOH59817	1711	58	1653
B38R14C18	38-18-14	Hs~Ref:NM_199169.1~uORF:IOH59817	1717	42	1675
B38R14C19	38-19-14	Hs~Ref:NM_015246.1~uORF:IOH26658	528	39	489
B38R14C20	38-20-14	Hs~Ref:NM_015246.1~uORF:IOH26658	502	43	459
B38R14C21	38-21-14	Hs~MGC:BC026270.1~uORF:IOH14666	426	48	378
B38R14C22	38-22-14	Hs~MGC:BC026270.1~uORF:IOH14666	416	46	370
B38R15C01	38-1-15	Hs~MGC:BC011234.1~uORF:IOH10261	870	54	816
B38R15C02	38-2-15	Hs~MGC:BC011234.1~uORF:IOH10261	877	57	820
B38R15C03	38-3-15	Hs~MGC:BC052955.1~uORF:IOH28816	462	65	397
B38R15C04	38-4-15	Hs~MGC:BC052955.1~uORF:IOH28816	372	54	318
B38R15C05	38-5-15	Hs~Ref:NM_006715.2~uORF:IOH26932	294	52	242
B38R15C06	38-6-15	Hs~Ref:NM_006715.2~uORF:IOH26932	311	89	222
B38R15C07	38-7-15	Hs~Ref:NM_001932.2~uORF:IOH29065	1036	55	981
B38R15C08	38-8-15	Hs~Ref:NM_001932.2~uORF:IOH29065	966	60	906
B38R15C09	38-9-15	Hs~Ref:NM_007106.2~uORF:IOH29272	588	75	513
B38R15C10	38-10-15	Hs~Ref:NM_007106.2~uORF:IOH29272	405	397	8
B38R15C11	38-11-15	Hs~MGC:BC060825.1~uORF:IOH29162	601	68	533
B38R15C12	38-12-15	Hs~MGC:BC060825.1~uORF:IOH29162	1082	50	1032
B38R15C13	38-13-15	Hs~IVGN:PM_2143~Ext:CENPB~N/A	700	46	654
B38R15C14	38-14-15	Hs~IVGN:PM_2143~Ext:CENPB~N/A	688	45	643
B38R15C15	38-15-15	Hs~Ref:NM_006259.1~CAT:PV3973	883	45	838
B38R15C16	38-16-15	Hs~Ref:NM_006259.1~CAT:PV3973	813	52	761
B38R15C17	38-17-15	Hs~Ref:NM_006206.3~CAT:PV3811	151	55	96
B38R15C18	38-18-15	Hs~Ref:NM_006206.3~CAT:PV3811	123	42	81
B38R15C19	38-19-15	Hs~Ref:NM_002020.1~CAT:PV4129	512	41	471
B38R15C20	38-20-15	Hs~Ref:NM_002020.1~CAT:PV4129	500	43	457
B38R15C21	38-21-15	Hs~Ref:NM_182691.1~CAT:PV3829	309	44	265
B38R15C22	38-22-15	Hs~Ref:NM_182691.1~CAT:PV3829	321	45	276
B38R16C01	38-1-16	Hs~Ref:NM_003600.1~CAT:PV3612	1176	47	1129
B38R16C02	38-2-16	Hs~Ref:NM_003600.1~CAT:PV3612	1175	52	1123
B38R16C03	38-3-16	Hs~Ref:NM_002745.2~CAT:PV3313	863	58	805
B38R16C04	38-4-16	Hs~Ref:NM_002745.2~CAT:PV3313	374	57	317
B38R16C05	38-5-16	Hs~Ref:NM_053025.1~CAT:PV4339	111	51	60
B38R16C06	38-6-16	Hs~Ref:NM_053025.1~CAT:PV4339	209	49	160
B38R16C07	38-7-16	Hs~Ref:NM_182724.1~uORF:IOH58633	392	65	327
B38R16C08	38-8-16	Hs~Ref:NM_182724.1~uORF:IOH58633	318	276	42
B38R16C09	38-9-16	Hs~MGC:BC068046.1~uORF:IOH57317	361	77	284
B38R16C10	38-10-16	Hs~MGC:BC068046.1~uORF:IOH57317	284	62	222
B38R16C11	38-11-16	Hs~Ref:NM_016281.2~uORF:IOH54175	488	87	401
B38R16C12	38-12-16	Hs~Ref:NM_016281.2~uORF:IOH54175	365	57	308
B38R16C13	38-13-16	Hs~Ref:NM_181270.1~uORF:IOH58636	550	49	501
B38R16C14	38-14-16	Hs~Ref:NM_181270.1~uORF:IOH58636	540	48	492
B38R16C15	38-15-16	Hs~MGC:BC058074.1~uORF:IOH56524	307	86	221
B38R16C16	38-16-16	Hs~MGC:BC058074.1~uORF:IOH56524	240	78	162
B38R16C17	38-17-16	Hs~Ref:NM_012144.2~uORF:IOH55631	1714	51	1663
B38R16C18	38-18-16	Hs~Ref:NM_012144.2~uORF:IOH55631	1699	44	1655
B38R16C19	38-19-16	Hs~Ref:NM_002507.1~uORF:IOH56378	210	64	146
B38R16C20	38-20-16	Hs~Ref:NM_002507.1~uORF:IOH56378	239	75	164
B38R16C21	38-21-16	Hs~Ref:NM_138285.3~uORF:IOH56483	419	50	369
B38R16C22	38-22-16	Hs~Ref:NM_138285.3~uORF:IOH56483	390	50	340
B38R17C01	38-1-17	Hs~MGC:BC011753.2~uORF:IOH12350	990	47	943
B38R17C02	38-2-17	Hs~MGC:BC011753.2~uORF:IOH12350	826	46	780
B38R17C03	38-3-17	Hs~Ref:NM_020345.3~uORF:IOH12650	688	55	633
B38R17C04	38-4-17	Hs~Ref:NM_020345.3~uORF:IOH12650	407	60	347
B38R17C05	38-5-17	Hs~Ref:NM_024333.1~uORF:IOH4546	951	53	898
B38R17C06	38-6-17	Hs~Ref:NM_024333.1~uORF:IOH4546	833	50	783
B38R17C07	38-7-17	Hs~MGC:BC011735.2~uORF:IOH13045	1531	49	1482
B38R17C08	38-8-17	Hs~MGC:BC011735.2~uORF:IOH13045	1647	50	1597
B38R17C09	38-9-17	Hs~MGC:BC008200.1~uORF:IOH3147	393	55	338
B38R17C10	38-10-17	Hs~MGC:BC008200.1~uORF:IOH3147	383	67	316
B38R17C11	38-11-17	Hs~Ref:NM_014685.1~uORF:IOH4612	268	55	213
B38R17C12	38-12-17	Hs~Ref:NM_014685.1~uORF:IOH4612	299	77	222
B38R17C13	38-13-17	Hs~Ref:NM_020898.1~uORF:IOH5116	459	225	234
B38R17C14	38-14-17	Hs~Ref:NM_020898.1~uORF:IOH5116	443	50	393
B38R17C15	38-15-17	Hs~MGC:BC009046.1~uORF:IOH3394	613	50	563
B38R17C16	38-16-17	Hs~MGC:BC009046.1~uORF:IOH3394	600	51	549
B38R17C17	38-17-17	Hs~Ref:NM_018410.2~uORF:IOH5020	564	56	508
B38R17C18	38-18-17	Hs~Ref:NM_018410.2~uORF:IOH5020	551	48	503
B38R17C19	38-19-17	Hs~MGC:BC051285.1~uORF:IOH28125	371	55	316
B38R17C20	38-20-17	Hs~MGC:BC051285.1~uORF:IOH28125	408	207	201
B38R17C21	38-21-17	Hs~MGC:BC014649.1~uORF:IOH14550	521	74	447
B38R17C22	38-22-17	Hs~MGC:BC014649.1~uORF:IOH14550	463	58	405
B38R18C01	38-1-18	Hs~MGC:BC009074.1~uORF:IOH3371	1679	49	1630
B38R18C02	38-2-18	Hs~MGC:BC009074.1~uORF:IOH3371	1282	49	1233
B38R18C03	38-3-18	Hs~Ref:NM_174901.3~uORF:IOH35161	529	73	456
B38R18C04	38-4-18	Hs~Ref:NM_174901.3~uORF:IOH35161	466	102	364
B38R18C05	38-5-18	Hs~Ref:NM_020866.1~uORF:IOH55673	95	59	36
B38R18C06	38-6-18	Hs~Ref:NM_020866.1~uORF:IOH55673	266	57	209
B38R18C07	38-7-18	Hs~Ref:NM_004546.1~uORF:IOH4818	530	51	479
B38R18C08	38-8-18	Hs~Ref:NM_004546.1~uORF:IOH4818	520	51	469
B38R18C09	38-9-18	Hs~MGC:BC049366.1~uORF:IOH26745	250	91	159
B38R18C10	38-10-18	Hs~MGC:BC049366.1~uORF:IOH26745	386	70	316
B38R18C11	38-11-18	Hs~Ref:NM_182838.1~uORF:IOH43111	369	85	284
B38R18C12	38-12-18	Hs~Ref:NM_182838.1~uORF:IOH43111	252	66	186
B38R18C13	38-13-18	Hs~MGC:BC033886.2~uORF:IOH27178	41	46	-5
B38R18C14	38-14-18	Hs~MGC:BC033886.2~uORF:IOH27178	44	43	1
B38R18C15	38-15-18	Hs~MGC:BC044227.1~uORF:IOH26333	388	50	338
B38R18C16	38-16-18	Hs~MGC:BC044227.1~uORF:IOH26333	409	52	357
B38R18C17	38-17-18	Hs~MGC:BC036846.1~uORF:IOH28739	489	56	433
B38R18C18	38-18-18	Hs~MGC:BC036846.1~uORF:IOH28739	516	50	466
B38R18C19	38-19-18	Hs~Ref:NM_006449.2~uORF:IOH12552	916	51	865
B38R18C20	38-20-18	Hs~Ref:NM_006449.2~uORF:IOH12552	847	59	788
B38R18C21	38-21-18	Hs~MGC:BC033582.1~uORF:IOH22594	508	57	451
B38R18C22	38-22-18	Hs~MGC:BC033582.1~uORF:IOH22594	409	50	359
B38R19C01	38-1-19	Hs~MGC:BC025742.1~uORF:IOH11762	435	57	378
B38R19C02	38-2-19	Hs~MGC:BC025742.1~uORF:IOH11762	500	56	444
B38R19C03	38-3-19	Hs~Ref:NM_006275.2~uORF:IOH3168	809	51	758
B38R19C04	38-4-19	Hs~Ref:NM_006275.2~uORF:IOH3168	1021	50	971
B38R19C05	38-5-19	Hs~Ref:NM_003318.3~uORF:IOH4197	270	67	203
B38R19C06	38-6-19	Hs~Ref:NM_003318.3~uORF:IOH4197	441	52	389
B38R19C07	38-7-19	Hs~Ref:NM_022164.1~uORF:IOH39923	435	55	380
B38R19C08	38-8-19	Hs~Ref:NM_022164.1~uORF:IOH39923	487	172	315
B38R19C09	38-9-19	Hs~MGC:BC015202.2~uORF:IOH39942	3251	52	3199
B38R19C10	38-10-19	Hs~MGC:BC015202.2~uORF:IOH39942	2800	51	2749
B38R19C11	38-11-19	Hs~Ref:NM_020182.3~uORF:IOH41590	956	54	902
B38R19C12	38-12-19	Hs~Ref:NM_020182.3~uORF:IOH41590	1028	55	973
B38R19C13	38-13-19	Hs~MGC:BC024254.1~uORF:IOH13735	1488	48	1440
B38R19C14	38-14-19	Hs~MGC:BC024254.1~uORF:IOH13735	1434	48	1386
B38R19C15	38-15-19	Hs~MGC:BC024030.2~uORF:IOH11924	434	60	374
B38R19C16	38-16-19	Hs~MGC:BC024030.2~uORF:IOH11924	353	61	292
B38R19C17	38-17-19	Hs~Ref:NM_024096.1~uORF:IOH3203	593	66	527
B38R19C18	38-18-19	Hs~Ref:NM_024096.1~uORF:IOH3203	407	54	353
B38R19C19	38-19-19	Hs~MGC:BC066915.1~uORF:IOH61470	379	191	188
B38R19C20	38-20-19	Hs~MGC:BC066915.1~uORF:IOH61470	423	52	371
B38R19C21	38-21-19	Hs~Ref:NM_003765.1~uORF:IOH59047	454	48	406
B38R19C22	38-22-19	Hs~Ref:NM_003765.1~uORF:IOH59047	416	43	373
B38R20C01	38-1-20	Hs~Ref:NM_138452.1~uORF:IOH54999	324	107	217
B38R20C02	38-2-20	Hs~Ref:NM_138452.1~uORF:IOH54999	176	69	107
B38R20C03	38-3-20	Hs~Ref:NM_002811.3~uORF:IOH59072	46	52	-6
B38R20C04	38-4-20	Hs~Ref:NM_002811.3~uORF:IOH59072	42	42	0
B38R20C05	38-5-20	Hs~MGC:BC045626.1~uORF:IOH27484	45	46	-1
B38R20C06	38-6-20	Hs~MGC:BC045626.1~uORF:IOH27484	42	45	-3
B38R20C07	38-7-20	Hs~Ref:NM_012227.1~uORF:IOH57121	515	151	364
B38R20C08	38-8-20	Hs~Ref:NM_012227.1~uORF:IOH57121	482	157	325
B38R20C09	38-9-20	Hs~Ref:NM_007042.1~uORF:IOH56123	197	49	148
B38R20C10	38-10-20	Hs~Ref:NM_007042.1~uORF:IOH56123	339	55	284
B38R20C11	38-11-20	Hs~MGC:BC018029.1~uORF:IOH56012	332	187	145
B38R20C12	38-12-20	Hs~MGC:BC018029.1~uORF:IOH56012	303	121	182
B38R20C13	38-13-20	Hs~Ref:NM_015474.2~uORF:IOH55544	252	57	195
B38R20C14	38-14-20	Hs~Ref:NM_015474.2~uORF:IOH55544	411	49	362
B38R20C15	38-15-20	Hs~MGC:BC033073.1~uORF:IOH23230	294	103	191
B38R20C16	38-16-20	Hs~MGC:BC033073.1~uORF:IOH23230	357	61	296
B38R20C17	38-17-20	Hs~Ref:NM_033343.2~uORF:IOH12989	564	75	489
B38R20C18	38-18-20	Hs~Ref:NM_033343.2~uORF:IOH12989	534	51	483
B38R20C19	38-19-20	Hs~MGC:BC020660.1~uORF:IOH12837	243	88	155
B38R20C20	38-20-20	Hs~MGC:BC020660.1~uORF:IOH12837	258	45	213
B38R20C21	38-21-20	Hs~MGC:BC033165.1~uORF:IOH23231	272	51	221
B38R20C22	38-22-20	Hs~MGC:BC033165.1~uORF:IOH23231	248	47	201
B38R21C01	38-1-21	Hs~Ref:NM_002351.1~uORF:IOH14436	183	58	125
B38R21C02	38-2-21	Hs~Ref:NM_002351.1~uORF:IOH14436	174	56	118
B38R21C03	38-3-21	Hs~Ref:NM_021027.2~uORF:IOH29434	51	53	-2
B38R21C04	38-4-21	Hs~Ref:NM_021027.2~uORF:IOH29434	147	48	99
B38R21C05	38-5-21	Hs~MGC:BC020677.1~uORF:IOH14375	298	55	243
B38R21C06	38-6-21	Hs~MGC:BC020677.1~uORF:IOH14375	162	50	112
B38R21C07	38-7-21	Hs~Ref:NM_025149.3~uORF:IOH12933	326	104	222
B38R21C08	38-8-21	Hs~Ref:NM_025149.3~uORF:IOH12933	320	182	138
B38R21C09	38-9-21	Hs~Ref:NP_056074.1~CAT_11559-H08H-25	44	45	-1
B38R21C10	38-10-21	Hs~Ref:NP_056074.1~CAT_11559-H08H-25	41	48	-7
B38R21C11	38-11-21	Internal_1007209	50	50	0
B38R21C12	38-12-21	Internal_1007209	50	49	1
B38R21C13	38-13-21	Hs~Ref:Q08188~CAT_11923-H07B-25	59	48	11
B38R21C14	38-14-21	Hs~Ref:Q08188~CAT_11923-H07B-25	331	47	284
B38R21C15	38-15-21	Internal_1007209	54	43	11
B38R21C16	38-16-21	Internal_1007209	61	43	18
B38R21C17	38-17-21	Hs~Ref:NP_002328.1~CAT_11100-H08H-25	48	46	2
B38R21C18	38-18-21	Hs~Ref:NP_002328.1~CAT_11100-H08H-25	40	43	-3
B38R21C19	38-19-21	Internal_1007209	40	39	1
B38R21C20	38-20-21	Internal_1007209	43	39	4
B38R21C21	38-21-21	Internal_1007209	42	38	4
B38R21C22	38-22-21	Internal_1007209	112	39	73
B38R22C01	38-1-22	ERa~N/A	2031	52	1979
B38R22C02	38-2-22	ERa~N/A	2111	49	2062
B38R22C03	38-3-22	PKCeta~N/A	345	51	294
B38R22C04	38-4-22	PKCeta~N/A	42	49	-7
B38R22C05	38-5-22	Calmodulin~N/A	334	51	283
B38R22C06	38-6-22	Calmodulin~N/A	154	61	93
B38R22C07	38-7-22	V5control5~N/A	404	47	357
B38R22C08	38-8-22	V5control5~N/A	410	46	364
B38R22C09	38-9-22	V5control4~N/A	232	46	186
B38R22C10	38-10-22	V5control4~N/A	151	48	103
B38R22C11	38-11-22	V5control3~N/A	161	63	98
B38R22C12	38-12-22	V5control3~N/A	171	56	115
B38R22C13	38-13-22	V5control2~N/A	74	46	28
B38R22C14	38-14-22	V5control2~N/A	112	56	56
B38R22C15	38-15-22	V5control1~N/A	323	46	277
B38R22C16	38-16-22	V5control1~N/A	79	44	35
B38R22C17	38-17-22	CMK2A~N/A	435	47	388
B38R22C18	38-18-22	CMK2A~N/A	300	73	227
B38R22C19	38-19-22	ERa~N/A	2382	45	2337
B38R22C20	38-20-22	ERa~N/A	2105	42	2063
B38R22C21	38-21-22	AlexaAntiMouseAb~N/A	9785	39	9746
B38R22C22	38-22-22	AlexaAntiMouseAb~N/A	10825	38	10787
B39R01C01	39-1-1	AlexaAntiMouseAb~N/A	36129	40	36089
B39R01C02	39-2-1	AlexaAntiMouseAb~N/A	36876	41	36835
B39R01C03	39-3-1	ERa~N/A	1787	40	1747
B39R01C04	39-4-1	ERa~N/A	1708	39	1669
B39R01C05	39-5-1	HumanIgG1~N/A	1083	40	1043
B39R01C06	39-6-1	HumanIgG1~N/A	1100	40	1060
B39R01C07	39-7-1	HumanIgG2~N/A	2985	40	2945
B39R01C08	39-8-1	HumanIgG2~N/A	3051	40	3011
B39R01C09	39-9-1	HumanIgG3~N/A	11707	41	11666
B39R01C10	39-10-1	HumanIgG3~N/A	12187	42	12145
B39R01C11	39-11-1	HumanIgG4~N/A	36172	43	36129
B39R01C12	39-12-1	HumanIgG4~N/A	35956	43	35913
B39R01C13	39-13-1	BiotinAb~N/A	50	45	5
B39R01C14	39-14-1	BiotinAb~N/A	160	52	108
B39R01C15	39-15-1	RanBP2deltaFG~N/A	299	43	256
B39R01C16	39-16-1	RanBP2deltaFG~N/A	267	42	225
B39R01C17	39-17-1	hMDM2~N/A	729	43	686
B39R01C18	39-18-1	hMDM2~N/A	708	42	666
B39R01C19	39-19-1	PKCeta~N/A	327	42	285
B39R01C20	39-20-1	PKCeta~N/A	306	42	264
B39R01C21	39-21-1	AlexaAntiMouseAb~N/A	37148	43	37105
B39R01C22	39-22-1	AlexaAntiMouseAb~N/A	33655	43	33612
B39R02C01	39-1-2	PKCeta~N/A	1023	39	984
B39R02C02	39-2-2	PKCeta~N/A	981	41	940
B39R02C03	39-3-2	Buffer	684	41	643
B39R02C04	39-4-2	Buffer	599	40	559
B39R02C05	39-5-2	HumanIgA~N/A	18974	41	18933
B39R02C06	39-6-2	HumanIgA~N/A	19478	42	19436
B39R02C07	39-7-2	Buffer	133	67	66
B39R02C08	39-8-2	Buffer	100	41	59
B39R02C09	39-9-2	BSA~N/A	11414	41	11373
B39R02C10	39-10-2	BSA~N/A	11768	41	11727
B39R02C11	39-11-2	Hs~Ref:NM_182970.2~uORF:IOH43687	477	42	435
B39R02C12	39-12-2	Hs~Ref:NM_182970.2~uORF:IOH43687	468	45	423
B39R02C13	39-13-2	Hs~Ref:NM_178582.1~uORF:IOH42341	207	48	159
B39R02C14	39-14-2	Hs~Ref:NM_178582.1~uORF:IOH42341	182	60	122
B39R02C15	39-15-2	Hs~Ref:NM_079420.1~uORF:IOH42932	5486	47	5439
B39R02C16	39-16-2	Hs~Ref:NM_079420.1~uORF:IOH42932	5262	43	5219
B39R02C17	39-17-2	Hs~Ref:NM_025233.4~uORF:IOH40019	789	42	747
B39R02C18	39-18-2	Hs~Ref:NM_025233.4~uORF:IOH40019	767	42	725
B39R02C19	39-19-2	Hs~Ref:XM_378879.2~uORF:IOH42915	398	43	355
B39R02C20	39-20-2	Hs~Ref:XM_378879.2~uORF:IOH42915	415	43	372
B39R02C21	39-21-2	Hs~Ref:NM_178859.2~uORF:IOH43037	153	47	106
B39R02C22	39-22-2	Hs~Ref:NM_178859.2~uORF:IOH43037	148	50	98
B39R03C01	39-1-3	Hs~Ref:XM_211837.1~uORF:IOH44771	267	39	228
B39R03C02	39-2-3	Hs~Ref:XM_211837.1~uORF:IOH44771	263	42	221
B39R03C03	39-3-3	Hs~Ref:XM_373810.3~uORF:IOH43114	280	44	236
B39R03C04	39-4-3	Hs~Ref:XM_373810.3~uORF:IOH43114	274	44	230
B39R03C05	39-5-3	Hs~MGC:BC008651.1~uORF:IOH3382	400	44	356
B39R03C06	39-6-3	Hs~MGC:BC008651.1~uORF:IOH3382	386	44	342
B39R03C07	39-7-3	Hs~MGC:BC002656.1~uORF:IOH5254	327	56	271
B39R03C08	39-8-3	Hs~MGC:BC002656.1~uORF:IOH5254	328	51	277
B39R03C09	39-9-3	Hs~Ref:NM_032213.2~uORF:IOH13135	973	43	930
B39R03C10	39-10-3	Hs~Ref:NM_032213.2~uORF:IOH13135	957	42	915
B39R03C11	39-11-3	Hs~Ref:NM_007083.2~uORF:IOH12334	482	45	437
B39R03C12	39-12-3	Hs~Ref:NM_007083.2~uORF:IOH12334	468	46	422
B39R03C13	39-13-3	Hs~MGC:BC008567.1~uORF:IOH3328	206	48	158
B39R03C14	39-14-3	Hs~MGC:BC008567.1~uORF:IOH3328	201	50	151
B39R03C15	39-15-3	Hs~MGC:BC010896.1~uORF:IOH14253	475	45	430
B39R03C16	39-16-3	Hs~MGC:BC010896.1~uORF:IOH14253	450	44	406
B39R03C17	39-17-3	Hs~MGC:BC003366.1~uORF:IOH2912	368	54	314
B39R03C18	39-18-3	Hs~MGC:BC003366.1~uORF:IOH2912	363	52	311
B39R03C19	39-19-3	Hs~MGC:BC017064.1~uORF:IOH11279	334	44	290
B39R03C20	39-20-3	Hs~MGC:BC017064.1~uORF:IOH11279	360	51	309
B39R03C21	39-21-3	Hs~Ref:NM_014481.2~uORF:IOH4887	36468	50	36418
B39R03C22	39-22-3	Hs~Ref:NM_014481.2~uORF:IOH4887	33877	50	33827
B39R04C01	39-1-4	Hs~MGC:BC005233.1~uORF:IOH7235	182	66	116
B39R04C02	39-2-4	Hs~MGC:BC005233.1~uORF:IOH7235	201	152	49
B39R04C03	39-3-4	Hs~Ref:NM_145045.1~uORF:IOH13104	402	51	351
B39R04C04	39-4-4	Hs~Ref:NM_145045.1~uORF:IOH13104	379	62	317
B39R04C05	39-5-4	Hs~Ref:NM_005258.2~uORF:IOH1566	475	47	428
B39R04C06	39-6-4	Hs~Ref:NM_005258.2~uORF:IOH1566	426	46	380
B39R04C07	39-7-4	Hs~MGC:BC007874.2~uORF:IOH6696	319	46	273
B39R04C08	39-8-4	Hs~MGC:BC007874.2~uORF:IOH6696	288	47	241
B39R04C09	39-9-4	Hs~MGC:BC015752.1~uORF:IOH12141	411	47	364
B39R04C10	39-10-4	Hs~MGC:BC015752.1~uORF:IOH12141	436	47	389
B39R04C11	39-11-4	Hs~MGC:BC005254.1~uORF:IOH7277	121	43	78
B39R04C12	39-12-4	Hs~MGC:BC005254.1~uORF:IOH7277	175	77	98
B39R04C13	39-13-4	Hs~Ref:NM_024678.2~uORF:IOH6715	268	111	157
B39R04C14	39-14-4	Hs~Ref:NM_024678.2~uORF:IOH6715	61	49	12
B39R04C15	39-15-4	Hs~Ref:NM_013319.1~uORF:IOH5671	601	51	550
B39R04C16	39-16-4	Hs~Ref:NM_013319.1~uORF:IOH5671	575	52	523
B39R04C17	39-17-4	Hs~MGC:BC001258.1~uORF:IOH3053	551	58	493
B39R04C18	39-18-4	Hs~MGC:BC001258.1~uORF:IOH3053	474	52	422
B39R04C19	39-19-4	Hs~MGC:BC004248.1~uORF:IOH5475	424	45	379
B39R04C20	39-20-4	Hs~MGC:BC004248.1~uORF:IOH5475	411	46	365
B39R04C21	39-21-4	Hs~Ref:NM_012289.2~uORF:IOH5732	20848	51	20797
B39R04C22	39-22-4	Hs~Ref:NM_012289.2~uORF:IOH5732	19199	49	19150
B39R05C01	39-1-5	Hs~MGC:BC014538.1~uORF:IOH12144	584	65	519
B39R05C02	39-2-5	Hs~MGC:BC014538.1~uORF:IOH12144	631	73	558
B39R05C03	39-3-5	Hs~MGC:BC010915.1~uORF:IOH12222	771	47	724
B39R05C04	39-4-5	Hs~MGC:BC010915.1~uORF:IOH12222	816	45	771
B39R05C05	39-5-5	Hs~MGC:BC012573.1~uORF:IOH12159	547	44	503
B39R05C06	39-6-5	Hs~MGC:BC012573.1~uORF:IOH12159	558	43	515
B39R05C07	39-7-5	Hs~MGC:BC012626.1~uORF:IOH12346	1085	43	1042
B39R05C08	39-8-5	Hs~MGC:BC012626.1~uORF:IOH12346	1056	44	1012
B39R05C09	39-9-5	Hs~MGC:BC014244.1~uORF:IOH12917	264	133	131
B39R05C10	39-10-5	Hs~MGC:BC014244.1~uORF:IOH12917	203	52	151
B39R05C11	39-11-5	Hs~Ref:NM_004762.1~uORF:IOH26691	3151	42	3109
B39R05C12	39-12-5	Hs~Ref:NM_004762.1~uORF:IOH26691	2986	42	2944
B39R05C13	39-13-5	Hs~MGC:BC051838.1~uORF:IOH27071	296	48	248
B39R05C14	39-14-5	Hs~MGC:BC051838.1~uORF:IOH27071	41	74	-33
B39R05C15	39-15-5	Hs~Ref:NM_005902.1~uORF:IOH27044	320	258	62
B39R05C16	39-16-5	Hs~Ref:NM_005902.1~uORF:IOH27044	317	87	230
B39R05C17	39-17-5	Hs~Ref:NM_024552.1~uORF:IOH12136	421	46	375
B39R05C18	39-18-5	Hs~Ref:NM_024552.1~uORF:IOH12136	380	45	335
B39R05C19	39-19-5	Hs~Ref:NM_004866.2~uORF:IOH12951	357	46	311
B39R05C20	39-20-5	Hs~Ref:NM_004866.2~uORF:IOH12951	397	46	351
B39R05C21	39-21-5	Hs~Ref:NM_002300.2~uORF:IOH3646	43	56	-13
B39R05C22	39-22-5	Hs~Ref:NM_002300.2~uORF:IOH3646	41	83	-42
B39R06C01	39-1-6	Hs~Ref:NM_006321.1~uORF:IOH3683	363	110	253
B39R06C02	39-2-6	Hs~Ref:NM_006321.1~uORF:IOH3683	409	107	302
B39R06C03	39-3-6	Hs~Ref:NM_182728.1~uORF:IOH45748	149	44	105
B39R06C04	39-4-6	Hs~Ref:NM_182728.1~uORF:IOH45748	115	45	70
B39R06C05	39-5-6	Hs~Ref:NM_175040.1~uORF:IOH45799	255	44	211
B39R06C06	39-6-6	Hs~Ref:NM_175040.1~uORF:IOH45799	315	43	272
B39R06C07	39-7-6	Hs~Ref:NM_206836.1~uORF:IOH45844	249	61	188
B39R06C08	39-8-6	Hs~Ref:NM_206836.1~uORF:IOH45844	214	67	147
B39R06C09	39-9-6	Hs~Ref:NM_016400.2~uORF:IOH45779	342	160	182
B39R06C10	39-10-6	Hs~Ref:NM_016400.2~uORF:IOH45779	339	71	268
B39R06C11	39-11-6	Hs~MGC:BC011975.1~uORF:IOH10480	450	42	408
B39R06C12	39-12-6	Hs~MGC:BC011975.1~uORF:IOH10480	438	42	396
B39R06C13	39-13-6	Hs~Ref:NM_002608.1~uORF:IOH22794	425	44	381
B39R06C14	39-14-6	Hs~Ref:NM_002608.1~uORF:IOH22794	445	45	400
B39R06C15	39-15-6	Hs~MGC:BC022341.1~uORF:IOH14769	462	45	417
B39R06C16	39-16-6	Hs~MGC:BC022341.1~uORF:IOH14769	446	45	401
B39R06C17	39-17-6	Hs~MGC:BC031592.1~uORF:IOH22703	502	46	456
B39R06C18	39-18-6	Hs~MGC:BC031592.1~uORF:IOH22703	448	48	400
B39R06C19	39-19-6	Hs~Ref:NM_003677.3~uORF:IOH56971	105	49	56
B39R06C20	39-20-6	Hs~Ref:NM_003677.3~uORF:IOH56971	105	48	57
B39R06C21	39-21-6	Hs~Ref:NM_032730.3~uORF:IOH56958	40	64	-24
B39R06C22	39-22-6	Hs~Ref:NM_032730.3~uORF:IOH56958	51	58	-7
B39R07C01	39-1-7	Hs~Ref:NM_006544.3~uORF:IOH55643	407	43	364
B39R07C02	39-2-7	Hs~Ref:NM_006544.3~uORF:IOH55643	383	48	335
B39R07C03	39-3-7	Hs~Ref:NM_032298.1~uORF:IOH55503	507	42	465
B39R07C04	39-4-7	Hs~Ref:NM_032298.1~uORF:IOH55503	453	43	410
B39R07C05	39-5-7	Hs~MGC:BC015186.1~uORF:IOH12980	263	44	219
B39R07C06	39-6-7	Hs~MGC:BC015186.1~uORF:IOH12980	261	66	195
B39R07C07	39-7-7	Hs~Ref:NM_013410.1~uORF:IOH13992	164	95	69
B39R07C08	39-8-7	Hs~Ref:NM_013410.1~uORF:IOH13992	229	48	181
B39R07C09	39-9-7	Hs~Ref:NM_005565.2~uORF:IOH11014	1082	42	1040
B39R07C10	39-10-7	Hs~Ref:NM_005565.2~uORF:IOH11014	1000	41	959
B39R07C11	39-11-7	Hs~Ref:NM_001721.2~uORF:IOH11645	517	42	475
B39R07C12	39-12-7	Hs~Ref:NM_001721.2~uORF:IOH11645	469	43	426
B39R07C13	39-13-7	Hs~Ref:NM_005002.3~uORF:IOH13734	629	42	587
B39R07C14	39-14-7	Hs~Ref:NM_005002.3~uORF:IOH13734	624	42	582
B39R07C15	39-15-7	Hs~MGC:BC027609.2~uORF:IOH11601	418	46	372
B39R07C16	39-16-7	Hs~MGC:BC027609.2~uORF:IOH11601	418	48	370
B39R07C17	39-17-7	Hs~Ref:NM_017868.2~uORF:IOH21721	150	54	96
B39R07C18	39-18-7	Hs~Ref:NM_017868.2~uORF:IOH21721	140	58	82
B39R07C19	39-19-7	Hs~Ref:NM_016584.2~uORF:IOH39400	52	59	-7
B39R07C20	39-20-7	Hs~Ref:NM_016584.2~uORF:IOH39400	42	61	-19
B39R07C21	39-21-7	Hs~Ref:NM_021913.2~N/A	264	54	210
B39R07C22	39-22-7	Hs~Ref:NM_021913.2~N/A	462	45	417
B39R08C01	39-1-8	Hs~Ref:NM_005211.1~N/A	458	44	414
B39R08C02	39-2-8	Hs~Ref:NM_005211.1~N/A	443	46	397
B39R08C03	39-3-8	Hs~Ref:NM_006343.1~N/A	399	46	353
B39R08C04	39-4-8	Hs~Ref:NM_006343.1~N/A	397	47	350
B39R08C05	39-5-8	Hs~Ref:NM_002530.1~N/A	566	46	520
B39R08C06	39-6-8	Hs~Ref:NM_002530.1~N/A	557	47	510
B39R08C07	39-7-8	Hs~Ref:NM_032112.1~uORF:IOH25749	724	45	679
B39R08C08	39-8-8	Hs~Ref:NM_032112.1~uORF:IOH25749	700	45	655
B39R08C09	39-9-8	Hs~MGC:BC036197.1~uORF:IOH27500	4076	42	4034
B39R08C10	39-10-8	Hs~MGC:BC036197.1~uORF:IOH27500	4057	41	4016
B39R08C11	39-11-8	Hs~MGC:NM_178838.2~uORF:IOH23233	584	43	541
B39R08C12	39-12-8	Hs~MGC:NM_178838.2~uORF:IOH23233	607	43	564
B39R08C13	39-13-8	Hs~Ref:NM_016210.1~uORF:IOH22819	452	44	408
B39R08C14	39-14-8	Hs~Ref:NM_016210.1~uORF:IOH22819	446	43	403
B39R08C15	39-15-8	Hs~Ref:NM_021268.1~uORF:IOH35234	494	46	448
B39R08C16	39-16-8	Hs~Ref:NM_021268.1~uORF:IOH35234	500	49	451
B39R08C17	39-17-8	Hs~Ref:NM_006590.2~uORF:IOH45672	1511	54	1457
B39R08C18	39-18-8	Hs~Ref:NM_006590.2~uORF:IOH45672	1494	54	1440
B39R08C19	39-19-8	Hs~MGC:BC031687.1~uORF:IOH21501	1607	56	1551
B39R08C20	39-20-8	Hs~MGC:BC031687.1~uORF:IOH21501	1565	52	1513
B39R08C21	39-21-8	Hs~Ref:NM_007041.2~uORF:IOH45551	603	48	555
B39R08C22	39-22-8	Hs~Ref:NM_007041.2~uORF:IOH45551	546	45	501
B39R09C01	39-1-9	Hs~Ref:NM_152277.1~uORF:IOH11072	228	60	168
B39R09C02	39-2-9	Hs~Ref:NM_152277.1~uORF:IOH11072	205	47	158
B39R09C03	39-3-9	Hs~MGC:BC018302.1~uORF:IOH10233	277	57	220
B39R09C04	39-4-9	Hs~MGC:BC018302.1~uORF:IOH10233	213	114	99
B39R09C05	39-5-9	Hs~MGC:BC025682.1~uORF:IOH10827	4687	46	4641
B39R09C06	39-6-9	Hs~MGC:BC025682.1~uORF:IOH10827	4464	44	4420
B39R09C07	39-7-9	Hs~Ref:NM_013943.1~uORF:IOH10508	387	46	341
B39R09C08	39-8-9	Hs~Ref:NM_013943.1~uORF:IOH10508	415	50	365
B39R09C09	39-9-9	Hs~Ref:NM_000849.1~uORF:IOH4761	152	46	106
B39R09C10	39-10-9	Hs~Ref:NM_000849.1~uORF:IOH4761	167	44	123
B39R09C11	39-11-9	Hs~MGC:BC007633.1~uORF:IOH6965	358	41	317
B39R09C12	39-12-9	Hs~MGC:BC007633.1~uORF:IOH6965	315	43	272
B39R09C13	39-13-9	Hs~MGC:BC007526.1~uORF:IOH6827	265	52	213
B39R09C14	39-14-9	Hs~MGC:BC007526.1~uORF:IOH6827	231	47	184
B39R09C15	39-15-9	Hs~Ref:NM_003574.2~uORF:IOH5040	360	45	315
B39R09C16	39-16-9	Hs~Ref:NM_003574.2~uORF:IOH5040	366	52	314
B39R09C17	39-17-9	Hs~Ref:NM_201625.1~uORF:IOH41017	132	44	88
B39R09C18	39-18-9	Hs~Ref:NM_201625.1~uORF:IOH41017	128	44	84
B39R09C19	39-19-9	Hs~MGC:BC022812.1~uORF:IOH46102	42	49	-7
B39R09C20	39-20-9	Hs~MGC:BC022812.1~uORF:IOH46102	125	45	80
B39R09C21	39-21-9	Hs~Ref:NM_198175.1~uORF:IOH41255	351	71	280
B39R09C22	39-22-9	Hs~Ref:NM_198175.1~uORF:IOH41255	323	47	276
B39R10C01	39-1-10	Hs~MGC:BC001852.2~uORF:IOH46107	292	42	250
B39R10C02	39-2-10	Hs~MGC:BC001852.2~uORF:IOH46107	258	49	209
B39R10C03	39-3-10	Hs~Ref:NM_007172.2~uORF:IOH40805	3534	42	3492
B39R10C04	39-4-10	Hs~Ref:NM_007172.2~uORF:IOH40805	3495	41	3454
B39R10C05	39-5-10	Hs~MGC:BC067080.1~uORF:IOH40666	321	42	279
B39R10C06	39-6-10	Hs~MGC:BC067080.1~uORF:IOH40666	306	41	265
B39R10C07	39-7-10	Hs~MGC:BC062736.1~uORF:IOH40707	763	42	721
B39R10C08	39-8-10	Hs~MGC:BC062736.1~uORF:IOH40707	718	42	676
B39R10C09	39-9-10	Hs~Ref:NM_207350.1~uORF:IOH40748	9349	43	9306
B39R10C10	39-10-10	Hs~Ref:NM_207350.1~uORF:IOH40748	9330	41	9289
B39R10C11	39-11-10	GST1	41	39	2
B39R10C12	39-12-10	GST1	43	40	3
B39R10C13	39-13-10	GST2	47	39	8
B39R10C14	39-14-10	GST2	46	40	6
B39R10C15	39-15-10	GST3	55	40	15
B39R10C16	39-16-10	GST3	56	40	16
B39R10C17	39-17-10	GST4	81	39	42
B39R10C18	39-18-10	GST4	82	41	41
B39R10C19	39-19-10	Anti-HumanIgA1~N/A	6547	41	6506
B39R10C20	39-20-10	Anti-HumanIgA1~N/A	6491	41	6450
B39R10C21	39-21-10	Anti-HumanIgA2~N/A	12598	44	12554
B39R10C22	39-22-10	Anti-HumanIgA2~N/A	12587	43	12544
B39R11C01	39-1-11	AlexaAntiMouseAb~N/A	30798	40	30758
B39R11C02	39-2-11	AlexaAntiMouseAb~N/A	27794	42	27752
B39R11C03	39-3-11	MAPKAP~N/A	76	41	35
B39R11C04	39-4-11	MAPKAP~N/A	74	39	35
B39R11C05	39-5-11	Buffer	118	48	70
B39R11C06	39-6-11	Buffer	108	58	50
B39R11C07	39-7-11	BSA~N/A	7500	41	7459
B39R11C08	39-8-11	BSA~N/A	7663	42	7621
B39R11C09	39-9-11	Anti-HumanIgG1~N/A	1393	41	1352
B39R11C10	39-10-11	Anti-HumanIgG1~N/A	1316	41	1275
B39R11C11	39-11-11	Anti-HumanIgG2~N/A	2631	40	2591
B39R11C12	39-12-11	Anti-HumanIgG2~N/A	2450	40	2410
B39R11C13	39-13-11	Anti-HumanIgG3~N/A	4565	40	4525
B39R11C14	39-14-11	Anti-HumanIgG3~N/A	4140	40	4100
B39R11C15	39-15-11	Anti-HumanIgG4~N/A	7788	41	7747
B39R11C16	39-16-11	Anti-HumanIgG4~N/A	7251	41	7210
B39R11C17	39-17-11	AntiBiotinAb~N/A	8516	41	8475
B39R11C18	39-18-11	AntiBiotinAb~N/A	2121	41	2080
B39R11C19	39-19-11	Buffer	44	41	3
B39R11C20	39-20-11	Buffer	45	42	3
B39R11C21	39-21-11	Hs~MGC:BC011795.2~uORF:IOH13069	154	46	108
B39R11C22	39-22-11	Hs~MGC:BC011795.2~uORF:IOH13069	202	59	143
B39R12C01	39-1-12	Hs~Ref:NM_001190.2~uORF:IOH4883	175	58	117
B39R12C02	39-2-12	Hs~Ref:NM_001190.2~uORF:IOH4883	111	41	70
B39R12C03	39-3-12	Hs~Ref:NM_004725.2~uORF:IOH4613	169	86	83
B39R12C04	39-4-12	Hs~Ref:NM_004725.2~uORF:IOH4613	197	42	155
B39R12C05	39-5-12	Hs~MGC:BC000453.2~uORF:IOH3516	339	43	296
B39R12C06	39-6-12	Hs~MGC:BC000453.2~uORF:IOH3516	335	77	258
B39R12C07	39-7-12	Hs~MGC:BC007207.1~uORF:IOH6669	314	45	269
B39R12C08	39-8-12	Hs~MGC:BC007207.1~uORF:IOH6669	329	47	282
B39R12C09	39-9-12	Hs~MGC:BC017943.1~uORF:IOH12235	541	45	496
B39R12C10	39-10-12	Hs~MGC:BC017943.1~uORF:IOH12235	527	43	484
B39R12C11	39-11-12	Hs~MGC:BC029032.1~uORF:IOH22628	311	49	262
B39R12C12	39-12-12	Hs~MGC:BC029032.1~uORF:IOH22628	151	49	102
B39R12C13	39-13-12	Hs~Ref:NM_024059.2~uORF:IOH2960	515	43	472
B39R12C14	39-14-12	Hs~Ref:NM_024059.2~uORF:IOH2960	477	42	435
B39R12C15	39-15-12	Hs~Ref:NM_207283.1~uORF:IOH50062	807	42	765
B39R12C16	39-16-12	Hs~Ref:NM_207283.1~uORF:IOH50062	745	43	702
B39R12C17	39-17-12	Hs~Ref:XM_375307.2~uORF:IOH44530	578	44	534
B39R12C18	39-18-12	Hs~Ref:XM_375307.2~uORF:IOH44530	604	43	561
B39R12C19	39-19-12	Hs~Ref:NM_080918.1~uORF:IOH44424	100	41	59
B39R12C20	39-20-12	Hs~Ref:NM_080918.1~uORF:IOH44424	610	41	569
B39R12C21	39-21-12	Hs~Ref:NM_198216.1~uORF:IOH44674	850	42	808
B39R12C22	39-22-12	Hs~Ref:NM_198216.1~uORF:IOH44674	838	41	797
B39R13C01	39-1-13	Hs~Ref:NM_004574.2~uORF:IOH29562	257	40	217
B39R13C02	39-2-13	Hs~Ref:NM_004574.2~uORF:IOH29562	245	43	202
B39R13C03	39-3-13	Hs~Ref:NM_032781.2~uORF:IOH29621	234	47	187
B39R13C04	39-4-13	Hs~Ref:NM_032781.2~uORF:IOH29621	244	71	173
B39R13C05	39-5-13	Hs~MGC:BC000914.1~uORF:IOH2971	568	40	528
B39R13C06	39-6-13	Hs~MGC:BC000914.1~uORF:IOH2971	561	41	520
B39R13C07	39-7-13	Hs~MGC:BC039039.1~uORF:IOH27465	679	42	637
B39R13C08	39-8-13	Hs~MGC:BC039039.1~uORF:IOH27465	696	41	655
B39R13C09	39-9-13	Hs~Ref:NM_001005753.1~uORF:IOH45855	337	41	296
B39R13C10	39-10-13	Hs~Ref:NM_001005753.1~uORF:IOH45855	344	40	304
B39R13C11	39-11-13	Hs~Ref:NM_197967.1~uORF:IOH45743	396	42	354
B39R13C12	39-12-13	Hs~Ref:NM_197967.1~uORF:IOH45743	321	42	279
B39R13C13	39-13-13	Hs~Ref:NM_145863.1~uORF:IOH45865	409	44	365
B39R13C14	39-14-13	Hs~Ref:NM_145863.1~uORF:IOH45865	383	44	339
B39R13C15	39-15-13	Hs~Ref:NM_004178.3~uORF:IOH45867	155	98	57
B39R13C16	39-16-13	Hs~Ref:NM_004178.3~uORF:IOH45867	102	73	29
B39R13C17	39-17-13	Hs~MGC:BC013385.1~uORF:IOH12422	450	47	403
B39R13C18	39-18-13	Hs~MGC:BC013385.1~uORF:IOH12422	370	46	324
B39R13C19	39-19-13	Hs~MGC:BC012933.1~uORF:IOH11173	505	43	462
B39R13C20	39-20-13	Hs~MGC:BC012933.1~uORF:IOH11173	906	40	866
B39R13C21	39-21-13	Hs~MGC:BC016996.1~uORF:IOH11935	297	41	256
B39R13C22	39-22-13	Hs~MGC:BC016996.1~uORF:IOH11935	306	44	262
B39R14C01	39-1-14	Hs~MGC:BC012865.1~uORF:IOH11604	422	42	380
B39R14C02	39-2-14	Hs~MGC:BC012865.1~uORF:IOH11604	401	43	358
B39R14C03	39-3-14	Hs~Ref:NM_152387.2~uORF:IOH53987	3242	45	3197
B39R14C04	39-4-14	Hs~Ref:NM_152387.2~uORF:IOH53987	3087	43	3044
B39R14C05	39-5-14	Hs~Ref:NM_013367.2~uORF:IOH54154	223	40	183
B39R14C06	39-6-14	Hs~Ref:NM_013367.2~uORF:IOH54154	236	81	155
B39R14C07	39-7-14	Hs~Ref:NM_002404.1~uORF:IOH53871	229	65	164
B39R14C08	39-8-14	Hs~Ref:NM_002404.1~uORF:IOH53871	98	41	57
B39R14C09	39-9-14	Hs~Ref:NM_032738.3~uORF:IOH53952	317	52	265
B39R14C10	39-10-14	Hs~Ref:NM_032738.3~uORF:IOH53952	191	40	151
B39R14C11	39-11-14	Hs~MGC:XM_376503.1~uORF:IOH11280	232	46	186
B39R14C12	39-12-14	Hs~MGC:XM_376503.1~uORF:IOH11280	245	44	201
B39R14C13	39-13-14	Hs~Ref:NM_005398.2~uORF:IOH13809	348	63	285
B39R14C14	39-14-14	Hs~Ref:NM_005398.2~uORF:IOH13809	323	44	279
B39R14C15	39-15-14	Hs~Ref:NM_016322.2~uORF:IOH6559	314	49	265
B39R14C16	39-16-14	Hs~Ref:NM_016322.2~uORF:IOH6559	368	88	280
B39R14C17	39-17-14	Hs~Ref:NM_002143.2~uORF:IOH4454	425	42	383
B39R14C18	39-18-14	Hs~Ref:NM_002143.2~uORF:IOH4454	389	42	347
B39R14C19	39-19-14	Hs~Ref:NM_000673.3~uORF:IOH60854	419	40	379
B39R14C20	39-20-14	Hs~Ref:NM_000673.3~uORF:IOH60854	418	41	377
B39R14C21	39-21-14	Hs~Ref:BC015062.1~uORF:IOH62805	329	41	288
B39R14C22	39-22-14	Hs~Ref:BC015062.1~uORF:IOH62805	262	41	221
B39R15C01	39-1-15	Hs~MGC:BC036523.1~uORF:IOH62112	429	42	387
B39R15C02	39-2-15	Hs~MGC:BC036523.1~uORF:IOH62112	459	44	415
B39R15C03	39-3-15	Hs~MGC:BC036218.1~uORF:IOH62176	416	42	374
B39R15C04	39-4-15	Hs~MGC:BC036218.1~uORF:IOH62176	296	41	255
B39R15C05	39-5-15	Hs~MGC:BC012736.2~uORF:IOH14394	331	41	290
B39R15C06	39-6-15	Hs~MGC:BC012736.2~uORF:IOH14394	379	45	334
B39R15C07	39-7-15	Hs~MGC:BC056148.1~uORF:IOH29121	524	40	484
B39R15C08	39-8-15	Hs~MGC:BC056148.1~uORF:IOH29121	538	41	497
B39R15C09	39-9-15	Hs~MGC:BC041632.1~uORF:IOH29353	192	42	150
B39R15C10	39-10-15	Hs~MGC:BC041632.1~uORF:IOH29353	183	111	72
B39R15C11	39-11-15	Hs~MGC:BC015596.1~uORF:IOH29335	227	59	168
B39R15C12	39-12-15	Hs~MGC:BC015596.1~uORF:IOH29335	188	43	145
B39R15C13	39-13-15	Hs~IVGN:PM_2129~Ext:CCP_10BSA~N/A	10005	41	9964
B39R15C14	39-14-15	Hs~IVGN:PM_2129~Ext:CCP_10BSA~N/A	10092	41	10051
B39R15C15	39-15-15	Hs~N/A:NM_001007792.1~CAT:PV3144	138	39	99
B39R15C16	39-16-15	Hs~N/A:NM_001007792.1~CAT:PV3144	190	42	148
B39R15C17	39-17-15	Hs~Ref:NM_006282.1~CAT:PV3854	117	40	77
B39R15C18	39-18-15	Hs~Ref:NM_006282.1~CAT:PV3854	243	87	156
B39R15C19	39-19-15	Hs~Ref:NM_000294.1~CAT:PV4555	74	42	32
B39R15C20	39-20-15	Hs~Ref:NM_000294.1~CAT:PV4555	82	41	41
B39R15C21	39-21-15	Hs~Ref:NM_004439.4~CAT:PV3840	83	40	43
B39R15C22	39-22-15	Hs~Ref:NM_004439.4~CAT:PV3840	183	64	119
B39R16C01	39-1-16	Hs~Ref:NM_001569.2~CAT:PV4403	440	42	398
B39R16C02	39-2-16	Hs~Ref:NM_001569.2~CAT:PV4403	375	52	323
B39R16C03	39-3-16	Hs~Ref:NM_198578.2~CAT:PV4873	302	42	260
B39R16C04	39-4-16	Hs~Ref:NM_198578.2~CAT:PV4873	361	45	316
B39R16C05	39-5-16	Hs~Ref:NM_004935.1~CAT:PV4676	1216	39	1177
B39R16C06	39-6-16	Hs~Ref:NM_004935.1~CAT:PV4676	1194	40	1154
B39R16C07	39-7-16	Hs~Ref:NM_012282.2~uORF:IOH27351	405	41	364
B39R16C08	39-8-16	Hs~Ref:NM_012282.2~uORF:IOH27351	390	42	348
B39R16C09	39-9-16	Hs~MGC:BC016985.2~uORF:IOH28621	824	40	784
B39R16C10	39-10-16	Hs~MGC:BC016985.2~uORF:IOH28621	822	41	781
B39R16C11	39-11-16	Hs~Ref:NM_153486.2~uORF:IOH26957	474	42	432
B39R16C12	39-12-16	Hs~Ref:NM_153486.2~uORF:IOH26957	478	42	436
B39R16C13	39-13-16	Hs~MGC:BC047782.1~uORF:IOH26739	456	41	415
B39R16C14	39-14-16	Hs~MGC:BC047782.1~uORF:IOH26739	457	41	416
B39R16C15	39-15-16	Hs~MGC:BC016442.1~uORF:IOH28612	349	41	308
B39R16C16	39-16-16	Hs~MGC:BC016442.1~uORF:IOH28612	369	41	328
B39R16C17	39-17-16	Hs~MGC:BC039323.1~uORF:IOH28719	675	41	634
B39R16C18	39-18-16	Hs~MGC:BC039323.1~uORF:IOH28719	642	43	599
B39R16C19	39-19-16	Hs~MGC:BC060760.1~uORF:IOH29142	277	47	230
B39R16C20	39-20-16	Hs~MGC:BC060760.1~uORF:IOH29142	288	50	238
B39R16C21	39-21-16	Hs~MGC:BC053646.1~uORF:IOH28946	586	44	542
B39R16C22	39-22-16	Hs~MGC:BC053646.1~uORF:IOH28946	558	41	517
B39R17C01	39-1-17	Hs~MGC:BC060870.1~uORF:IOH62447	511	42	469
B39R17C02	39-2-17	Hs~MGC:BC060870.1~uORF:IOH62447	360	45	315
B39R17C03	39-3-17	Hs~Ref:NM_006144.2~uORF:IOH14828	490	42	448
B39R17C04	39-4-17	Hs~Ref:NM_006144.2~uORF:IOH14828	471	41	430
B39R17C05	39-5-17	Hs~MGC:NM_152552.1~uORF:IOH22758	663	39	624
B39R17C06	39-6-17	Hs~MGC:NM_152552.1~uORF:IOH22758	646	40	606
B39R17C07	39-7-17	Hs~Ref:NM_145250.1~uORF:IOH11197	474	40	434
B39R17C08	39-8-17	Hs~Ref:NM_145250.1~uORF:IOH11197	454	41	413
B39R17C09	39-9-17	Hs~Ref:NM_018384.1~uORF:IOH12230	398	41	357
B39R17C10	39-10-17	Hs~Ref:NM_018384.1~uORF:IOH12230	351	43	308
B39R17C11	39-11-17	Hs~Ref:NM_005105.2~uORF:IOH10383	364	42	322
B39R17C12	39-12-17	Hs~Ref:NM_005105.2~uORF:IOH10383	344	41	303
B39R17C13	39-13-17	Hs~Ref:NM_004049.2~uORF:IOH10128	70	40	30
B39R17C14	39-14-17	Hs~Ref:NM_004049.2~uORF:IOH10128	90	60	30
B39R17C15	39-15-17	Hs~Ref:NM_003342.2~uORF:IOH5319	252	66	186
B39R17C16	39-16-17	Hs~Ref:NM_003342.2~uORF:IOH5319	179	43	136
B39R17C17	39-17-17	Hs~MGC:BC032851.2~uORF:IOH27168	745	42	703
B39R17C18	39-18-17	Hs~MGC:BC032851.2~uORF:IOH27168	688	43	645
B39R17C19	39-19-17	Hs~Ref:NM_014899.2~uORF:IOH25836	182	46	136
B39R17C20	39-20-17	Hs~Ref:NM_014899.2~uORF:IOH25836	70	45	25
B39R17C21	39-21-17	Hs~Ref:NM_058217.1~uORF:IOH4338	289	99	190
B39R17C22	39-22-17	Hs~Ref:NM_058217.1~uORF:IOH4338	142	41	101
B39R18C01	39-1-18	Hs~MGC:NM_174940.1~uORF:IOH3344	174	39	135
B39R18C02	39-2-18	Hs~MGC:NM_174940.1~uORF:IOH3344	824	49	775
B39R18C03	39-3-18	Hs~MGC:BC017337.1~uORF:IOH13947	589	57	532
B39R18C04	39-4-18	Hs~MGC:BC017337.1~uORF:IOH13947	521	74	447
B39R18C05	39-5-18	Hs~Ref:NM_032459.1~uORF:IOH21413	1667	43	1624
B39R18C06	39-6-18	Hs~Ref:NM_032459.1~uORF:IOH21413	1491	42	1449
B39R18C07	39-7-18	Hs~MGC:BC021622.1~uORF:IOH21430	325	41	284
B39R18C08	39-8-18	Hs~MGC:BC021622.1~uORF:IOH21430	321	41	280
B39R18C09	39-9-18	Hs~MGC:BC020979.1~uORF:IOH21444	398	40	358
B39R18C10	39-10-18	Hs~MGC:BC020979.1~uORF:IOH21444	384	40	344
B39R18C11	39-11-18	Hs~Ref:NM_001008726.1~uORF:IOH9771	750	40	710
B39R18C12	39-12-18	Hs~Ref:NM_001008726.1~uORF:IOH9771	675	40	635
B39R18C13	39-13-18	Hs~MGC:BC056401.1~uORF:IOH28794	298	41	257
B39R18C14	39-14-18	Hs~MGC:BC056401.1~uORF:IOH28794	91	42	49
B39R18C15	39-15-18	Hs~Ref:NM_021260.1~uORF:IOH28828	249	41	208
B39R18C16	39-16-18	Hs~Ref:NM_021260.1~uORF:IOH28828	439	48	391
B39R18C17	39-17-18	Hs~MGC:BC043394.1~uORF:IOH26350	836	42	794
B39R18C18	39-18-18	Hs~MGC:BC043394.1~uORF:IOH26350	837	44	793
B39R18C19	39-19-18	Hs~MGC:BC032120.1~uORF:IOH23083	60	54	6
B39R18C20	39-20-18	Hs~MGC:BC032120.1~uORF:IOH23083	306	54	252
B39R18C21	39-21-18	Hs~Ref:NM_025136.1~uORF:IOH6524	763	44	719
B39R18C22	39-22-18	Hs~Ref:NM_025136.1~uORF:IOH6524	819	42	777
B39R19C01	39-1-19	Hs~MGC:BC051911.1~uORF:IOH27047	1323	39	1284
B39R19C02	39-2-19	Hs~MGC:BC051911.1~uORF:IOH27047	1285	46	1239
B39R19C03	39-3-19	Hs~Ref:NM_145275.1~uORF:IOH14017	489	59	430
B39R19C04	39-4-19	Hs~Ref:NM_145275.1~uORF:IOH14017	456	49	407
B39R19C05	39-5-19	Hs~MGC:BC013905.2~uORF:IOH14523	259	52	207
B39R19C06	39-6-19	Hs~MGC:BC013905.2~uORF:IOH14523	262	200	62
B39R19C07	39-7-19	Hs~MGC:BC018771.1~uORF:IOH13629	346	41	305
B39R19C08	39-8-19	Hs~MGC:BC018771.1~uORF:IOH13629	270	41	229
B39R19C09	39-9-19	Hs~MGC:BC023982.1~uORF:IOH14039	421	39	382
B39R19C10	39-10-19	Hs~MGC:BC023982.1~uORF:IOH14039	397	39	358
B39R19C11	39-11-19	Hs~MGC:BC012373.1~uORF:IOH10550	414	40	374
B39R19C12	39-12-19	Hs~MGC:BC012373.1~uORF:IOH10550	437	41	396
B39R19C13	39-13-19	Hs~Ref:NM_018206.3~uORF:IOH4148	404	42	362
B39R19C14	39-14-19	Hs~Ref:NM_018206.3~uORF:IOH4148	410	41	369
B39R19C15	39-15-19	Hs~Ref:NM_032750.1~uORF:IOH6797	1859	41	1818
B39R19C16	39-16-19	Hs~Ref:NM_032750.1~uORF:IOH6797	1841	41	1800
B39R19C17	39-17-19	Hs~MGC:BC007072.1~uORF:IOH7380	7629	42	7587
B39R19C18	39-18-19	Hs~MGC:BC007072.1~uORF:IOH7380	7152	44	7108
B39R19C19	39-19-19	Hs~Ref:NM_003785.3~uORF:IOH5630	197	47	150
B39R19C20	39-20-19	Hs~Ref:NM_003785.3~uORF:IOH5630	196	46	150
B39R19C21	39-21-19	Hs~Ref:NM_080664.1~uORF:IOH9768	1242	42	1200
B39R19C22	39-22-19	Hs~Ref:NM_080664.1~uORF:IOH9768	1308	42	1266
B39R20C01	39-1-20	Hs~Ref:NM_020676.2~uORF:IOH3846	1037	41	996
B39R20C02	39-2-20	Hs~Ref:NM_020676.2~uORF:IOH3846	1057	42	1015
B39R20C03	39-3-20	Hs~Ref:NM_014358.1~uORF:IOH4717	2572	62	2510
B39R20C04	39-4-20	Hs~Ref:NM_014358.1~uORF:IOH4717	3202	90	3112
B39R20C05	39-5-20	Hs~MGC:BC005004.1~uORF:IOH4814	6153	64	6089
B39R20C06	39-6-20	Hs~MGC:BC005004.1~uORF:IOH4814	3258	42	3216
B39R20C07	39-7-20	Hs~Ref:NM_016930.1~uORF:IOH13076	46	38	8
B39R20C08	39-8-20	Hs~Ref:NM_016930.1~uORF:IOH13076	46	39	7
B39R20C09	39-9-20	Hs~Ref:NM_003123.1~uORF:IOH12537	258	40	218
B39R20C10	39-10-20	Hs~Ref:NM_003123.1~uORF:IOH12537	372	39	333
B39R20C11	39-11-20	Hs~MGC:BC000924.2~uORF:IOH2992	359	41	318
B39R20C12	39-12-20	Hs~MGC:BC000924.2~uORF:IOH2992	157	42	115
B39R20C13	39-13-20	Hs~MGC:BC010665.1~uORF:IOH9756	41	43	-2
B39R20C14	39-14-20	Hs~MGC:BC010665.1~uORF:IOH9756	40	45	-5
B39R20C15	39-15-20	Hs~MGC:BC028587.1~uORF:IOH11837	39	42	-3
B39R20C16	39-16-20	Hs~MGC:BC028587.1~uORF:IOH11837	61	39	22
B39R20C17	39-17-20	Hs~MGC:NM_152692.2~uORF:IOH12600	103	41	62
B39R20C18	39-18-20	Hs~MGC:NM_152692.2~uORF:IOH12600	106	43	63
B39R20C19	39-19-20	Hs~MGC:BC001544.1~uORF:IOH10681	113	42	71
B39R20C20	39-20-20	Hs~MGC:BC001544.1~uORF:IOH10681	289	81	208
B39R20C21	39-21-20	Hs~MGC:BC012844.1~uORF:IOH10523	326	43	283
B39R20C22	39-22-20	Hs~MGC:BC012844.1~uORF:IOH10523	364	75	289
B39R21C01	39-1-21	Hs~Ref:NM_001006610.1~uORF:IOH27353	190	61	129
B39R21C02	39-2-21	Hs~Ref:NM_001006610.1~uORF:IOH27353	168	55	113
B39R21C03	39-3-21	Hs~Ref:NM_206889.1~uORF:IOH27544	303	163	140
B39R21C04	39-4-21	Hs~Ref:NM_206889.1~uORF:IOH27544	253	172	81
B39R21C05	39-5-21	Hs~Ref:NM_152599.2~uORF:IOH27200	200	105	95
B39R21C06	39-6-21	Hs~Ref:NM_152599.2~uORF:IOH27200	323	58	265
B39R21C07	39-7-21	Hs~MGC:BC003080.2~uORF:IOH3928	632	39	593
B39R21C08	39-8-21	Hs~MGC:BC003080.2~uORF:IOH3928	614	39	575
B39R21C09	39-9-21	Hs~Ref:P08637-1~CAT_10389-H08H-25	40	38	2
B39R21C10	39-10-21	Hs~Ref:P08637-1~CAT_10389-H08H-25	42	37	5
B39R21C11	39-11-21	Internal_1007209	3859	39	3820
B39R21C12	39-12-21	Internal_1007209	4021	39	3982
B39R21C13	39-13-21	Hs~Ref:NP_002497.2~CAT_11050-HNAC-25	41	38	3
B39R21C14	39-14-21	Hs~Ref:NP_002497.2~CAT_11050-HNAC-25	39	38	1
B39R21C15	39-15-21	Internal_1007209	55	44	11
B39R21C16	39-16-21	Internal_1007209	44	37	7
B39R21C17	39-17-21	Hs~Ref:Q9Y275-1~CAT_10056-H01H-25	3894	40	3854
B39R21C18	39-18-21	Hs~Ref:Q9Y275-1~CAT_10056-H01H-25	3802	43	3759
B39R21C19	39-19-21	Internal_1007209	43	39	4
B39R21C20	39-20-21	Internal_1007209	42	40	2
B39R21C21	39-21-21	Hs~IVGN:IL12_Recombinant~CAT_PHC1124~N/A	63	40	23
B39R21C22	39-22-21	Hs~IVGN:IL12_Recombinant~CAT_PHC1124~N/A	55	41	14
B39R22C01	39-1-22	ERa~N/A	2072	39	2033
B39R22C02	39-2-22	ERa~N/A	2620	66	2554
B39R22C03	39-3-22	PKCeta~N/A	693	356	337
B39R22C04	39-4-22	PKCeta~N/A	180	95	85
B39R22C05	39-5-22	Calmodulin~N/A	1227	83	1144
B39R22C06	39-6-22	Calmodulin~N/A	61	62	-1
B39R22C07	39-7-22	V5control5~N/A	1541	68	1473
B39R22C08	39-8-22	V5control5~N/A	1176	41	1135
B39R22C09	39-9-22	V5control4~N/A	100	56	44
B39R22C10	39-10-22	V5control4~N/A	93	38	55
B39R22C11	39-11-22	V5control3~N/A	58	38	20
B39R22C12	39-12-22	V5control3~N/A	64	39	25
B39R22C13	39-13-22	V5control2~N/A	46	39	7
B39R22C14	39-14-22	V5control2~N/A	50	37	13
B39R22C15	39-15-22	V5control1~N/A	45	37	8
B39R22C16	39-16-22	V5control1~N/A	44	38	6
B39R22C17	39-17-22	CMK2A~N/A	42	47	-5
B39R22C18	39-18-22	CMK2A~N/A	409	113	296
B39R22C19	39-19-22	ERa~N/A	1773	39	1734
B39R22C20	39-20-22	ERa~N/A	1660	38	1622
B39R22C21	39-21-22	AlexaAntiMouseAb~N/A	9517	40	9477
B39R22C22	39-22-22	AlexaAntiMouseAb~N/A	8912	41	8871
B40R01C01	40-1-1	AlexaAntiMouseAb~N/A	34302	42	34260
B40R01C02	40-2-1	AlexaAntiMouseAb~N/A	30787	45	30742
B40R01C03	40-3-1	ERa~N/A	1701	43	1658
B40R01C04	40-4-1	ERa~N/A	1663	43	1620
B40R01C05	40-5-1	HumanIgG1~N/A	1063	44	1019
B40R01C06	40-6-1	HumanIgG1~N/A	1183	44	1139
B40R01C07	40-7-1	HumanIgG2~N/A	3038	44	2994
B40R01C08	40-8-1	HumanIgG2~N/A	3005	44	2961
B40R01C09	40-9-1	HumanIgG3~N/A	12064	44	12020
B40R01C10	40-10-1	HumanIgG3~N/A	12416	44	12372
B40R01C11	40-11-1	HumanIgG4~N/A	34796	46	34750
B40R01C12	40-12-1	HumanIgG4~N/A	34150	47	34103
B40R01C13	40-13-1	BiotinAb~N/A	262	45	217
B40R01C14	40-14-1	BiotinAb~N/A	169	43	126
B40R01C15	40-15-1	RanBP2deltaFG~N/A	254	66	188
B40R01C16	40-16-1	RanBP2deltaFG~N/A	3597	80	3517
B40R01C17	40-17-1	hMDM2~N/A	2143	76	2067
B40R01C18	40-18-1	hMDM2~N/A	634	54	580
B40R01C19	40-19-1	PKCeta~N/A	559	58	501
B40R01C20	40-20-1	PKCeta~N/A	530	355	175
B40R01C21	40-21-1	AlexaAntiMouseAb~N/A	29757	51	29706
B40R01C22	40-22-1	AlexaAntiMouseAb~N/A	34424	65	34359
B40R02C01	40-1-2	PKCeta~N/A	309	47	262
B40R02C02	40-2-2	PKCeta~N/A	895	49	846
B40R02C03	40-3-2	Buffer	338	232	106
B40R02C04	40-4-2	Buffer	346	53	293
B40R02C05	40-5-2	HumanIgA~N/A	18315	48	18267
B40R02C06	40-6-2	HumanIgA~N/A	17960	46	17914
B40R02C07	40-7-2	Buffer	114	45	69
B40R02C08	40-8-2	Buffer	108	45	63
B40R02C09	40-9-2	BSA~N/A	10609	45	10564
B40R02C10	40-10-2	BSA~N/A	10557	43	10514
B40R02C11	40-11-2	Hs~MGC:BC029660.1~uORF:IOH22374	459	49	410
B40R02C12	40-12-2	Hs~MGC:BC029660.1~uORF:IOH22374	624	110	514
B40R02C13	40-13-2	Hs~MGC:BC034774.1~uORF:IOH22743	832	45	787
B40R02C14	40-14-2	Hs~MGC:BC034774.1~uORF:IOH22743	722	44	678
B40R02C15	40-15-2	Hs~MGC:BC015814.1~uORF:IOH10105	1093	46	1047
B40R02C16	40-16-2	Hs~MGC:BC015814.1~uORF:IOH10105	1045	53	992
B40R02C17	40-17-2	Hs~Ref:NM_006012.2~uORF:IOH4910	7446	62	7384
B40R02C18	40-18-2	Hs~Ref:NM_006012.2~uORF:IOH4910	7014	59	6955
B40R02C19	40-19-2	Hs~Ref:NM_002479.2~uORF:IOH6403	413	60	353
B40R02C20	40-20-2	Hs~Ref:NM_002479.2~uORF:IOH6403	385	63	322
B40R02C21	40-21-2	Hs~Ref:NM_134442.2~uORF:IOH9797	202	49	153
B40R02C22	40-22-2	Hs~Ref:NM_134442.2~uORF:IOH9797	110	59	51
B40R03C01	40-1-3	Hs~MGC:NM_152323.1~uORF:IOH21727	319	50	269
B40R03C02	40-2-3	Hs~MGC:NM_152323.1~uORF:IOH21727	446	59	387
B40R03C03	40-3-3	Hs~MGC:BC012899.1~uORF:IOH11155	363	49	314
B40R03C04	40-4-3	Hs~MGC:BC012899.1~uORF:IOH11155	275	53	222
B40R03C05	40-5-3	Hs~Ref:NM_173695.1~uORF:IOH35866	127	48	79
B40R03C06	40-6-3	Hs~Ref:NM_173695.1~uORF:IOH35866	129	50	79
B40R03C07	40-7-3	Hs~Ref:NM_178134.2~uORF:IOH35875	155	44	111
B40R03C08	40-8-3	Hs~Ref:NM_178134.2~uORF:IOH35875	116	45	71
B40R03C09	40-9-3	Hs~Ref:NM_006418.3~uORF:IOH35885	153	45	108
B40R03C10	40-10-3	Hs~Ref:NM_006418.3~uORF:IOH35885	124	44	80
B40R03C11	40-11-3	Hs~Ref:NM_145655.2~uORF:IOH35693	211	46	165
B40R03C12	40-12-3	Hs~Ref:NM_145655.2~uORF:IOH35693	210	52	158
B40R03C13	40-13-3	Hs~Ref:NM_005446.2~uORF:IOH44334	171	45	126
B40R03C14	40-14-3	Hs~Ref:NM_005446.2~uORF:IOH44334	108	46	62
B40R03C15	40-15-3	Hs~Ref:NM_006591.1~uORF:IOH41599	1805	67	1738
B40R03C16	40-16-3	Hs~Ref:NM_006591.1~uORF:IOH41599	1530	93	1437
B40R03C17	40-17-3	Hs~Ref:NM_054022.2~uORF:IOH36765	201	60	141
B40R03C18	40-18-3	Hs~Ref:NM_054022.2~uORF:IOH36765	52	69	-17
B40R03C19	40-19-3	Hs~Ref:NM_182739.1~uORF:IOH44393	1668	60	1608
B40R03C20	40-20-3	Hs~Ref:NM_182739.1~uORF:IOH44393	1341	75	1266
B40R03C21	40-21-3	Hs~Ref:NM_031297.1~uORF:IOH10314	77	67	10
B40R03C22	40-22-3	Hs~Ref:NM_031297.1~uORF:IOH10314	56	66	-10
B40R04C01	40-1-4	Hs~Ref:NM_033046.1~uORF:IOH10325	1968	55	1913
B40R04C02	40-2-4	Hs~Ref:NM_033046.1~uORF:IOH10325	1863	64	1799
B40R04C03	40-3-4	Hs~MGC:BC016979.1~uORF:IOH10345	1021	52	969
B40R04C04	40-4-4	Hs~MGC:BC016979.1~uORF:IOH10345	1072	53	1019
B40R04C05	40-5-4	Hs~MGC:BC020955.1~uORF:IOH10359	86	64	22
B40R04C06	40-6-4	Hs~MGC:BC020955.1~uORF:IOH10359	46	56	-10
B40R04C07	40-7-4	Hs~Ref:NM_032765.1~uORF:IOH7015	416	48	368
B40R04C08	40-8-4	Hs~Ref:NM_032765.1~uORF:IOH7015	449	47	402
B40R04C09	40-9-4	Hs~MGC:BC010181.1~uORF:IOH12592	167	47	120
B40R04C10	40-10-4	Hs~MGC:BC010181.1~uORF:IOH12592	44	68	-24
B40R04C11	40-11-4	Hs~Ref:NM_007233.1~uORF:IOH5376	575	56	519
B40R04C12	40-12-4	Hs~Ref:NM_007233.1~uORF:IOH5376	531	59	472
B40R04C13	40-13-4	Hs~Ref:NM_033177.2~uORF:IOH6217	579	51	528
B40R04C14	40-14-4	Hs~Ref:NM_033177.2~uORF:IOH6217	511	55	456
B40R04C15	40-15-4	Hs~Ref:NM_022140.2~uORF:IOH38016	4944	82	4862
B40R04C16	40-16-4	Hs~Ref:NM_022140.2~uORF:IOH38016	3788	98	3690
B40R04C17	40-17-4	Hs~Ref:NM_015687.2~uORF:IOH38763	5041	69	4972
B40R04C18	40-18-4	Hs~Ref:NM_015687.2~uORF:IOH38763	5398	62	5336
B40R04C19	40-19-4	Hs~Ref:NM_018480.2~uORF:IOH28698	86	60	26
B40R04C20	40-20-4	Hs~Ref:NM_018480.2~uORF:IOH28698	292	192	100
B40R04C21	40-21-4	Hs~Ref:NM_018133.2~uORF:IOH38005	340	67	273
B40R04C22	40-22-4	Hs~Ref:NM_018133.2~uORF:IOH38005	303	62	241
B40R05C01	40-1-5	Hs~MGC:BC010501.1~uORF:IOH10253	2356	48	2308
B40R05C02	40-2-5	Hs~MGC:BC010501.1~uORF:IOH10253	2314	63	2251
B40R05C03	40-3-5	Hs~MGC:BC002555.1~uORF:IOH4008	117	68	49
B40R05C04	40-4-5	Hs~MGC:BC002555.1~uORF:IOH4008	355	70	285
B40R05C05	40-5-5	Hs~Ref:NM_015971.2~uORF:IOH1875	45	94	-49
B40R05C06	40-6-5	Hs~Ref:NM_015971.2~uORF:IOH1875	54	82	-28
B40R05C07	40-7-5	Hs~MGC:BC022377.1~uORF:IOH13489	182	51	131
B40R05C08	40-8-5	Hs~MGC:BC022377.1~uORF:IOH13489	166	50	116
B40R05C09	40-9-5	Hs~Ref:NM_002742.1~N/A	399	48	351
B40R05C10	40-10-5	Hs~Ref:NM_002742.1~N/A	52	59	-7
B40R05C11	40-11-5	Hs~Ref:NM_003600.1~N/A	5631	63	5568
B40R05C12	40-12-5	Hs~Ref:NM_003600.1~N/A	5732	59	5673
B40R05C13	40-13-5	Hs~Ref:NM_018571.4~N/A	430	80	350
B40R05C14	40-14-5	Hs~Ref:NM_018571.4~N/A	41	62	-21
B40R05C15	40-15-5	Hs~Ref:NM_004834.2~N/A	228	52	176
B40R05C16	40-16-5	Hs~Ref:NM_004834.2~N/A	2132	53	2079
B40R05C17	40-17-5	Hs~Ref:NM_001001330.1~uORF:IOH40137	1399	375	1024
B40R05C18	40-18-5	Hs~Ref:NM_001001330.1~uORF:IOH40137	645	89	556
B40R05C19	40-19-5	Hs~Ref:NM_144647.2~uORF:IOH40190	36897	208	36689
B40R05C20	40-20-5	Hs~Ref:NM_144647.2~uORF:IOH40190	34598	204	34394
B40R05C21	40-21-5	Hs~MGC:BC069451.1~uORF:IOH40263	478	99	379
B40R05C22	40-22-5	Hs~MGC:BC069451.1~uORF:IOH40263	402	58	344
B40R06C01	40-1-6	Hs~Ref:NM_024057.2~uORF:IOH40191	1775	42	1733
B40R06C02	40-2-6	Hs~Ref:NM_024057.2~uORF:IOH40191	1788	48	1740
B40R06C03	40-3-6	Hs~Ref:NM_032345.1~uORF:IOH6625	2377	59	2318
B40R06C04	40-4-6	Hs~Ref:NM_032345.1~uORF:IOH6625	2373	65	2308
B40R06C05	40-5-6	Hs~Ref:NM_145204.1~uORF:IOH22722	236	64	172
B40R06C06	40-6-6	Hs~Ref:NM_145204.1~uORF:IOH22722	235	60	175
B40R06C07	40-7-6	Hs~Ref:NM_006498.1~uORF:IOH22699	870	50	820
B40R06C08	40-8-6	Hs~Ref:NM_006498.1~uORF:IOH22699	891	47	844
B40R06C09	40-9-6	Hs~Ref:NM_001175.1~uORF:IOH14469	873	53	820
B40R06C10	40-10-6	Hs~Ref:NM_001175.1~uORF:IOH14469	948	57	891
B40R06C11	40-11-6	Hs~Ref:NM_014396.2~uORF:IOH52895	309	50	259
B40R06C12	40-12-6	Hs~Ref:NM_014396.2~uORF:IOH52895	383	54	329
B40R06C13	40-13-6	Hs~Ref:NM_003826.1~uORF:IOH54997	157	47	110
B40R06C14	40-14-6	Hs~Ref:NM_003826.1~uORF:IOH54997	49	59	-10
B40R06C15	40-15-6	Hs~MGC:BC002371.2~uORF:IOH59061	352	51	301
B40R06C16	40-16-6	Hs~MGC:BC002371.2~uORF:IOH59061	2215	54	2161
B40R06C17	40-17-6	Hs~Ref:NM_003314.1~uORF:IOH54949	2271	722	1549
B40R06C18	40-18-6	Hs~Ref:NM_003314.1~uORF:IOH54949	1886	129	1757
B40R06C19	40-19-6	Hs~MGC:BC006105.1~uORF:IOH5992	30717	66	30651
B40R06C20	40-20-6	Hs~MGC:BC006105.1~uORF:IOH5992	29939	62	29877
B40R06C21	40-21-6	Hs~Ref:NM_173852.3~uORF:IOH22704	141	56	85
B40R06C22	40-22-6	Hs~Ref:NM_173852.3~uORF:IOH22704	55	67	-12
B40R07C01	40-1-7	Hs~Ref:NM_005171.2~uORF:IOH23136	310	45	265
B40R07C02	40-2-7	Hs~Ref:NM_005171.2~uORF:IOH23136	377	60	317
B40R07C03	40-3-7	Hs~Ref:NM_005309.1~uORF:IOH9641	1261	49	1212
B40R07C04	40-4-7	Hs~Ref:NM_005309.1~uORF:IOH9641	1190	52	1138
B40R07C05	40-5-7	Hs~MGC:NM_152992.1~uORF:IOH3431	703	61	642
B40R07C06	40-6-7	Hs~MGC:NM_152992.1~uORF:IOH3431	656	56	600
B40R07C07	40-7-7	Hs~Ref:NM_004328.2~uORF:IOH3650	326	45	281
B40R07C08	40-8-7	Hs~Ref:NM_004328.2~uORF:IOH3650	299	45	254
B40R07C09	40-9-7	Hs~Ref:NM_002794.2~uORF:IOH4386	287	56	231
B40R07C10	40-10-7	Hs~Ref:NM_002794.2~uORF:IOH4386	52	129	-77
B40R07C11	40-11-7	Hs~MGC:NM_152301.3~uORF:IOH3274	1711	53	1658
B40R07C12	40-12-7	Hs~MGC:NM_152301.3~uORF:IOH3274	1705	49	1656
B40R07C13	40-13-7	Hs~Ref:NM_002738.2~N/A	491	47	444
B40R07C14	40-14-7	Hs~Ref:NM_002738.2~N/A	537	51	486
B40R07C15	40-15-7	Hs~Ref:NM_006255.1~N/A	1171	64	1107
B40R07C16	40-16-7	Hs~Ref:NM_006255.1~N/A	2538	63	2475
B40R07C17	40-17-7	Hs~Ref:NM_004217.1~N/A	7962	78	7884
B40R07C18	40-18-7	Hs~Ref:NM_004217.1~N/A	8296	73	8223
B40R07C19	40-19-7	Hs~Ref:NM_007170.1~N/A	359	59	300
B40R07C20	40-20-7	Hs~Ref:NM_007170.1~N/A	336	57	279
B40R07C21	40-21-7	Hs~MGC:BC012105.1~uORF:IOH14609	1744	53	1691
B40R07C22	40-22-7	Hs~MGC:BC012105.1~uORF:IOH14609	1559	54	1505
B40R08C01	40-1-8	Hs~Ref:NM_017809.2~uORF:IOH10134	211	45	166
B40R08C02	40-2-8	Hs~Ref:NM_017809.2~uORF:IOH10134	235	46	189
B40R08C03	40-3-8	Hs~Ref:NM_021219.2~uORF:IOH12137	327	44	283
B40R08C04	40-4-8	Hs~Ref:NM_021219.2~uORF:IOH12137	334	47	287
B40R08C05	40-5-8	Hs~Ref:NM_000700.1~uORF:IOH3222	1793	50	1743
B40R08C06	40-6-8	Hs~Ref:NM_000700.1~uORF:IOH3222	1722	52	1670
B40R08C07	40-7-8	Hs~Ref:NM_021783.2~uORF:IOH23275	1487	54	1433
B40R08C08	40-8-8	Hs~Ref:NM_021783.2~uORF:IOH23275	1457	55	1402
B40R08C09	40-9-8	Hs~Ref:NM_001275.2~uORF:IOH4766	215	55	160
B40R08C10	40-10-8	Hs~Ref:NM_001275.2~uORF:IOH4766	206	62	144
B40R08C11	40-11-8	Hs~Ref:NM_016234.3~uORF:IOH6123	181	51	130
B40R08C12	40-12-8	Hs~Ref:NM_016234.3~uORF:IOH6123	167	52	115
B40R08C13	40-13-8	Hs~Ref:NM_002394.3~uORF:IOH4673	258	55	203
B40R08C14	40-14-8	Hs~Ref:NM_002394.3~uORF:IOH4673	290	57	233
B40R08C15	40-15-8	Hs~Ref:NM_002424.1~uORF:IOH45732	308	54	254
B40R08C16	40-16-8	Hs~Ref:NM_002424.1~uORF:IOH45732	330	58	272
B40R08C17	40-17-8	Hs~MGC:BC040457.1~uORF:IOH26807	264	73	191
B40R08C18	40-18-8	Hs~MGC:BC040457.1~uORF:IOH26807	66	177	-111
B40R08C19	40-19-8	Hs~MGC:BC006986.1~uORF:IOH7170	48	217	-169
B40R08C20	40-20-8	Hs~MGC:BC006986.1~uORF:IOH7170	52	236	-184
B40R08C21	40-21-8	Hs~Ref:NM_021146.2~uORF:IOH4956	78	55	23
B40R08C22	40-22-8	Hs~Ref:NM_021146.2~uORF:IOH4956	222	49	173
B40R09C01	40-1-9	Hs~Ref:NM_002899.2~uORF:IOH58961	165	44	121
B40R09C02	40-2-9	Hs~Ref:NM_002899.2~uORF:IOH58961	156	48	108
B40R09C03	40-3-9	Hs~Ref:NM_002188.2~uORF:IOH35104	373	45	328
B40R09C04	40-4-9	Hs~Ref:NM_002188.2~uORF:IOH35104	366	44	322
B40R09C05	40-5-9	Hs~Ref:NM_003527.4~uORF:IOH58710	491	44	447
B40R09C06	40-6-9	Hs~Ref:NM_003527.4~uORF:IOH58710	435	45	390
B40R09C07	40-7-9	Hs~Ref:NM_153819.1~uORF:IOH52442	1186	50	1136
B40R09C08	40-8-9	Hs~Ref:NM_153819.1~uORF:IOH52442	1152	51	1101
B40R09C09	40-9-9	Hs~Ref:NM_001001711.1~uORF:IOH56024	2089	50	2039
B40R09C10	40-10-9	Hs~Ref:NM_001001711.1~uORF:IOH56024	2006	47	1959
B40R09C11	40-11-9	Hs~MGC:BC069674.1~uORF:IOH56675	50	57	-7
B40R09C12	40-12-9	Hs~MGC:BC069674.1~uORF:IOH56675	102	71	31
B40R09C13	40-13-9	Hs~Ref:NM_003690.3~uORF:IOH57108	54	55	-1
B40R09C14	40-14-9	Hs~Ref:NM_003690.3~uORF:IOH57108	1147	48	1099
B40R09C15	40-15-9	Hs~Ref:NM_017426.2~uORF:IOH52132	1170	74	1096
B40R09C16	40-16-9	Hs~Ref:NM_017426.2~uORF:IOH52132	4799	63	4736
B40R09C17	40-17-9	Hs~MGC:BC002680.1~uORF:IOH5302	894	63	831
B40R09C18	40-18-9	Hs~MGC:BC002680.1~uORF:IOH5302	51	101	-50
B40R09C19	40-19-9	Hs~MGC:BC014552.1~uORF:IOH12669	48	179	-131
B40R09C20	40-20-9	Hs~MGC:BC014552.1~uORF:IOH12669	59	107	-48
B40R09C21	40-21-9	Hs~Ref:NM_007202.2~uORF:IOH10972	126	93	33
B40R09C22	40-22-9	Hs~Ref:NM_007202.2~uORF:IOH10972	97	55	42
B40R10C01	40-1-10	Hs~Ref:NM_018291.2~uORF:IOH14716	133	42	91
B40R10C02	40-2-10	Hs~Ref:NM_018291.2~uORF:IOH14716	130	43	87
B40R10C03	40-3-10	Hs~Ref:NM_016139.2~uORF:IOH3869	873	43	830
B40R10C04	40-4-10	Hs~Ref:NM_016139.2~uORF:IOH3869	830	42	788
B40R10C05	40-5-10	Hs~Ref:NM_013974.1~uORF:IOH4021	556	44	512
B40R10C06	40-6-10	Hs~Ref:NM_013974.1~uORF:IOH4021	526	46	480
B40R10C07	40-7-10	Hs~Ref:NM_145870.1~uORF:IOH4046	533	43	490
B40R10C08	40-8-10	Hs~Ref:NM_145870.1~uORF:IOH4046	501	42	459
B40R10C09	40-9-10	Hs~Ref:NM_001349.2~uORF:IOH4209	663	42	621
B40R10C10	40-10-10	Hs~Ref:NM_001349.2~uORF:IOH4209	710	41	669
B40R10C11	40-11-10	GST1	44	42	2
B40R10C12	40-12-10	GST1	43	44	-1
B40R10C13	40-13-10	GST2	50	44	6
B40R10C14	40-14-10	GST2	45	41	4
B40R10C15	40-15-10	GST3	46	44	2
B40R10C16	40-16-10	GST3	139	93	46
B40R10C17	40-17-10	GST4	72	68	4
B40R10C18	40-18-10	GST4	70	58	12
B40R10C19	40-19-10	Anti-HumanIgA1~N/A	7159	51	7108
B40R10C20	40-20-10	Anti-HumanIgA1~N/A	6745	56	6689
B40R10C21	40-21-10	Anti-HumanIgA2~N/A	12688	57	12631
B40R10C22	40-22-10	Anti-HumanIgA2~N/A	12605	55	12550
B40R11C01	40-1-11	AlexaAntiMouseAb~N/A	21435	44	21391
B40R11C02	40-2-11	AlexaAntiMouseAb~N/A	20784	44	20740
B40R11C03	40-3-11	MAPKAP~N/A	135	48	87
B40R11C04	40-4-11	MAPKAP~N/A	99	44	55
B40R11C05	40-5-11	Buffer	111	65	46
B40R11C06	40-6-11	Buffer	181	104	77
B40R11C07	40-7-11	BSA~N/A	7602	47	7555
B40R11C08	40-8-11	BSA~N/A	7615	43	7572
B40R11C09	40-9-11	Anti-HumanIgG1~N/A	1615	44	1571
B40R11C10	40-10-11	Anti-HumanIgG1~N/A	1639	45	1594
B40R11C11	40-11-11	Anti-HumanIgG2~N/A	2773	45	2728
B40R11C12	40-12-11	Anti-HumanIgG2~N/A	2807	47	2760
B40R11C13	40-13-11	Anti-HumanIgG3~N/A	4212	51	4161
B40R11C14	40-14-11	Anti-HumanIgG3~N/A	5889	90	5799
B40R11C15	40-15-11	Anti-HumanIgG4~N/A	11967	86	11881
B40R11C16	40-16-11	Anti-HumanIgG4~N/A	10152	95	10057
B40R11C17	40-17-11	AntiBiotinAb~N/A	11011	67	10944
B40R11C18	40-18-11	AntiBiotinAb~N/A	9599	56	9543
B40R11C19	40-19-11	Buffer	62	50	12
B40R11C20	40-20-11	Buffer	56	53	3
B40R11C21	40-21-11	Hs~Ref:NM_020141.2~uORF:IOH5923	133	59	74
B40R11C22	40-22-11	Hs~Ref:NM_020141.2~uORF:IOH5923	137	52	85
B40R12C01	40-1-12	Hs~Ref:NM_004846.1~uORF:IOH6102	9033	43	8990
B40R12C02	40-2-12	Hs~Ref:NM_004846.1~uORF:IOH6102	9117	44	9073
B40R12C03	40-3-12	Hs~Ref:NM_001070.1~uORF:IOH4241	411	43	368
B40R12C04	40-4-12	Hs~Ref:NM_001070.1~uORF:IOH4241	492	45	447
B40R12C05	40-5-12	Hs~Ref:NM_007285.5~uORF:IOH7450	1475	77	1398
B40R12C06	40-6-12	Hs~Ref:NM_007285.5~uORF:IOH7450	1218	99	1119
B40R12C07	40-7-12	Hs~Ref:NM_012424.2~N/A	1111	58	1053
B40R12C08	40-8-12	Hs~Ref:NM_012424.2~N/A	1055	49	1006
B40R12C09	40-9-12	Hs~Ref:NM_053006.1~N/A	956	51	905
B40R12C10	40-10-12	Hs~Ref:NM_053006.1~N/A	992	347	645
B40R12C11	40-11-12	Hs~Ref:NM_003503.2~N/A	776	53	723
B40R12C12	40-12-12	Hs~Ref:NM_003503.2~N/A	1081	598	483
B40R12C13	40-13-12	Hs~Ref:NM_032844.1~N/A	863	62	801
B40R12C14	40-14-12	Hs~Ref:NM_032844.1~N/A	10293	149	10144
B40R12C15	40-15-12	Hs~Ref:NM_181710.2~uORF:IOH40189	375	74	301
B40R12C16	40-16-12	Hs~Ref:NM_181710.2~uORF:IOH40189	124	71	53
B40R12C17	40-17-12	Hs~Ref:NM_018215.2~uORF:IOH40888	205	72	133
B40R12C18	40-18-12	Hs~Ref:NM_018215.2~uORF:IOH40888	80	59	21
B40R12C19	40-19-12	Hs~Ref:NM_017706.3~uORF:IOH40135	142	52	90
B40R12C20	40-20-12	Hs~Ref:NM_017706.3~uORF:IOH40135	118	49	69
B40R12C21	40-21-12	Hs~Ref:NM_052960.1~uORF:IOH39885	96	51	45
B40R12C22	40-22-12	Hs~Ref:NM_052960.1~uORF:IOH39885	47	52	-5
B40R13C01	40-1-13	Hs~Ref:NM_016462.1~uORF:IOH3937	299	48	251
B40R13C02	40-2-13	Hs~Ref:NM_016462.1~uORF:IOH3937	322	45	277
B40R13C03	40-3-13	Hs~MGC:BC000931.2~uORF:IOH2988	179	43	136
B40R13C04	40-4-13	Hs~MGC:BC000931.2~uORF:IOH2988	78	69	9
B40R13C05	40-5-13	Hs~MGC:BC015569.1~uORF:IOH14802	605	48	557
B40R13C06	40-6-13	Hs~MGC:BC015569.1~uORF:IOH14802	486	61	425
B40R13C07	40-7-13	Hs~Ref:NM_145173.1~uORF:IOH22396	40	89	-49
B40R13C08	40-8-13	Hs~Ref:NM_145173.1~uORF:IOH22396	46	119	-73
B40R13C09	40-9-13	Hs~MGC:BC052988.1~uORF:IOH28908	1962	52	1910
B40R13C10	40-10-13	Hs~MGC:BC052988.1~uORF:IOH28908	1839	52	1787
B40R13C11	40-11-13	Hs~MGC:BC042637.1~uORF:IOH21048	37	67	-30
B40R13C12	40-12-13	Hs~MGC:BC042637.1~uORF:IOH21048	36	50	-14
B40R13C13	40-13-13	Hs~MGC:BC028006.1~uORF:IOH11573	65535	70	65465
B40R13C14	40-14-13	Hs~MGC:BC028006.1~uORF:IOH11573	43068	103	42965
B40R13C15	40-15-13	Hs~MGC:BC040966.1~uORF:IOH26250	57	117	-60
B40R13C16	40-16-13	Hs~MGC:BC040966.1~uORF:IOH26250	78	73	5
B40R13C17	40-17-13	Hs~MGC:BC031412.1~uORF:IOH22687	100	97	3
B40R13C18	40-18-13	Hs~MGC:BC031412.1~uORF:IOH22687	78	59	19
B40R13C19	40-19-13	Hs~MGC:BC011393.1~uORF:IOH9774	359	57	302
B40R13C20	40-20-13	Hs~MGC:BC011393.1~uORF:IOH9774	77	66	11
B40R13C21	40-21-13	Hs~Ref:NM_001841.1~uORF:IOH29591	52	61	-9
B40R13C22	40-22-13	Hs~Ref:NM_001841.1~uORF:IOH29591	137	53	84
B40R14C01	40-1-14	Hs~MGC:BC056146.1~uORF:IOH29058	404	44	360
B40R14C02	40-2-14	Hs~MGC:BC056146.1~uORF:IOH29058	364	44	320
B40R14C03	40-3-14	Hs~Ref:NM_033083.1~uORF:IOH25830	573	43	530
B40R14C04	40-4-14	Hs~Ref:NM_033083.1~uORF:IOH25830	522	47	475
B40R14C05	40-5-14	Hs~MGC:NM_178127.2~uORF:IOH26886	249	46	203
B40R14C06	40-6-14	Hs~MGC:NM_178127.2~uORF:IOH26886	43	66	-23
B40R14C07	40-7-14	Hs~MGC:BC036242.1~uORF:IOH27520	1175	66	1109
B40R14C08	40-8-14	Hs~MGC:BC036242.1~uORF:IOH27520	1215	61	1154
B40R14C09	40-9-14	Hs~MGC:BC015521.1~uORF:IOH11702	259	57	202
B40R14C10	40-10-14	Hs~MGC:BC015521.1~uORF:IOH11702	273	209	64
B40R14C11	40-11-14	Hs~Ref:NM_001003675.1~uORF:IOH53461	712	60	652
B40R14C12	40-12-14	Hs~Ref:NM_001003675.1~uORF:IOH53461	45	137	-92
B40R14C13	40-13-14	Hs~Ref:NM_002770.2~uORF:IOH59786	47	64	-17
B40R14C14	40-14-14	Hs~Ref:NM_002770.2~uORF:IOH59786	177	72	105
B40R14C15	40-15-14	Hs~MGC:NM_173217.1~uORF:IOH59000	59	82	-23
B40R14C16	40-16-14	Hs~MGC:NM_173217.1~uORF:IOH59000	80	102	-22
B40R14C17	40-17-14	Hs~Ref:NM_001252.2~uORF:IOH59017	178	71	107
B40R14C18	40-18-14	Hs~Ref:NM_001252.2~uORF:IOH59017	53	85	-32
B40R14C19	40-19-14	Hs~Ref:NM_002738.5~uORF:IOH22061	781	71	710
B40R14C20	40-20-14	Hs~Ref:NM_002738.5~uORF:IOH22061	61	96	-35
B40R14C21	40-21-14	Hs~MGC:BC028629.1~uORF:IOH11485	74	56	18
B40R14C22	40-22-14	Hs~MGC:BC028629.1~uORF:IOH11485	843	70	773
B40R15C01	40-1-15	Hs~MGC:BC018359.1~uORF:IOH11786	387	45	342
B40R15C02	40-2-15	Hs~MGC:BC018359.1~uORF:IOH11786	354	47	307
B40R15C03	40-3-15	Hs~MGC:BC058900.1~uORF:IOH29076	402	45	357
B40R15C04	40-4-15	Hs~MGC:BC058900.1~uORF:IOH29076	398	116	282
B40R15C05	40-5-15	Hs~Ref:NM_000466.1~uORF:IOH27596	776	65	711
B40R15C06	40-6-15	Hs~Ref:NM_000466.1~uORF:IOH27596	771	427	344
B40R15C07	40-7-15	Hs~MGC:BC060785.1~uORF:IOH29158	612	383	229
B40R15C08	40-8-15	Hs~MGC:BC060785.1~uORF:IOH29158	497	53	444
B40R15C09	40-9-15	Hs~Ref:NM_017949.1~uORF:IOH29099	821	55	766
B40R15C10	40-10-15	Hs~Ref:NM_017949.1~uORF:IOH29099	824	61	763
B40R15C11	40-11-15	Hs~Ref:NM_003517.2~uORF:IOH29296	666	55	611
B40R15C12	40-12-15	Hs~Ref:NM_003517.2~uORF:IOH29296	51	207	-156
B40R15C13	40-13-15	Hs~Ref:NM_005157.2~CAT:PV3865	48	78	-30
B40R15C14	40-14-15	Hs~Ref:NM_005157.2~CAT:PV3865	364	65	299
B40R15C15	40-15-15	Hs~Ref:NM_020397.1~CAT:PV3663	47	73	-26
B40R15C16	40-16-15	Hs~Ref:NM_020397.1~CAT:PV3663	73	89	-16
B40R15C17	40-17-15	Hs~Ref:NM_001221.2~CAT:PV3373	305	63	242
B40R15C18	40-18-15	Hs~Ref:NM_001221.2~CAT:PV3373	86	56	30
B40R15C19	40-19-15	Hs~Ref:NM_002880.1~CAT:PV3805	57	56	1
B40R15C20	40-20-15	Hs~Ref:NM_002880.1~CAT:PV3805	51	62	-11
B40R15C21	40-21-15	Hs~Ref:NM_001744.2~CAT:PV3310	125	49	76
B40R15C22	40-22-15	Hs~Ref:NM_001744.2~CAT:PV3310	45	52	-7
B40R16C01	40-1-16	Hs~IVGN:NM_001206389~CAT_PHG0184~N/A	504	260	244
B40R16C02	40-2-16	Hs~IVGN:NM_001206389~CAT_PHG0184~N/A	526	44	482
B40R16C03	40-3-16	Hs~IVGN:NM_000514~CAT_PHC7041~N/A	309	52	257
B40R16C04	40-4-16	Hs~IVGN:NM_000514~CAT_PHC7041~N/A	214	47	167
B40R16C05	40-5-16	Hs~IVGN:NM_000074~CAT_PHP0025~N/A	1028	46	982
B40R16C06	40-6-16	Hs~IVGN:NM_000074~CAT_PHP0025~N/A	892	47	845
B40R16C07	40-7-16	Hs~Ref:NM_145165.2~uORF:IOH58632	289	46	243
B40R16C08	40-8-16	Hs~Ref:NM_145165.2~uORF:IOH58632	329	47	282
B40R16C09	40-9-16	Hs~Ref:NM_002036.2~uORF:IOH53930	43	60	-17
B40R16C10	40-10-16	Hs~Ref:NM_002036.2~uORF:IOH53930	67	62	5
B40R16C11	40-11-16	Hs~Ref:NM_001001786.1~uORF:IOH58608	48	61	-13
B40R16C12	40-12-16	Hs~Ref:NM_001001786.1~uORF:IOH58608	55	68	-13
B40R16C13	40-13-16	Hs~Ref:NM_145015.2~uORF:IOH53933	94	70	24
B40R16C14	40-14-16	Hs~Ref:NM_145015.2~uORF:IOH53933	451	113	338
B40R16C15	40-15-16	Hs~Ref:NM_001354.4~uORF:IOH57036	144	82	62
B40R16C16	40-16-16	Hs~Ref:NM_001354.4~uORF:IOH57036	74	114	-40
B40R16C17	40-17-16	Hs~Ref:NM_001025247.1~uORF:IOH56427	95	64	31
B40R16C18	40-18-16	Hs~Ref:NM_001025247.1~uORF:IOH56427	59	55	4
B40R16C19	40-19-16	Hs~Ref:NM_004902.2~uORF:IOH52195	2060	55	2005
B40R16C20	40-20-16	Hs~Ref:NM_004902.2~uORF:IOH52195	516	55	461
B40R16C21	40-21-16	Hs~Ref:NM_139124.1~uORF:IOH57251	608	56	552
B40R16C22	40-22-16	Hs~Ref:NM_139124.1~uORF:IOH57251	553	63	490
B40R17C01	40-1-17	Hs~Ref:NM_004541.2~uORF:IOH4389	79	43	36
B40R17C02	40-2-17	Hs~Ref:NM_004541.2~uORF:IOH4389	523	43	480
B40R17C03	40-3-17	Hs~Ref:NM_004077.2~uORF:IOH12424	501	43	458
B40R17C04	40-4-17	Hs~Ref:NM_004077.2~uORF:IOH12424	588	43	545
B40R17C05	40-5-17	Hs~MGC:BC002763.2~uORF:IOH5342	1076	47	1029
B40R17C06	40-6-17	Hs~MGC:BC002763.2~uORF:IOH5342	1037	47	990
B40R17C07	40-7-17	Hs~MGC:BC003193.1~uORF:IOH4578	826	43	783
B40R17C08	40-8-17	Hs~MGC:BC003193.1~uORF:IOH4578	805	43	762
B40R17C09	40-9-17	Hs~Ref:NM_021254.1~uORF:IOH4573	790	46	744
B40R17C10	40-10-17	Hs~Ref:NM_021254.1~uORF:IOH4573	795	48	747
B40R17C11	40-11-17	Hs~MGC:BC000733.1~uORF:IOH4627	384	49	335
B40R17C12	40-12-17	Hs~MGC:BC000733.1~uORF:IOH4627	368	51	317
B40R17C13	40-13-17	Hs~Ref:NM_032014.1~uORF:IOH13283	2869	84	2785
B40R17C14	40-14-17	Hs~Ref:NM_032014.1~uORF:IOH13283	2044	110	1934
B40R17C15	40-15-17	Hs~MGC:BC009108.1~uORF:IOH10191	4352	86	4266
B40R17C16	40-16-17	Hs~MGC:BC009108.1~uORF:IOH10191	5384	79	5305
B40R17C17	40-17-17	Hs~MGC:BC060806.1~uORF:IOH29136	148	86	62
B40R17C18	40-18-17	Hs~MGC:BC060806.1~uORF:IOH29136	92	57	35
B40R17C19	40-19-17	Hs~MGC:BC058036.1~uORF:IOH29481	241	52	189
B40R17C20	40-20-17	Hs~MGC:BC058036.1~uORF:IOH29481	71	74	-3
B40R17C21	40-21-17	Hs~MGC:BC034417.1~uORF:IOH22867	109	65	44
B40R17C22	40-22-17	Hs~MGC:BC034417.1~uORF:IOH22867	52	69	-17
B40R18C01	40-1-18	Hs~Ref:NM_145247.4~uORF:IOH45440	367	65	302
B40R18C02	40-2-18	Hs~Ref:NM_145247.4~uORF:IOH45440	323	56	267
B40R18C03	40-3-18	Hs~MGC:BC071909.1~uORF:IOH63092	1208	44	1164
B40R18C04	40-4-18	Hs~MGC:BC071909.1~uORF:IOH63092	1260	45	1215
B40R18C05	40-5-18	Hs~MGC:BC101055.1~uORF:IOH63530	38	57	-19
B40R18C06	40-6-18	Hs~MGC:BC101055.1~uORF:IOH63530	368	56	312
B40R18C07	40-7-18	Hs~MGC:BC039235.1~uORF:IOH27982	143	45	98
B40R18C08	40-8-18	Hs~MGC:BC039235.1~uORF:IOH27982	110	69	41
B40R18C09	40-9-18	Hs~Ref:NM_001165.3~uORF:IOH25952	531	49	482
B40R18C10	40-10-18	Hs~Ref:NM_001165.3~uORF:IOH25952	654	326	328
B40R18C11	40-11-18	Hs~MGC:BC050716.1~uORF:IOH27065	49	63	-14
B40R18C12	40-12-18	Hs~MGC:BC050716.1~uORF:IOH27065	61	58	3
B40R18C13	40-13-18	Hs~MGC:BC033491.1~uORF:IOH27359	1875	58	1817
B40R18C14	40-14-18	Hs~MGC:BC033491.1~uORF:IOH27359	60	94	-34
B40R18C15	40-15-18	Hs~MGC:BC040290.1~uORF:IOH27654	314	110	204
B40R18C16	40-16-18	Hs~MGC:BC040290.1~uORF:IOH27654	51	72	-21
B40R18C17	40-17-18	Hs~MGC:BC045799.1~uORF:IOH26424	583	62	521
B40R18C18	40-18-18	Hs~MGC:BC045799.1~uORF:IOH26424	607	61	546
B40R18C19	40-19-18	Hs~Ref:NM_032860.2~uORF:IOH22948	127	68	59
B40R18C20	40-20-18	Hs~Ref:NM_032860.2~uORF:IOH22948	141	100	41
B40R18C21	40-21-18	Hs~MGC:BC030210.1~uORF:IOH22603	119	62	57
B40R18C22	40-22-18	Hs~MGC:BC030210.1~uORF:IOH22603	60	81	-21
B40R19C01	40-1-19	Hs~Ref:NM_001384.2~uORF:IOH5134	78	61	17
B40R19C02	40-2-19	Hs~Ref:NM_001384.2~uORF:IOH5134	59	46	13
B40R19C03	40-3-19	Hs~Ref:NM_002287.2~uORF:IOH11793	968	43	925
B40R19C04	40-4-19	Hs~Ref:NM_002287.2~uORF:IOH11793	980	43	937
B40R19C05	40-5-19	Hs~MGC:BC006012.1~uORF:IOH40621	223	43	180
B40R19C06	40-6-19	Hs~MGC:BC006012.1~uORF:IOH40621	222	45	177
B40R19C07	40-7-19	Hs~Ref:NM_005375.2~uORF:IOH39964	172	44	128
B40R19C08	40-8-19	Hs~Ref:NM_005375.2~uORF:IOH39964	166	45	121
B40R19C09	40-9-19	Hs~Ref:NM_007250.2~uORF:IOH43163	497	47	450
B40R19C10	40-10-19	Hs~Ref:NM_007250.2~uORF:IOH43163	716	169	547
B40R19C11	40-11-19	Hs~MGC:BC002552.2~uORF:IOH4031	477	101	376
B40R19C12	40-12-19	Hs~MGC:BC002552.2~uORF:IOH4031	182	73	109
B40R19C13	40-13-19	Hs~MGC:NM_152522.2~uORF:IOH11477	3195	107	3088
B40R19C14	40-14-19	Hs~MGC:NM_152522.2~uORF:IOH11477	221	198	23
B40R19C15	40-15-19	Hs~MGC:BC028724.1~uORF:IOH11709	289	162	127
B40R19C16	40-16-19	Hs~MGC:BC028724.1~uORF:IOH11709	196	62	134
B40R19C17	40-17-19	Hs~MGC:BC000288.1~uORF:IOH3404	81	67	14
B40R19C18	40-18-19	Hs~MGC:BC000288.1~uORF:IOH3404	104	74	30
B40R19C19	40-19-19	Hs~MGC:BC000232.1~uORF:IOH62785	52	107	-55
B40R19C20	40-20-19	Hs~MGC:BC000232.1~uORF:IOH62785	78	104	-26
B40R19C21	40-21-19	Hs~Ref:NM_001001938.1~uORF:IOH59697	268	63	205
B40R19C22	40-22-19	Hs~Ref:NM_001001938.1~uORF:IOH59697	172	61	111
B40R20C01	40-1-20	Hs~Ref:NM_006398.2~uORF:IOH59996	45	48	-3
B40R20C02	40-2-20	Hs~Ref:NM_006398.2~uORF:IOH59996	42	43	-1
B40R20C03	40-3-20	Hs~Ref:NM_001012984.1~uORF:IOH54807	38	41	-3
B40R20C04	40-4-20	Hs~Ref:NM_001012984.1~uORF:IOH54807	40	40	0
B40R20C05	40-5-20	Hs~Ref:NM_002758.3~uORF:IOH59078	42	42	0
B40R20C06	40-6-20	Hs~Ref:NM_002758.3~uORF:IOH59078	41	42	-1
B40R20C07	40-7-20	Hs~Ref:NM_016224.3~uORF:IOH55509	448	47	401
B40R20C08	40-8-20	Hs~Ref:NM_016224.3~uORF:IOH55509	416	49	367
B40R20C09	40-9-20	Hs~MGC:BC013098.1~uORF:IOH22115	765	330	435
B40R20C10	40-10-20	Hs~MGC:BC013098.1~uORF:IOH22115	586	52	534
B40R20C11	40-11-20	Hs~MGC:BC017202.2~uORF:IOH57138	18210	57	18153
B40R20C12	40-12-20	Hs~MGC:BC017202.2~uORF:IOH57138	17548	65	17483
B40R20C13	40-13-20	Hs~Ref:NM_001010927.2~uORF:IOH55541	47595	82	47513
B40R20C14	40-14-20	Hs~Ref:NM_001010927.2~uORF:IOH55541	45293	85	45208
B40R20C15	40-15-20	Hs~Ref:NM_001706.2~uORF:IOH36781	388	86	302
B40R20C16	40-16-20	Hs~Ref:NM_001706.2~uORF:IOH36781	339	60	279
B40R20C17	40-17-20	Hs~Ref:XM_373588.2~uORF:IOH41175	70	76	-6
B40R20C18	40-18-20	Hs~Ref:XM_373588.2~uORF:IOH41175	57	60	-3
B40R20C19	40-19-20	Hs~Ref:NM_145058.1~uORF:IOH12215	263	123	140
B40R20C20	40-20-20	Hs~Ref:NM_145058.1~uORF:IOH12215	100	138	-38
B40R20C21	40-21-20	Hs~Ref:NM_172390.1~uORF:IOH36807	182	82	100
B40R20C22	40-22-20	Hs~Ref:NM_172390.1~uORF:IOH36807	106	150	-44
B40R21C01	40-1-21	Hs~Ref:NM_213607.1~uORF:IOH28023	41	53	-12
B40R21C02	40-2-21	Hs~Ref:NM_213607.1~uORF:IOH28023	49	59	-10
B40R21C03	40-3-21	Hs~Ref:NM_006833.4~uORF:IOH40651	43	61	-18
B40R21C04	40-4-21	Hs~Ref:NM_006833.4~uORF:IOH40651	131	49	82
B40R21C05	40-5-21	Hs~Ref:NM_175913.3~uORF:IOH42350	67	50	17
B40R21C06	40-6-21	Hs~Ref:NM_175913.3~uORF:IOH42350	57	49	8
B40R21C07	40-7-21	Hs~Ref:NM_001031693.1~uORF:IOH12274	48	50	-2
B40R21C08	40-8-21	Hs~Ref:NM_001031693.1~uORF:IOH12274	42	54	-12
B40R21C09	40-9-21	Hs~Ref:NP_005609.3~CAT_11635-H08H-25	120	40	80
B40R21C10	40-10-21	Hs~Ref:NP_005609.3~CAT_11635-H08H-25	43	44	-1
B40R21C11	40-11-21	Internal_1007209	69	47	22
B40R21C12	40-12-21	Internal_1007209	48	55	-7
B40R21C13	40-13-21	Hs~Ref:Q13316-1~CAT_11929-H08H-25	1982	60	1922
B40R21C14	40-14-21	Hs~Ref:Q13316-1~CAT_11929-H08H-25	422	63	359
B40R21C15	40-15-21	Internal_1007209	57	53	4
B40R21C16	40-16-21	Internal_1007209	49	50	-1
B40R21C17	40-17-21	Hs~Ref:NP_003846.1~CAT_11102-H08H-25	550	68	482
B40R21C18	40-18-21	Hs~Ref:NP_003846.1~CAT_11102-H08H-25	178	49	129
B40R21C19	40-19-21	Internal_1007209	165	48	117
B40R21C20	40-20-21	Internal_1007209	172	52	120
B40R21C21	40-21-21	Internal_1007209	167	53	114
B40R21C22	40-22-21	Internal_1007209	164	54	110
B40R22C01	40-1-22	ERa~N/A	2684	43	2641
B40R22C02	40-2-22	ERa~N/A	2670	42	2628
B40R22C03	40-3-22	PKCeta~N/A	55	59	-4
B40R22C04	40-4-22	PKCeta~N/A	154	44	110
B40R22C05	40-5-22	Calmodulin~N/A	86	43	43
B40R22C06	40-6-22	Calmodulin~N/A	109	52	57
B40R22C07	40-7-22	V5control5~N/A	48	46	2
B40R22C08	40-8-22	V5control5~N/A	173	69	104
B40R22C09	40-9-22	V5control4~N/A	60	46	14
B40R22C10	40-10-22	V5control4~N/A	59	51	8
B40R22C11	40-11-22	V5control3~N/A	63	64	-1
B40R22C12	40-12-22	V5control3~N/A	190	94	96
B40R22C13	40-13-22	V5control2~N/A	1119	68	1051
B40R22C14	40-14-22	V5control2~N/A	90	62	28
B40R22C15	40-15-22	V5control1~N/A	671	51	620
B40R22C16	40-16-22	V5control1~N/A	311	51	260
B40R22C17	40-17-22	CMK2A~N/A	96	52	44
B40R22C18	40-18-22	CMK2A~N/A	197	82	115
B40R22C19	40-19-22	ERa~N/A	2399	54	2345
B40R22C20	40-20-22	ERa~N/A	2473	71	2402
B40R22C21	40-21-22	AlexaAntiMouseAb~N/A	9688	58	9630
B40R22C22	40-22-22	AlexaAntiMouseAb~N/A	8539	50	8489
B41R01C01	41-1-1	AlexaAntiMouseAb~N/A	28081	40	28041
B41R01C02	41-2-1	AlexaAntiMouseAb~N/A	28266	41	28225
B41R01C03	41-3-1	ERa~N/A	1775	37	1738
B41R01C04	41-4-1	ERa~N/A	1507	36	1471
B41R01C05	41-5-1	HumanIgG1~N/A	1129	37	1092
B41R01C06	41-6-1	HumanIgG1~N/A	1092	38	1054
B41R01C07	41-7-1	HumanIgG2~N/A	2462	37	2425
B41R01C08	41-8-1	HumanIgG2~N/A	2725	37	2688
B41R01C09	41-9-1	HumanIgG3~N/A	12906	37	12869
B41R01C10	41-10-1	HumanIgG3~N/A	13391	37	13354
B41R01C11	41-11-1	HumanIgG4~N/A	39898	38	39860
B41R01C12	41-12-1	HumanIgG4~N/A	39152	38	39114
B41R01C13	41-13-1	BiotinAb~N/A	316	37	279
B41R01C14	41-14-1	BiotinAb~N/A	327	37	290
B41R01C15	41-15-1	RanBP2deltaFG~N/A	306	37	269
B41R01C16	41-16-1	RanBP2deltaFG~N/A	295	37	258
B41R01C17	41-17-1	hMDM2~N/A	796	39	757
B41R01C18	41-18-1	hMDM2~N/A	841	42	799
B41R01C19	41-19-1	PKCeta~N/A	936	68	868
B41R01C20	41-20-1	PKCeta~N/A	882	74	808
B41R01C21	41-21-1	AlexaAntiMouseAb~N/A	37394	57	37337
B41R01C22	41-22-1	AlexaAntiMouseAb~N/A	40494	58	40436
B41R02C01	41-1-2	PKCeta~N/A	1018	39	979
B41R02C02	41-2-2	PKCeta~N/A	1172	41	1131
B41R02C03	41-3-2	Buffer	485	45	440
B41R02C04	41-4-2	Buffer	501	38	463
B41R02C05	41-5-2	HumanIgA~N/A	21047	39	21008
B41R02C06	41-6-2	HumanIgA~N/A	21007	41	20966
B41R02C07	41-7-2	Buffer	472	39	433
B41R02C08	41-8-2	Buffer	474	36	438
B41R02C09	41-9-2	BSA~N/A	11975	35	11940
B41R02C10	41-10-2	BSA~N/A	11651	37	11614
B41R02C11	41-11-2	Hs~Ref:NM_001871.2~uORF:IOH11321	343	38	305
B41R02C12	41-12-2	Hs~Ref:NM_001871.2~uORF:IOH11321	455	139	316
B41R02C13	41-13-2	Hs~MGC:BC029382.1~uORF:IOH23139	2534	37	2497
B41R02C14	41-14-2	Hs~MGC:BC029382.1~uORF:IOH23139	2373	37	2336
B41R02C15	41-15-2	Hs~MGC:BC009259.1~uORF:IOH13329	373	41	332
B41R02C16	41-16-2	Hs~MGC:BC009259.1~uORF:IOH13329	411	42	369
B41R02C17	41-17-2	Hs~MGC:BC001555.1~uORF:IOH10965	527	42	485
B41R02C18	41-18-2	Hs~MGC:BC001555.1~uORF:IOH10965	369	55	314
B41R02C19	41-19-2	Hs~Ref:NM_001898.2~uORF:IOH14329	488	76	412
B41R02C20	41-20-2	Hs~Ref:NM_001898.2~uORF:IOH14329	444	64	380
B41R02C21	41-21-2	Hs~MGC:BC024184.2~uORF:IOH10751	406	62	344
B41R02C22	41-22-2	Hs~MGC:BC024184.2~uORF:IOH10751	351	56	295
B41R03C01	41-1-3	Hs~MGC:BC016703.1~uORF:IOH13173	323	43	280
B41R03C02	41-2-3	Hs~MGC:BC016703.1~uORF:IOH13173	649	318	331
B41R03C03	41-3-3	Hs~MGC:BC010895.1~uORF:IOH14241	707	49	658
B41R03C04	41-4-3	Hs~MGC:BC010895.1~uORF:IOH14241	825	483	342
B41R03C05	41-5-3	Hs~Ref:NM_001015.2~uORF:IOH6920	374	44	330
B41R03C06	41-6-3	Hs~Ref:NM_001015.2~uORF:IOH6920	656	273	383
B41R03C07	41-7-3	Hs~MGC:BC007566.1~uORF:IOH6849	384	76	308
B41R03C08	41-8-3	Hs~MGC:BC007566.1~uORF:IOH6849	342	50	292
B41R03C09	41-9-3	Hs~MGC:NM_173473.2~uORF:IOH9870	428	38	390
B41R03C10	41-10-3	Hs~MGC:NM_173473.2~uORF:IOH9870	419	36	383
B41R03C11	41-11-3	Hs~MGC:BC009615.1~uORF:IOH9891	424	38	386
B41R03C12	41-12-3	Hs~MGC:BC009615.1~uORF:IOH9891	411	37	374
B41R03C13	41-13-3	Hs~MGC:BC030811.1~uORF:IOH23057	568	36	532
B41R03C14	41-14-3	Hs~MGC:BC030811.1~uORF:IOH23057	556	36	520
B41R03C15	41-15-3	Hs~MGC:NM_033387.2~uORF:IOH26402	3063	39	3024
B41R03C16	41-16-3	Hs~MGC:NM_033387.2~uORF:IOH26402	2972	46	2926
B41R03C17	41-17-3	Hs~MGC:NM_176791.2~uORF:IOH26363	389	54	335
B41R03C18	41-18-3	Hs~MGC:NM_176791.2~uORF:IOH26363	294	55	239
B41R03C19	41-19-3	Hs~Ref:NM_033014.1~uORF:IOH27143	148	52	96
B41R03C20	41-20-3	Hs~Ref:NM_033014.1~uORF:IOH27143	177	66	111
B41R03C21	41-21-3	Hs~MGC:BC024208.1~uORF:IOH12635	754	60	694
B41R03C22	41-22-3	Hs~MGC:BC024208.1~uORF:IOH12635	733	58	675
B41R04C01	41-1-4	Hs~Ref:NM_145043.1~uORF:IOH13260	1386	41	1345
B41R04C02	41-2-4	Hs~Ref:NM_145043.1~uORF:IOH13260	1275	39	1236
B41R04C03	41-3-4	Hs~Ref:NM_018696.1~uORF:IOH12628	699	40	659
B41R04C04	41-4-4	Hs~Ref:NM_018696.1~uORF:IOH12628	758	47	711
B41R04C05	41-5-4	Hs~MGC:BC015169.1~uORF:IOH9936	667	43	624
B41R04C06	41-6-4	Hs~MGC:BC015169.1~uORF:IOH9936	638	40	598
B41R04C07	41-7-4	Hs~Ref:NM_001584.1~uORF:IOH22675	606	43	563
B41R04C08	41-8-4	Hs~Ref:NM_001584.1~uORF:IOH22675	577	40	537
B41R04C09	41-9-4	Hs~Ref:NM_018659.1~uORF:IOH22679	339	37	302
B41R04C10	41-10-4	Hs~Ref:NM_018659.1~uORF:IOH22679	359	39	320
B41R04C11	41-11-4	Hs~MGC:NM_152315.1~uORF:IOH22681	364	37	327
B41R04C12	41-12-4	Hs~MGC:NM_152315.1~uORF:IOH22681	323	37	286
B41R04C13	41-13-4	Hs~MGC:BC008217.1~uORF:IOH3169	401	36	365
B41R04C14	41-14-4	Hs~MGC:BC008217.1~uORF:IOH3169	451	37	414
B41R04C15	41-15-4	Hs~Ref:NM_002633.2~uORF:IOH26862	1525	38	1487
B41R04C16	41-16-4	Hs~Ref:NM_002633.2~uORF:IOH26862	1789	46	1743
B41R04C17	41-17-4	Hs~Ref:NM_001150.1~uORF:IOH39688	202	51	151
B41R04C18	41-18-4	Hs~Ref:NM_001150.1~uORF:IOH39688	282	124	158
B41R04C19	41-19-4	Hs~Ref:NM_176792.1~uORF:IOH26232	358	51	307
B41R04C20	41-20-4	Hs~Ref:NM_176792.1~uORF:IOH26232	127	54	73
B41R04C21	41-21-4	Hs~Ref:NM_005525.2~uORF:IOH12895	249	52	197
B41R04C22	41-22-4	Hs~Ref:NM_005525.2~uORF:IOH12895	141	55	86
B41R05C01	41-1-5	Hs~MGC:BC047411.1~uORF:IOH26516	773	36	737
B41R05C02	41-2-5	Hs~MGC:BC047411.1~uORF:IOH26516	620	35	585
B41R05C03	41-3-5	Hs~Ref:NM_014553.1~uORF:IOH39819	302	46	256
B41R05C04	41-4-5	Hs~Ref:NM_014553.1~uORF:IOH39819	364	240	124
B41R05C05	41-5-5	Hs~Ref:NM_006402.2~uORF:IOH40860	266	102	164
B41R05C06	41-6-5	Hs~Ref:NM_006402.2~uORF:IOH40860	211	38	173
B41R05C07	41-7-5	Hs~MGC:BC022895.1~uORF:IOH12258	322	47	275
B41R05C08	41-8-5	Hs~MGC:BC022895.1~uORF:IOH12258	263	49	214
B41R05C09	41-9-5	Hs~Ref:NM_005868.3~uORF:IOH2876	889	36	853
B41R05C10	41-10-5	Hs~Ref:NM_005868.3~uORF:IOH2876	876	35	841
B41R05C11	41-11-5	Hs~Ref:NM_015993.1~uORF:IOH5384	632	36	596
B41R05C12	41-12-5	Hs~Ref:NM_015993.1~uORF:IOH5384	620	38	582
B41R05C13	41-13-5	Hs~Ref:NM_024819.2~uORF:IOH5768	768	38	730
B41R05C14	41-14-5	Hs~Ref:NM_024819.2~uORF:IOH5768	854	37	817
B41R05C15	41-15-5	Hs~Ref:NM_000995.2~uORF:IOH4459	1171	45	1126
B41R05C16	41-16-5	Hs~Ref:NM_000995.2~uORF:IOH4459	1088	54	1034
B41R05C17	41-17-5	Hs~Ref:NM_002269.1~uORF:IOH26522	168	53	115
B41R05C18	41-18-5	Hs~Ref:NM_002269.1~uORF:IOH26522	119	54	65
B41R05C19	41-19-5	Hs~MGC:BC050432.1~uORF:IOH26694	435	55	380
B41R05C20	41-20-5	Hs~MGC:BC050432.1~uORF:IOH26694	385	49	336
B41R05C21	41-21-5	Hs~Ref:NM_003724.1~uORF:IOH26418	634	51	583
B41R05C22	41-22-5	Hs~Ref:NM_003724.1~uORF:IOH26418	448	57	391
B41R06C01	41-1-6	Hs~MGC:BC035747.1~uORF:IOH26034	208	39	169
B41R06C02	41-2-6	Hs~MGC:BC035747.1~uORF:IOH26034	187	38	149
B41R06C03	41-3-6	Hs~Ref:NM_024071.2~uORF:IOH3850	488	40	448
B41R06C04	41-4-6	Hs~Ref:NM_024071.2~uORF:IOH3850	445	37	408
B41R06C05	41-5-6	Hs~Ref:NM_001680.2~uORF:IOH1555	334	39	295
B41R06C06	41-6-6	Hs~Ref:NM_001680.2~uORF:IOH1555	328	38	290
B41R06C07	41-7-6	Hs~MGC:NM_178815.2~uORF:IOH12502	294	38	256
B41R06C08	41-8-6	Hs~MGC:NM_178815.2~uORF:IOH12502	317	37	280
B41R06C09	41-9-6	Hs~Ref:NM_001018.2~uORF:IOH1683	444	36	408
B41R06C10	41-10-6	Hs~Ref:NM_001018.2~uORF:IOH1683	420	36	384
B41R06C11	41-11-6	Hs~Ref:NM_153686.4~uORF:IOH40880	233	61	172
B41R06C12	41-12-6	Hs~Ref:NM_153686.4~uORF:IOH40880	187	53	134
B41R06C13	41-13-6	Hs~Ref:NM_024647.4~uORF:IOH39956	171	116	55
B41R06C14	41-14-6	Hs~Ref:NM_024647.4~uORF:IOH39956	84	46	38
B41R06C15	41-15-6	Hs~MGC:BC062459.1~uORF:IOH40000	716	60	656
B41R06C16	41-16-6	Hs~MGC:BC062459.1~uORF:IOH40000	495	112	383
B41R06C17	41-17-6	Hs~Ref:NM_004269.2~uORF:IOH39902	155	50	105
B41R06C18	41-18-6	Hs~Ref:NM_004269.2~uORF:IOH39902	157	57	100
B41R06C19	41-19-6	Hs~MGC:BC045532.1~uORF:IOH26774	197	49	148
B41R06C20	41-20-6	Hs~MGC:BC045532.1~uORF:IOH26774	272	49	223
B41R06C21	41-21-6	Hs~MGC:BC023560.1~uORF:IOH27849	287	72	215
B41R06C22	41-22-6	Hs~MGC:BC023560.1~uORF:IOH27849	85	58	27
B41R07C01	41-1-7	Hs~Ref:NM_003564.1~uORF:IOH27832	462	324	138
B41R07C02	41-2-7	Hs~Ref:NM_003564.1~uORF:IOH27832	348	41	307
B41R07C03	41-3-7	Hs~MGC:BC051362.1~uORF:IOH28072	151	39	112
B41R07C04	41-4-7	Hs~MGC:BC051362.1~uORF:IOH28072	145	38	107
B41R07C05	41-5-7	Hs~Ref:NM_004765.2~uORF:IOH14041	330	253	77
B41R07C06	41-6-7	Hs~Ref:NM_004765.2~uORF:IOH14041	57	51	6
B41R07C07	41-7-7	Hs~MGC:BC009457.1~uORF:IOH14847	279	41	238
B41R07C08	41-8-7	Hs~MGC:BC009457.1~uORF:IOH14847	329	44	285
B41R07C09	41-9-7	Hs~MGC:BC035690.1~uORF:IOH26051	457	41	416
B41R07C10	41-10-7	Hs~MGC:BC035690.1~uORF:IOH26051	458	39	419
B41R07C11	41-11-7	Hs~MGC:BC000954.1~uORF:IOH3033	472	37	435
B41R07C12	41-12-7	Hs~MGC:BC000954.1~uORF:IOH3033	483	43	440
B41R07C13	41-13-7	Hs~Ref:NM_002142.3~uORF:IOH44625	394	76	318
B41R07C14	41-14-7	Hs~Ref:NM_002142.3~uORF:IOH44625	397	59	338
B41R07C15	41-15-7	Hs~Ref:NM_001244.2~uORF:IOH42084	768	57	711
B41R07C16	41-16-7	Hs~Ref:NM_001244.2~uORF:IOH42084	727	55	672
B41R07C17	41-17-7	Hs~Ref:NM_144660.1~uORF:IOH43639	721	50	671
B41R07C18	41-18-7	Hs~Ref:NM_144660.1~uORF:IOH43639	695	52	643
B41R07C19	41-19-7	Hs~Ref:NM_006426.1~uORF:IOH42101	819	49	770
B41R07C20	41-20-7	Hs~Ref:NM_006426.1~uORF:IOH42101	785	48	737
B41R07C21	41-21-7	Hs~MGC:BC011739.2~uORF:IOH14463	1061	51	1010
B41R07C22	41-22-7	Hs~MGC:BC011739.2~uORF:IOH14463	1049	50	999
B41R08C01	41-1-8	Hs~Ref:NM_002622.3~uORF:IOH14625	329	42	287
B41R08C02	41-2-8	Hs~Ref:NM_002622.3~uORF:IOH14625	315	49	266
B41R08C03	41-3-8	Hs~MGC:NM_007270.2~uORF:IOH14166	344	49	295
B41R08C04	41-4-8	Hs~MGC:NM_007270.2~uORF:IOH14166	595	50	545
B41R08C05	41-5-8	Hs~MGC:NM_058163.1~uORF:IOH14811	631	46	585
B41R08C06	41-6-8	Hs~MGC:NM_058163.1~uORF:IOH14811	563	40	523
B41R08C07	41-7-8	Hs~Ref:NM_022777.1~uORF:IOH14797	148	39	109
B41R08C08	41-8-8	Hs~Ref:NM_022777.1~uORF:IOH14797	137	42	95
B41R08C09	41-9-8	Hs~Ref:NM_002436.2~uORF:IOH3460	380	47	333
B41R08C10	41-10-8	Hs~Ref:NM_002436.2~uORF:IOH3460	344	42	302
B41R08C11	41-11-8	Hs~MGC:BC008094.1~uORF:IOH3305	309	38	271
B41R08C12	41-12-8	Hs~MGC:BC008094.1~uORF:IOH3305	380	68	312
B41R08C13	41-13-8	Hs~Ref:NM_024046.1~uORF:IOH21132	1701	59	1642
B41R08C14	41-14-8	Hs~Ref:NM_024046.1~uORF:IOH21132	2078	56	2022
B41R08C15	41-15-8	Hs~MGC:BC003643.1~uORF:IOH5184	561	50	511
B41R08C16	41-16-8	Hs~MGC:BC003643.1~uORF:IOH5184	654	51	603
B41R08C17	41-17-8	Hs~MGC:NM_003848.1~uORF:IOH26605	429	52	377
B41R08C18	41-18-8	Hs~MGC:NM_003848.1~uORF:IOH26605	545	53	492
B41R08C19	41-19-8	Hs~MGC:BC000162.2~uORF:IOH2911	398	44	354
B41R08C20	41-20-8	Hs~MGC:BC000162.2~uORF:IOH2911	480	48	432
B41R08C21	41-21-8	Hs~Ref:NM_004544.1~uORF:IOH3043	300	44	256
B41R08C22	41-22-8	Hs~Ref:NM_004544.1~uORF:IOH3043	304	60	244
B41R09C01	41-1-9	Hs~Ref:NM_002170.2~uORF:IOH35228	851	39	812
B41R09C02	41-2-9	Hs~Ref:NM_002170.2~uORF:IOH35228	804	43	761
B41R09C03	41-3-9	Hs~Ref:NM_014943.3~uORF:IOH28064	2709	47	2662
B41R09C04	41-4-9	Hs~Ref:NM_014943.3~uORF:IOH28064	2862	43	2819
B41R09C05	41-5-9	Hs~Ref:NM_002173.1~uORF:IOH35231	450	35	415
B41R09C06	41-6-9	Hs~Ref:NM_002173.1~uORF:IOH35231	454	35	419
B41R09C07	41-7-9	Hs~Ref:NM_002626.4~uORF:IOH6888	526	35	491
B41R09C08	41-8-9	Hs~Ref:NM_002626.4~uORF:IOH6888	545	36	509
B41R09C09	41-9-9	Hs~Ref:NM_138779.1~uORF:IOH10711	1778	38	1740
B41R09C10	41-10-9	Hs~Ref:NM_138779.1~uORF:IOH10711	1704	36	1668
B41R09C11	41-11-9	Hs~MGC:BC008499.1~uORF:IOH7414	375	35	340
B41R09C12	41-12-9	Hs~MGC:BC008499.1~uORF:IOH7414	413	36	377
B41R09C13	41-13-9	Hs~Ref:NM_080743.2~uORF:IOH10836	577	47	530
B41R09C14	41-14-9	Hs~Ref:NM_080743.2~uORF:IOH10836	194	54	140
B41R09C15	41-15-9	Hs~MGC:NM_178861.3~uORF:IOH10760	545	187	358
B41R09C16	41-16-9	Hs~MGC:NM_178861.3~uORF:IOH10760	420	52	368
B41R09C17	41-17-9	Hs~Ref:NM_138381.1~uORF:IOH6954	283	133	150
B41R09C18	41-18-9	Hs~Ref:NM_138381.1~uORF:IOH6954	463	78	385
B41R09C19	41-19-9	Hs~MGC:BC008303.1~uORF:IOH6987	221	48	173
B41R09C20	41-20-9	Hs~MGC:BC008303.1~uORF:IOH6987	86	46	40
B41R09C21	41-21-9	Hs~Ref:NM_004966.2~uORF:IOH3987	911	46	865
B41R09C22	41-22-9	Hs~Ref:NM_004966.2~uORF:IOH3987	852	52	800
B41R10C01	41-1-10	Hs~MGC:BC002677.1~uORF:IOH5269	452	41	411
B41R10C02	41-2-10	Hs~MGC:BC002677.1~uORF:IOH5269	434	39	395
B41R10C03	41-3-10	Hs~Ref:NM_001001852.2~uORF:IOH39671	571	39	532
B41R10C04	41-4-10	Hs~Ref:NM_001001852.2~uORF:IOH39671	579	34	545
B41R10C05	41-5-10	Hs~Ref:NM_006397.2~uORF:IOH13113	972	33	939
B41R10C06	41-6-10	Hs~Ref:NM_006397.2~uORF:IOH13113	959	33	926
B41R10C07	41-7-10	Hs~Ref:NM_152857.1~uORF:IOH3479	488	34	454
B41R10C08	41-8-10	Hs~Ref:NM_152857.1~uORF:IOH3479	498	34	464
B41R10C09	41-9-10	Hs~Ref:NM_014018.2~uORF:IOH12228	752	34	718
B41R10C10	41-10-10	Hs~Ref:NM_014018.2~uORF:IOH12228	743	33	710
B41R10C11	41-11-10	GST1	40	34	6
B41R10C12	41-12-10	GST1	39	36	3
B41R10C13	41-13-10	GST2	268	50	218
B41R10C14	41-14-10	GST2	45	49	-4
B41R10C15	41-15-10	GST3	43	49	-6
B41R10C16	41-16-10	GST3	59	48	11
B41R10C17	41-17-10	GST4	77	47	30
B41R10C18	41-18-10	GST4	75	48	27
B41R10C19	41-19-10	Anti-HumanIgA1~N/A	10991	48	10943
B41R10C20	41-20-10	Anti-HumanIgA1~N/A	11302	46	11256
B41R10C21	41-21-10	Anti-HumanIgA2~N/A	18872	48	18824
B41R10C22	41-22-10	Anti-HumanIgA2~N/A	18104	56	18048
B41R11C01	41-1-11	AlexaAntiMouseAb~N/A	18855	37	18818
B41R11C02	41-2-11	AlexaAntiMouseAb~N/A	20623	35	20588
B41R11C03	41-3-11	MAPKAP~N/A	80	34	46
B41R11C04	41-4-11	MAPKAP~N/A	76	34	42
B41R11C05	41-5-11	Buffer	83	34	49
B41R11C06	41-6-11	Buffer	107	33	74
B41R11C07	41-7-11	BSA~N/A	7504	33	7471
B41R11C08	41-8-11	BSA~N/A	7791	34	7757
B41R11C09	41-9-11	Anti-HumanIgG1~N/A	1536	33	1503
B41R11C10	41-10-11	Anti-HumanIgG1~N/A	1464	34	1430
B41R11C11	41-11-11	Anti-HumanIgG2~N/A	2917	36	2881
B41R11C12	41-12-11	Anti-HumanIgG2~N/A	2804	40	2764
B41R11C13	41-13-11	Anti-HumanIgG3~N/A	7641	48	7593
B41R11C14	41-14-11	Anti-HumanIgG3~N/A	7437	51	7386
B41R11C15	41-15-11	Anti-HumanIgG4~N/A	14096	49	14047
B41R11C16	41-16-11	Anti-HumanIgG4~N/A	15264	48	15216
B41R11C17	41-17-11	AntiBiotinAb~N/A	14937	47	14890
B41R11C18	41-18-11	AntiBiotinAb~N/A	14745	48	14697
B41R11C19	41-19-11	Buffer	46	50	-4
B41R11C20	41-20-11	Buffer	63	42	21
B41R11C21	41-21-11	Hs~Ref:NM_001728.1~uORF:IOH3378	614	188	426
B41R11C22	41-22-11	Hs~Ref:NM_001728.1~uORF:IOH3378	505	70	435
B41R12C01	41-1-12	Hs~Ref:NM_014570.2~uORF:IOH5693	4206	37	4169
B41R12C02	41-2-12	Hs~Ref:NM_014570.2~uORF:IOH5693	4265	36	4229
B41R12C03	41-3-12	Hs~MGC:BC034784.1~uORF:IOH22773	738	34	704
B41R12C04	41-4-12	Hs~MGC:BC034784.1~uORF:IOH22773	707	35	672
B41R12C05	41-5-12	Hs~MGC:NM_030645.1~uORF:IOH14805	740	36	704
B41R12C06	41-6-12	Hs~MGC:NM_030645.1~uORF:IOH14805	748	36	712
B41R12C07	41-7-12	Hs~Ref:NM_000507.2~uORF:IOH2056	262	34	228
B41R12C08	41-8-12	Hs~Ref:NM_000507.2~uORF:IOH2056	326	44	282
B41R12C09	41-9-12	Hs~Ref:NM_018719.2~uORF:IOH26280	223	37	186
B41R12C10	41-10-12	Hs~Ref:NM_018719.2~uORF:IOH26280	202	42	160
B41R12C11	41-11-12	Hs~Ref:NM_015387.2~uORF:IOH57047	364	40	324
B41R12C12	41-12-12	Hs~Ref:NM_015387.2~uORF:IOH57047	1034	91	943
B41R12C13	41-13-12	Hs~MGC:BC007057.1~uORF:IOH57046	254	61	193
B41R12C14	41-14-12	Hs~MGC:BC007057.1~uORF:IOH57046	739	197	542
B41R12C15	41-15-12	Hs~Ref:NM_000880.2~uORF:IOH26652	818	48	770
B41R12C16	41-16-12	Hs~Ref:NM_000880.2~uORF:IOH26652	737	48	689
B41R12C17	41-17-12	Hs~MGC:BC011786.1~uORF:IOH13185	795	49	746
B41R12C18	41-18-12	Hs~MGC:BC011786.1~uORF:IOH13185	749	52	697
B41R12C19	41-19-12	Hs~Ref:NM_022787.2~uORF:IOH13215	311	49	262
B41R12C20	41-20-12	Hs~Ref:NM_022787.2~uORF:IOH13215	182	48	134
B41R12C21	41-21-12	Hs~Ref:NM_016208.1~uORF:IOH5976	62	48	14
B41R12C22	41-22-12	Hs~Ref:NM_016208.1~uORF:IOH5976	53	49	4
B41R13C01	41-1-13	Hs~Ref:NM_002254.5~uORF:IOH42589	704	39	665
B41R13C02	41-2-13	Hs~Ref:NM_002254.5~uORF:IOH42589	618	38	580
B41R13C03	41-3-13	Hs~MGC:BC012021.1~uORF:IOH10818	557	37	520
B41R13C04	41-4-13	Hs~MGC:BC012021.1~uORF:IOH10818	541	34	507
B41R13C05	41-5-13	Hs~Ref:NM_015023.2~uORF:IOH21950	381	36	345
B41R13C06	41-6-13	Hs~Ref:NM_015023.2~uORF:IOH21950	392	36	356
B41R13C07	41-7-13	Hs~Ref:NM_031434.2~uORF:IOH3021	456	35	421
B41R13C08	41-8-13	Hs~Ref:NM_031434.2~uORF:IOH3021	442	37	405
B41R13C09	41-9-13	Hs~MGC:BC014484.1~uORF:IOH13585	318	36	282
B41R13C10	41-10-13	Hs~MGC:BC014484.1~uORF:IOH13585	322	36	286
B41R13C11	41-11-13	Hs~MGC:BC015626.2~uORF:IOH13367	434	63	371
B41R13C12	41-12-13	Hs~MGC:BC015626.2~uORF:IOH13367	791	111	680
B41R13C13	41-13-13	Hs~MGC:BC015514.1~uORF:IOH11731	11853	63	11790
B41R13C14	41-14-13	Hs~MGC:BC015514.1~uORF:IOH11731	11048	60	10988
B41R13C15	41-15-13	Hs~Ref:NM_000149.1~uORF:IOH45728	733	53	680
B41R13C16	41-16-13	Hs~Ref:NM_000149.1~uORF:IOH45728	704	51	653
B41R13C17	41-17-13	Hs~MGC:BC000029.2~uORF:IOH4750	247	51	196
B41R13C18	41-18-13	Hs~MGC:BC000029.2~uORF:IOH4750	423	58	365
B41R13C19	41-19-13	Hs~Ref:NM_004915.3~uORF:IOH52605	455	54	401
B41R13C20	41-20-13	Hs~Ref:NM_004915.3~uORF:IOH52605	366	47	319
B41R13C21	41-21-13	Hs~Ref:NM_006350.2~uORF:IOH59070	348	43	305
B41R13C22	41-22-13	Hs~Ref:NM_006350.2~uORF:IOH59070	188	49	139
B41R14C01	41-1-14	Hs~Ref:NM_019110.3~uORF:IOH13427	537	41	496
B41R14C02	41-2-14	Hs~Ref:NM_019110.3~uORF:IOH13427	489	40	449
B41R14C03	41-3-14	Hs~Ref:NM_198331.1~uORF:IOH42150	370	98	272
B41R14C04	41-4-14	Hs~Ref:NM_198331.1~uORF:IOH42150	375	66	309
B41R14C05	41-5-14	Hs~Ref:NM_198890.1~uORF:IOH42393	398	35	363
B41R14C06	41-6-14	Hs~Ref:NM_198890.1~uORF:IOH42393	402	34	368
B41R14C07	41-7-14	Hs~Ref:NM_013240.2~uORF:IOH41150	315	37	278
B41R14C08	41-8-14	Hs~Ref:NM_013240.2~uORF:IOH41150	318	38	280
B41R14C09	41-9-14	Hs~Ref:NM_002893.2~uORF:IOH42163	294	47	247
B41R14C10	41-10-14	Hs~Ref:NM_002893.2~uORF:IOH42163	382	40	342
B41R14C11	41-11-14	Hs~Ref:NM_002301.2~uORF:IOH10643	470	57	413
B41R14C12	41-12-14	Hs~Ref:NM_002301.2~uORF:IOH10643	496	144	352
B41R14C13	41-13-14	Hs~Ref:NM_006307.2~uORF:IOH13589	381	69	312
B41R14C14	41-14-14	Hs~Ref:NM_006307.2~uORF:IOH13589	250	98	152
B41R14C15	41-15-14	Hs~Ref:NM_130398.1~uORF:IOH5832	1776	54	1722
B41R14C16	41-16-14	Hs~Ref:NM_130398.1~uORF:IOH5832	1724	49	1675
B41R14C17	41-17-14	Hs~MGC:BC034141.1~uORF:IOH23179	45156	48	45108
B41R14C18	41-18-14	Hs~MGC:BC034141.1~uORF:IOH23179	46185	50	46135
B41R14C19	41-19-14	Hs~Ref:NM_001547.3~uORF:IOH45467	510	67	443
B41R14C20	41-20-14	Hs~Ref:NM_001547.3~uORF:IOH45467	522	51	471
B41R14C21	41-21-14	Hs~Ref:NM_153710.2~uORF:IOH45542	414	44	370
B41R14C22	41-22-14	Hs~Ref:NM_153710.2~uORF:IOH45542	412	51	361
B41R15C01	41-1-15	Hs~Ref:NM_007169.2~uORF:IOH45469	609	37	572
B41R15C02	41-2-15	Hs~Ref:NM_007169.2~uORF:IOH45469	617	35	582
B41R15C03	41-3-15	Hs~Ref:NM_001001660.1~uORF:IOH45936	418	35	383
B41R15C04	41-4-15	Hs~Ref:NM_001001660.1~uORF:IOH45936	389	35	354
B41R15C05	41-5-15	Hs~MGC:BC048125.1~uORF:IOH26780	384	34	350
B41R15C06	41-6-15	Hs~MGC:BC048125.1~uORF:IOH26780	351	34	317
B41R15C07	41-7-15	Hs~Ref:NM_002730.1~uORF:IOH26286	291	36	255
B41R15C08	41-8-15	Hs~Ref:NM_002730.1~uORF:IOH26286	271	48	223
B41R15C09	41-9-15	Hs~MGC:BC051762.1~uORF:IOH28838	1630	37	1593
B41R15C10	41-10-15	Hs~MGC:BC051762.1~uORF:IOH28838	1697	41	1656
B41R15C11	41-11-15	Hs~MGC:BC009189.1~uORF:IOH29320	516	53	463
B41R15C12	41-12-15	Hs~MGC:BC009189.1~uORF:IOH29320	523	138	385
B41R15C13	41-13-15	Hs~IVGN:NM_000799~CAT_PHC9631~N/A	51	53	-2
B41R15C14	41-14-15	Hs~IVGN:NM_000799~CAT_PHC9631~N/A	42	49	-7
B41R15C15	41-15-15	Hs~Ref:NM_004438.1~CAT:PV3651	363	47	316
B41R15C16	41-16-15	Hs~Ref:NM_004438.1~CAT:PV3651	345	45	300
B41R15C17	41-17-15	Hs~Ref:NM_001004023.1~CAT:PV3837	598	42	556
B41R15C18	41-18-15	Hs~Ref:NM_001004023.1~CAT:PV3837	667	47	620
B41R15C19	41-19-15	Hs~Ref:NM_000875.2~CAT:PV3250	1511	101	1410
B41R15C20	41-20-15	Hs~Ref:NM_000875.2~CAT:PV3250	353	62	291
B41R15C21	41-21-15	Hs~Ref:NP_005239~CAT:P3041	128	54	74
B41R15C22	41-22-15	Hs~Ref:NP_005239~CAT:P3041	131	54	77
B41R16C01	41-1-16	Hs~Ref:NM_004443.2~CAT:PV3658	58	34	24
B41R16C02	41-2-16	Hs~Ref:NM_004443.2~CAT:PV3658	50	34	16
B41R16C03	41-3-16	Hs~Ref:NM_006252.2~CAT:PV4674	198	67	131
B41R16C04	41-4-16	Hs~Ref:NM_006252.2~CAT:PV4674	187	37	150
B41R16C05	41-5-16	Hs~IVGN:NM_002546~CAT_PHC1684~N/A	319	34	285
B41R16C06	41-6-16	Hs~IVGN:NM_002546~CAT_PHC1684~N/A	337	37	300
B41R16C07	41-7-16	Hs~MGC:BC015244.1~uORF:IOH21465	591	37	554
B41R16C08	41-8-16	Hs~MGC:BC015244.1~uORF:IOH21465	574	37	537
B41R16C09	41-9-16	Hs~Ref:NM_025160.1~uORF:IOH21455	616	37	579
B41R16C10	41-10-16	Hs~Ref:NM_025160.1~uORF:IOH21455	710	51	659
B41R16C11	41-11-16	Hs~MGC:BC024223.2~uORF:IOH14706	480	67	413
B41R16C12	41-12-16	Hs~MGC:BC024223.2~uORF:IOH14706	428	65	363
B41R16C13	41-13-16	Hs~MGC:BC060767.1~uORF:IOH29188	918	55	863
B41R16C14	41-14-16	Hs~MGC:BC060767.1~uORF:IOH29188	834	54	780
B41R16C15	41-15-16	Hs~Ref:NM_004666.1~uORF:IOH37862	271	168	103
B41R16C16	41-16-16	Hs~Ref:NM_004666.1~uORF:IOH37862	287	59	228
B41R16C17	41-17-16	Hs~Ref:NM_205833.1~uORF:IOH41224	425	57	368
B41R16C18	41-18-16	Hs~Ref:NM_205833.1~uORF:IOH41224	209	47	162
B41R16C19	41-19-16	Hs~Ref:XM_294794.1~uORF:IOH42923	12882	47	12835
B41R16C20	41-20-16	Hs~Ref:XM_294794.1~uORF:IOH42923	12669	49	12620
B41R16C21	41-21-16	Hs~Ref:XM_379149.1~uORF:IOH43693	269	49	220
B41R16C22	41-22-16	Hs~Ref:XM_379149.1~uORF:IOH43693	399	47	352
B41R17C01	41-1-17	Hs~MGC:BC012445.1~uORF:IOH10448	460	36	424
B41R17C02	41-2-17	Hs~MGC:BC012445.1~uORF:IOH10448	557	38	519
B41R17C03	41-3-17	Hs~MGC:BC050535.1~uORF:IOH26965	583	42	541
B41R17C04	41-4-17	Hs~MGC:BC050535.1~uORF:IOH26965	425	35	390
B41R17C05	41-5-17	Hs~MGC:BC031062.1~uORF:IOH27218	314	34	280
B41R17C06	41-6-17	Hs~MGC:BC031062.1~uORF:IOH27218	345	40	305
B41R17C07	41-7-17	Hs~MGC:BC035021.1~uORF:IOH27103	5936	43	5893
B41R17C08	41-8-17	Hs~MGC:BC035021.1~uORF:IOH27103	6113	38	6075
B41R17C09	41-9-17	Hs~MGC:BC042970.1~uORF:IOH25849	697	36	661
B41R17C10	41-10-17	Hs~MGC:BC042970.1~uORF:IOH25849	777	49	728
B41R17C11	41-11-17	Hs~MGC:BC032645.1~uORF:IOH21959	610	51	559
B41R17C12	41-12-17	Hs~MGC:BC032645.1~uORF:IOH21959	564	47	517
B41R17C13	41-13-17	Hs~Ref:NM_014864.2~uORF:IOH27350	489	45	444
B41R17C14	41-14-17	Hs~Ref:NM_014864.2~uORF:IOH27350	643	48	595
B41R17C15	41-15-17	Hs~MGC:BC034692.1~uORF:IOH22176	952	52	900
B41R17C16	41-16-17	Hs~MGC:BC034692.1~uORF:IOH22176	902	51	851
B41R17C17	41-17-17	Hs~MGC:BC008054.1~uORF:IOH7016	304	182	122
B41R17C18	41-18-17	Hs~MGC:BC008054.1~uORF:IOH7016	290	75	215
B41R17C19	41-19-17	Hs~Ref:NM_032499.1~uORF:IOH6336	548	52	496
B41R17C20	41-20-17	Hs~Ref:NM_032499.1~uORF:IOH6336	323	52	271
B41R17C21	41-21-17	Hs~Ref:NM_001008.2~uORF:IOH11799	224	55	169
B41R17C22	41-22-17	Hs~Ref:NM_001008.2~uORF:IOH11799	349	51	298
B41R18C01	41-1-18	Hs~MGC:BC008365.1~uORF:IOH5958	336	59	277
B41R18C02	41-2-18	Hs~MGC:BC008365.1~uORF:IOH5958	395	44	351
B41R18C03	41-3-18	Hs~Ref:NM_003215.1~N/A	964	37	927
B41R18C04	41-4-18	Hs~Ref:NM_003215.1~N/A	868	35	833
B41R18C05	41-5-18	Hs~MGC:BC002466.1~N/A	1334	34	1300
B41R18C06	41-6-18	Hs~MGC:BC002466.1~N/A	1320	37	1283
B41R18C07	41-7-18	Hs~MGC:BC011668.1~N/A	1434	41	1393
B41R18C08	41-8-18	Hs~MGC:BC011668.1~N/A	1394	40	1354
B41R18C09	41-9-18	Hs~MGC:BC001968.1~N/A	700	46	654
B41R18C10	41-10-18	Hs~MGC:BC001968.1~N/A	610	68	542
B41R18C11	41-11-18	Hs~MGC:BC036096.2~uORF:IOH27280	449	78	371
B41R18C12	41-12-18	Hs~MGC:BC036096.2~uORF:IOH27280	385	50	335
B41R18C13	41-13-18	Hs~Ref:NM_002659.1~uORF:IOH5327	246	88	158
B41R18C14	41-14-18	Hs~Ref:NM_002659.1~uORF:IOH5327	408	54	354
B41R18C15	41-15-18	Hs~MGC:BC063648.1~uORF:IOH39845	599	53	546
B41R18C16	41-16-18	Hs~MGC:BC063648.1~uORF:IOH39845	477	69	408
B41R18C17	41-17-18	Hs~MGC:BC067819.1~uORF:IOH40128	539	271	268
B41R18C18	41-18-18	Hs~MGC:BC067819.1~uORF:IOH40128	330	59	271
B41R18C19	41-19-18	Hs~MGC:BC090940.1~uORF:IOH62699	24992	53	24939
B41R18C20	41-20-18	Hs~MGC:BC090940.1~uORF:IOH62699	24696	53	24643
B41R18C21	41-21-18	Hs~Ref:NM_199183.1~uORF:IOH60515	1636	52	1584
B41R18C22	41-22-18	Hs~Ref:NM_199183.1~uORF:IOH60515	2218	48	2170
B41R19C01	41-1-19	Hs~MGC:BC092518.1~uORF:IOH62695	47540	41	47499
B41R19C02	41-2-19	Hs~MGC:BC092518.1~uORF:IOH62695	50204	41	50163
B41R19C03	41-3-19	Hs~Ref:NM_213593.3~uORF:IOH60449	406	100	306
B41R19C04	41-4-19	Hs~Ref:NM_213593.3~uORF:IOH60449	42	39	3
B41R19C05	41-5-19	Hs~MGC:BC035079.2~uORF:IOH27679	716	35	681
B41R19C06	41-6-19	Hs~MGC:BC035079.2~uORF:IOH27679	704	35	669
B41R19C07	41-7-19	Hs~MGC:NM_181703.1~uORF:IOH13936	813	37	776
B41R19C08	41-8-19	Hs~MGC:NM_181703.1~uORF:IOH13936	877	37	840
B41R19C09	41-9-19	Hs~Ref:NM_152460.2~uORF:IOH35340	906	49	857
B41R19C10	41-10-19	Hs~Ref:NM_152460.2~uORF:IOH35340	801	48	753
B41R19C11	41-11-19	Hs~Ref:NM_178497.2~uORF:IOH44607	1019	47	972
B41R19C12	41-12-19	Hs~Ref:NM_178497.2~uORF:IOH44607	1040	47	993
B41R19C13	41-13-19	Hs~MGC:BC020713.1~uORF:IOH12329	735	47	688
B41R19C14	41-14-19	Hs~MGC:BC020713.1~uORF:IOH12329	641	46	595
B41R19C15	41-15-19	Hs~Ref:NM_203417.1~uORF:IOH45858	1192	49	1143
B41R19C16	41-16-19	Hs~Ref:NM_203417.1~uORF:IOH45858	1056	52	1004
B41R19C17	41-17-19	Hs~Ref:NM_212540.1~uORF:IOH45879	590	53	537
B41R19C18	41-18-19	Hs~Ref:NM_212540.1~uORF:IOH45879	724	126	598
B41R19C19	41-19-19	Hs~MGC:BC011857.2~uORF:IOH46160	1329	53	1276
B41R19C20	41-20-19	Hs~MGC:BC011857.2~uORF:IOH46160	1272	49	1223
B41R19C21	41-21-19	Hs~MGC:BC066942.1~uORF:IOH40062	323	47	276
B41R19C22	41-22-19	Hs~MGC:BC066942.1~uORF:IOH40062	394	52	342
B41R20C01	41-1-20	Hs~Ref:XM_373583.2~uORF:IOH43122	98	35	63
B41R20C02	41-2-20	Hs~Ref:XM_373583.2~uORF:IOH43122	97	34	63
B41R20C03	41-3-20	Hs~Ref:XM_379161.1~uORF:IOH41257	339	36	303
B41R20C04	41-4-20	Hs~Ref:XM_379161.1~uORF:IOH41257	324	35	289
B41R20C05	41-5-20	Hs~Ref:NM_148571.1~uORF:IOH41376	369	35	334
B41R20C06	41-6-20	Hs~Ref:NM_148571.1~uORF:IOH41376	382	34	348
B41R20C07	41-7-20	Hs~Ref:NM_144595.1~uORF:IOH25832	910	34	876
B41R20C08	41-8-20	Hs~Ref:NM_144595.1~uORF:IOH25832	890	36	854
B41R20C09	41-9-20	Hs~Ref:NM_005558.2~uORF:IOH13864	373	45	328
B41R20C10	41-10-20	Hs~Ref:NM_005558.2~uORF:IOH13864	407	43	364
B41R20C11	41-11-20	Hs~Ref:NM_024076.1~uORF:IOH4559	492	46	446
B41R20C12	41-12-20	Hs~Ref:NM_024076.1~uORF:IOH4559	485	46	439
B41R20C13	41-13-20	Hs~MGC:BC000103.1~uORF:IOH4659	1537	45	1492
B41R20C14	41-14-20	Hs~MGC:BC000103.1~uORF:IOH4659	1558	43	1515
B41R20C15	41-15-20	Hs~Ref:NM_152652.1~uORF:IOH41534	471	59	412
B41R20C16	41-16-20	Hs~Ref:NM_152652.1~uORF:IOH41534	392	55	337
B41R20C17	41-17-20	Hs~Ref:ENST00000397586~uORF:IOH41644	272	47	225
B41R20C18	41-18-20	Hs~Ref:ENST00000397586~uORF:IOH41644	194	51	143
B41R20C19	41-19-20	Hs~Ref:NM_015629.2~uORF:IOH41469	437	142	295
B41R20C20	41-20-20	Hs~Ref:NM_015629.2~uORF:IOH41469	497	51	446
B41R20C21	41-21-20	Hs~Ref:XM_002343855.1~uORF:IOH41141	161	48	113
B41R20C22	41-22-20	Hs~Ref:XM_002343855.1~uORF:IOH41141	172	49	123
B41R21C01	41-1-21	Hs~Ref:NM_134264.2~uORF:IOH43473	170	38	132
B41R21C02	41-2-21	Hs~Ref:NM_134264.2~uORF:IOH43473	97	34	63
B41R21C03	41-3-21	Hs~Ref:NM_012276.3~uORF:IOH43377	245	33	212
B41R21C04	41-4-21	Hs~Ref:NM_012276.3~uORF:IOH43377	284	39	245
B41R21C05	41-5-21	Hs~Ref:XM_378643.1~uORF:IOH43294	175	77	98
B41R21C06	41-6-21	Hs~Ref:XM_378643.1~uORF:IOH43294	95	33	62
B41R21C07	41-7-21	Hs~Ref:NM_173557.1~uORF:IOH43310	225	85	140
B41R21C08	41-8-21	Hs~Ref:NM_173557.1~uORF:IOH43310	86	38	48
B41R21C09	41-9-21	Hs~Ref:NP_006262.1~CAT_10179-H01H-25	104	47	57
B41R21C10	41-10-21	Hs~Ref:NP_006262.1~CAT_10179-H01H-25	41	42	-1
B41R21C11	41-11-21	Internal_1007209	39	39	0
B41R21C12	41-12-21	Internal_1007209	44	43	1
B41R21C13	41-13-21	Hs~Ref:NP_000407.1~CAT_10338-H08H-25	47	43	4
B41R21C14	41-14-21	Hs~Ref:NP_000407.1~CAT_10338-H08H-25	44	40	4
B41R21C15	41-15-21	Internal_1007209	48	41	7
B41R21C16	41-16-21	Internal_1007209	63	47	16
B41R21C17	41-17-21	Hs~Ref:NP_001618.2~CAT_10045-H08H-25	60	53	7
B41R21C18	41-18-21	Hs~Ref:NP_001618.2~CAT_10045-H08H-25	53	45	8
B41R21C19	41-19-21	Internal_1007209	1941	47	1894
B41R21C20	41-20-21	Internal_1007209	1903	47	1856
B41R21C21	41-21-21	Hs~Abcam:hu-IgE~CAT_ab65866~N/A	16933	48	16885
B41R21C22	41-22-21	Hs~Abcam:hu-IgE~CAT_ab65866~N/A	16123	49	16074
B41R22C01	41-1-22	ERa~N/A	2187	34	2153
B41R22C02	41-2-22	ERa~N/A	2189	35	2154
B41R22C03	41-3-22	PKCeta~N/A	310	34	276
B41R22C04	41-4-22	PKCeta~N/A	334	33	301
B41R22C05	41-5-22	Calmodulin~N/A	193	64	129
B41R22C06	41-6-22	Calmodulin~N/A	139	53	86
B41R22C07	41-7-22	V5control5~N/A	453	33	420
B41R22C08	41-8-22	V5control5~N/A	538	43	495
B41R22C09	41-9-22	V5control4~N/A	145	75	70
B41R22C10	41-10-22	V5control4~N/A	197	44	153
B41R22C11	41-11-22	V5control3~N/A	137	47	90
B41R22C12	41-12-22	V5control3~N/A	106	63	43
B41R22C13	41-13-22	V5control2~N/A	64	44	20
B41R22C14	41-14-22	V5control2~N/A	97	56	41
B41R22C15	41-15-22	V5control1~N/A	76	40	36
B41R22C16	41-16-22	V5control1~N/A	88	46	42
B41R22C17	41-17-22	CMK2A~N/A	284	48	236
B41R22C18	41-18-22	CMK2A~N/A	445	77	368
B41R22C19	41-19-22	ERa~N/A	2176	46	2130
B41R22C20	41-20-22	ERa~N/A	1896	44	1852
B41R22C21	41-21-22	AlexaAntiMouseAb~N/A	7777	45	7732
B41R22C22	41-22-22	AlexaAntiMouseAb~N/A	6650	46	6604
B42R01C01	42-1-1	AlexaAntiMouseAb~N/A	42489	61	42428
B42R01C02	42-2-1	AlexaAntiMouseAb~N/A	1404	49	1355
B42R01C03	42-3-1	ERa~N/A	1444	47	1397
B42R01C04	42-4-1	ERa~N/A	1584	46	1538
B42R01C05	42-5-1	HumanIgG1~N/A	1449	46	1403
B42R01C06	42-6-1	HumanIgG1~N/A	3587	46	3541
B42R01C07	42-7-1	HumanIgG2~N/A	3183	46	3137
B42R01C08	42-8-1	HumanIgG2~N/A	15729	47	15682
B42R01C09	42-9-1	HumanIgG3~N/A	14159	47	14112
B42R01C10	42-10-1	HumanIgG3~N/A	47217	51	47166
B42R01C11	42-11-1	HumanIgG4~N/A	42774	52	42722
B42R01C12	42-12-1	HumanIgG4~N/A	420	48	372
B42R01C13	42-13-1	BiotinAb~N/A	388	49	339
B42R01C14	42-14-1	BiotinAb~N/A	460	47	413
B42R01C15	42-15-1	RanBP2deltaFG~N/A	430	43	387
B42R01C16	42-16-1	RanBP2deltaFG~N/A	948	43	905
B42R01C17	42-17-1	hMDM2~N/A	911	48	863
B42R01C18	42-18-1	hMDM2~N/A	620	45	575
B42R01C19	42-19-1	PKCeta~N/A	535	45	490
B42R01C20	42-20-1	PKCeta~N/A	34634	44	34590
B42R01C21	42-21-1	AlexaAntiMouseAb~N/A	33156	42	33114
B42R01C22	42-22-1	AlexaAntiMouseAb~N/A	42	39	3
B42R02C01	42-1-2	PKCeta~N/A	1661	72	1589
B42R02C02	42-2-2	PKCeta~N/A	640	62	578
B42R02C03	42-3-2	Buffer	915	52	863
B42R02C04	42-4-2	Buffer	27049	50	26999
B42R02C05	42-5-2	HumanIgA~N/A	27172	52	27120
B42R02C06	42-6-2	HumanIgA~N/A	360	191	169
B42R02C07	42-7-2	Buffer	322	90	232
B42R02C08	42-8-2	Buffer	13804	50	13754
B42R02C09	42-9-2	BSA~N/A	13683	48	13635
B42R02C10	42-10-2	BSA~N/A	593	59	534
B42R02C11	42-11-2	Hs~Ref:NM_006401.1~uORF:IOH3664	624	340	284
B42R02C12	42-12-2	Hs~Ref:NM_006401.1~uORF:IOH3664	1526	103	1423
B42R02C13	42-13-2	Hs~MGC:BC009055.1~uORF:IOH3376	1404	107	1297
B42R02C14	42-14-2	Hs~MGC:BC009055.1~uORF:IOH3376	570	375	195
B42R02C15	42-15-2	Hs~MGC:BC000553.1~uORF:IOH4163	507	60	447
B42R02C16	42-16-2	Hs~MGC:BC000553.1~uORF:IOH4163	412	51	361
B42R02C17	42-17-2	Hs~Ref:NM_005390.1~uORF:IOH22280	454	59	395
B42R02C18	42-18-2	Hs~Ref:NM_005390.1~uORF:IOH22280	363	45	318
B42R02C19	42-19-2	Hs~Ref:NM_001016.2~uORF:IOH14179	451	82	369
B42R02C20	42-20-2	Hs~Ref:NM_001016.2~uORF:IOH14179	409	48	361
B42R02C21	42-21-2	Hs~MGC:BC016365.1~uORF:IOH27881	659	46	613
B42R02C22	42-22-2	Hs~MGC:BC016365.1~uORF:IOH27881	636	41	595
B42R03C01	42-1-3	Hs~Ref:NM_017856.1~uORF:IOH3877	648	69	579
B42R03C02	42-2-3	Hs~Ref:NM_017856.1~uORF:IOH3877	579	64	515
B42R03C03	42-3-3	Hs~MGC:BC000896.1~uORF:IOH3226	497	62	435
B42R03C04	42-4-3	Hs~MGC:BC000896.1~uORF:IOH3226	502	54	448
B42R03C05	42-5-3	Hs~Ref:NM_016830.2~uORF:IOH43739	271	55	216
B42R03C06	42-6-3	Hs~Ref:NM_016830.2~uORF:IOH43739	306	54	252
B42R03C07	42-7-3	Hs~Ref:NM_033484.1~uORF:IOH42196	360	99	261
B42R03C08	42-8-3	Hs~Ref:NM_033484.1~uORF:IOH42196	314	64	250
B42R03C09	42-9-3	Hs~MGC:NM_201280.1~uORF:IOH43536	1848	52	1796
B42R03C10	42-10-3	Hs~MGC:NM_201280.1~uORF:IOH43536	1676	54	1622
B42R03C11	42-11-3	Hs~Ref:NM_032141.1~uORF:IOH43707	8127	68	8059
B42R03C12	42-12-3	Hs~Ref:NM_032141.1~uORF:IOH43707	8094	133	7961
B42R03C13	42-13-3	Hs~Ref:NM_033259.1~uORF:IOH42049	410	158	252
B42R03C14	42-14-3	Hs~Ref:NM_033259.1~uORF:IOH42049	419	83	336
B42R03C15	42-15-3	Hs~Ref:NM_198501.1~uORF:IOH43320	2444	97	2347
B42R03C16	42-16-3	Hs~Ref:NM_198501.1~uORF:IOH43320	2241	65	2176
B42R03C17	42-17-3	Hs~Ref:XM_086879.4~uORF:IOH43381	3993	59	3934
B42R03C18	42-18-3	Hs~Ref:XM_086879.4~uORF:IOH43381	4210	57	4153
B42R03C19	42-19-3	Hs~Ref:NM_005089.1~uORF:IOH43714	234	60	174
B42R03C20	42-20-3	Hs~Ref:NM_005089.1~uORF:IOH43714	137	47	90
B42R03C21	42-21-3	Hs~Ref:NM_005506.1~uORF:IOH9776	400	44	356
B42R03C22	42-22-3	Hs~Ref:NM_005506.1~uORF:IOH9776	362	41	321
B42R04C01	42-1-4	Hs~Ref:NM_052852.1~uORF:IOH5816	505	171	334
B42R04C02	42-2-4	Hs~Ref:NM_052852.1~uORF:IOH5816	635	65	570
B42R04C03	42-3-4	Hs~MGC:BC009464.1~uORF:IOH13699	516	64	452
B42R04C04	42-4-4	Hs~MGC:BC009464.1~uORF:IOH13699	658	81	577
B42R04C05	42-5-4	Hs~MGC:BC007523.1~uORF:IOH6889	350	59	291
B42R04C06	42-6-4	Hs~MGC:BC007523.1~uORF:IOH6889	323	56	267
B42R04C07	42-7-4	Hs~MGC:BC029378.1~uORF:IOH23186	2402	57	2345
B42R04C08	42-8-4	Hs~MGC:BC029378.1~uORF:IOH23186	2350	53	2297
B42R04C09	42-9-4	Hs~MGC:BC032708.1~uORF:IOH21938	1070	48	1022
B42R04C10	42-10-4	Hs~MGC:BC032708.1~uORF:IOH21938	1003	47	956
B42R04C11	42-11-4	Hs~Ref:NM_003617.2~uORF:IOH23200	2201	48	2153
B42R04C12	42-12-4	Hs~Ref:NM_003617.2~uORF:IOH23200	2113	59	2054
B42R04C13	42-13-4	Hs~MGC:BC014475.1~uORF:IOH12830	702	74	628
B42R04C14	42-14-4	Hs~MGC:BC014475.1~uORF:IOH12830	589	79	510
B42R04C15	42-15-4	Hs~Ref:NM_006817.2~uORF:IOH41199	273	108	165
B42R04C16	42-16-4	Hs~Ref:NM_006817.2~uORF:IOH41199	205	143	62
B42R04C17	42-17-4	Hs~Ref:NM_022575.2~uORF:IOH41705	500	232	268
B42R04C18	42-18-4	Hs~Ref:NM_022575.2~uORF:IOH41705	165	138	27
B42R04C19	42-19-4	Hs~Ref:NM_181690.1~uORF:IOH43070	372	279	93
B42R04C20	42-20-4	Hs~Ref:NM_181690.1~uORF:IOH43070	501	118	383
B42R04C21	42-21-4	Hs~Ref:NM_005794.2~uORF:IOH41302	677	51	626
B42R04C22	42-22-4	Hs~Ref:NM_005794.2~uORF:IOH41302	634	43	591
B42R05C01	42-1-5	Hs~Ref:NM_152418.2~uORF:IOH43407	213	74	139
B42R05C02	42-2-5	Hs~Ref:NM_152418.2~uORF:IOH43407	368	155	213
B42R05C03	42-3-5	Hs~Ref:NM_022333.1~uORF:IOH43130	354	103	251
B42R05C04	42-4-5	Hs~Ref:NM_022333.1~uORF:IOH43130	298	69	229
B42R05C05	42-5-5	Hs~Ref:NM_173700.1~uORF:IOH43271	328	60	268
B42R05C06	42-6-5	Hs~Ref:NM_173700.1~uORF:IOH43271	386	69	317
B42R05C07	42-7-5	Hs~Ref:XM_379667.1~uORF:IOH43133	400	92	308
B42R05C08	42-8-5	Hs~Ref:XM_379667.1~uORF:IOH43133	246	103	143
B42R05C09	42-9-5	Hs~MGC:BC068078.1~uORF:IOH40781	2311	46	2265
B42R05C10	42-10-5	Hs~MGC:BC068078.1~uORF:IOH40781	2405	47	2358
B42R05C11	42-11-5	Hs~MGC:BC012885.1~uORF:IOH10554	268	49	219
B42R05C12	42-12-5	Hs~MGC:BC012885.1~uORF:IOH10554	284	92	192
B42R05C13	42-13-5	Hs~MGC:BC064612.1~uORF:IOH39905	4677	68	4609
B42R05C14	42-14-5	Hs~MGC:BC064612.1~uORF:IOH39905	4491	65	4426
B42R05C15	42-15-5	Hs~Ref:NM_145261.2~uORF:IOH9879	328	106	222
B42R05C16	42-16-5	Hs~Ref:NM_145261.2~uORF:IOH9879	164	65	99
B42R05C17	42-17-5	Hs~Ref:NM_016370.1~uORF:IOH42108	1064	149	915
B42R05C18	42-18-5	Hs~Ref:NM_016370.1~uORF:IOH42108	290	139	151
B42R05C19	42-19-5	Hs~Ref:NM_020197.1~uORF:IOH42115	757	186	571
B42R05C20	42-20-5	Hs~Ref:NM_020197.1~uORF:IOH42115	763	149	614
B42R05C21	42-21-5	Hs~Ref:NM_001012337.1~uORF:IOH42173	343	67	276
B42R05C22	42-22-5	Hs~Ref:NM_001012337.1~uORF:IOH42173	169	50	119
B42R06C01	42-1-6	Hs~Ref:NM_018201.2~uORF:IOH41097	236	70	166
B42R06C02	42-2-6	Hs~Ref:NM_018201.2~uORF:IOH41097	292	191	101
B42R06C03	42-3-6	Hs~MGC:BC009077.1~uORF:IOH9817	482	111	371
B42R06C04	42-4-6	Hs~MGC:BC009077.1~uORF:IOH9817	415	147	268
B42R06C05	42-5-6	Hs~Ref:NM_016422.2~uORF:IOH11058	424	121	303
B42R06C06	42-6-6	Hs~Ref:NM_016422.2~uORF:IOH11058	378	56	322
B42R06C07	42-7-6	Hs~MGC:BC000557.1~uORF:IOH4154	649	52	597
B42R06C08	42-8-6	Hs~MGC:BC000557.1~uORF:IOH4154	419	50	369
B42R06C09	42-9-6	Hs~MGC:BC011916.1~uORF:IOH12850	426	55	371
B42R06C10	42-10-6	Hs~MGC:BC011916.1~uORF:IOH12850	540	278	262
B42R06C11	42-11-6	Hs~MGC:BC000412.1~uORF:IOH3631	749	50	699
B42R06C12	42-12-6	Hs~MGC:BC000412.1~uORF:IOH3631	810	54	756
B42R06C13	42-13-6	Hs~MGC:BC001606.1~uORF:IOH4901	3012	63	2949
B42R06C14	42-14-6	Hs~MGC:BC001606.1~uORF:IOH4901	2749	56	2693
B42R06C15	42-15-6	Hs~MGC:BC006306.1~uORF:IOH6404	531	50	481
B42R06C16	42-16-6	Hs~MGC:BC006306.1~uORF:IOH6404	524	55	469
B42R06C17	42-17-6	Hs~MGC:BC007750.2~uORF:IOH6405	199	86	113
B42R06C18	42-18-6	Hs~MGC:BC007750.2~uORF:IOH6405	432	75	357
B42R06C19	42-19-6	Hs~Ref:NM_025241.1~uORF:IOH41143	357	72	285
B42R06C20	42-20-6	Hs~Ref:NM_025241.1~uORF:IOH41143	213	68	145
B42R06C21	42-21-6	Hs~Ref:NM_201592.1~uORF:IOH41375	1109	57	1052
B42R06C22	42-22-6	Hs~Ref:NM_201592.1~uORF:IOH41375	1229	43	1186
B42R07C01	42-1-7	Hs~Ref:NM_052988.2~uORF:IOH41508	362	68	294
B42R07C02	42-2-7	Hs~Ref:NM_052988.2~uORF:IOH41508	440	106	334
B42R07C03	42-3-7	Hs~MGC:BC093020.1~uORF:IOH62682	1613	85	1528
B42R07C04	42-4-7	Hs~MGC:BC093020.1~uORF:IOH62682	1533	74	1459
B42R07C05	42-5-7	Hs~MGC:BC070267.1~uORF:IOH40812	207	79	128
B42R07C06	42-6-7	Hs~MGC:BC070267.1~uORF:IOH40812	163	57	106
B42R07C07	42-7-7	Hs~Ref:NM_025197.2~uORF:IOH42110	152	57	95
B42R07C08	42-8-7	Hs~Ref:NM_025197.2~uORF:IOH42110	150	54	96
B42R07C09	42-9-7	Hs~Ref:NM_138559.1~uORF:IOH43559	426	52	374
B42R07C10	42-10-7	Hs~Ref:NM_138559.1~uORF:IOH43559	456	57	399
B42R07C11	42-11-7	Hs~Ref:XM_371664.3~uORF:IOH43574	105	48	57
B42R07C12	42-12-7	Hs~Ref:XM_371664.3~uORF:IOH43574	99	53	46
B42R07C13	42-13-7	Hs~MGC:BC007340.2~uORF:IOH62790	648	152	496
B42R07C14	42-14-7	Hs~MGC:BC007340.2~uORF:IOH62790	315	98	217
B42R07C15	42-15-7	Hs~MGC:BC070299.1~uORF:IOH62888	277	52	225
B42R07C16	42-16-7	Hs~MGC:BC070299.1~uORF:IOH62888	332	93	239
B42R07C17	42-17-7	Hs~MGC:BC006357.2~uORF:IOH62832	278	63	215
B42R07C18	42-18-7	Hs~MGC:BC006357.2~uORF:IOH62832	274	60	214
B42R07C19	42-19-7	Hs~MGC:BC014022.2~uORF:IOH62925	147	57	90
B42R07C20	42-20-7	Hs~MGC:BC014022.2~uORF:IOH62925	127	54	73
B42R07C21	42-21-7	Hs~MGC:BC005958.1~uORF:IOH62812	114	58	56
B42R07C22	42-22-7	Hs~MGC:BC005958.1~uORF:IOH62812	107	63	44
B42R08C01	42-1-8	Hs~MGC:BC074965.2~uORF:IOH61950	361	89	272
B42R08C02	42-2-8	Hs~MGC:BC074965.2~uORF:IOH61950	133	71	62
B42R08C03	42-3-8	Hs~Ref:NM_016433.3~uORF:IOH57161	485	120	365
B42R08C04	42-4-8	Hs~Ref:NM_016433.3~uORF:IOH57161	117	68	49
B42R08C05	42-5-8	Hs~MGC:BC036804.1~uORF:IOH56311	255	87	168
B42R08C06	42-6-8	Hs~MGC:BC036804.1~uORF:IOH56311	150	78	72
B42R08C07	42-7-8	Hs~MGC:BC029799.1~uORF:IOH22727	390	179	211
B42R08C08	42-8-8	Hs~MGC:BC029799.1~uORF:IOH22727	162	90	72
B42R08C09	42-9-8	Hs~MGC:BC002751.1~uORF:IOH5335	483	51	432
B42R08C10	42-10-8	Hs~MGC:BC002751.1~uORF:IOH5335	553	61	492
B42R08C11	42-11-8	Hs~MGC:BC001250.1~uORF:IOH3221	1940	48	1892
B42R08C12	42-12-8	Hs~MGC:BC001250.1~uORF:IOH3221	1938	55	1883
B42R08C13	42-13-8	Hs~Ref:NM_016630.2~uORF:IOH4511	466	168	298
B42R08C14	42-14-8	Hs~Ref:NM_016630.2~uORF:IOH4511	439	136	303
B42R08C15	42-15-8	Hs~MGC:BC009779.1~uORF:IOH12227	1602	54	1548
B42R08C16	42-16-8	Hs~MGC:BC009779.1~uORF:IOH12227	1578	56	1522
B42R08C17	42-17-8	Hs~Ref:NM_033661.1~uORF:IOH6391	509	246	263
B42R08C18	42-18-8	Hs~Ref:NM_033661.1~uORF:IOH6391	287	210	77
B42R08C19	42-19-8	Hs~MGC:BC018445.1~uORF:IOH9764	341	197	144
B42R08C20	42-20-8	Hs~MGC:BC018445.1~uORF:IOH9764	230	59	171
B42R08C21	42-21-8	Hs~MGC:BC008091.1~uORF:IOH3325	172	57	115
B42R08C22	42-22-8	Hs~MGC:BC008091.1~uORF:IOH3325	152	50	102
B42R09C01	42-1-9	Hs~MGC:BC034926.1~uORF:IOH23229	355	56	299
B42R09C02	42-2-9	Hs~MGC:BC034926.1~uORF:IOH23229	480	75	405
B42R09C03	42-3-9	Hs~Ref:NM_020126.3~uORF:IOH6613	482	114	368
B42R09C04	42-4-9	Hs~Ref:NM_020126.3~uORF:IOH6613	438	269	169
B42R09C05	42-5-9	Hs~Ref:NM_024036.3~uORF:IOH23019	381	136	245
B42R09C06	42-6-9	Hs~Ref:NM_024036.3~uORF:IOH23019	178	60	118
B42R09C07	42-7-9	Hs~MGC:BC015008.1~uORF:IOH23029	1901	69	1832
B42R09C08	42-8-9	Hs~MGC:BC015008.1~uORF:IOH23029	2151	62	2089
B42R09C09	42-9-9	Hs~Ref:NM_006666.1~uORF:IOH3426	256	58	198
B42R09C10	42-10-9	Hs~Ref:NM_006666.1~uORF:IOH3426	367	125	242
B42R09C11	42-11-9	Hs~Ref:NM_006145.1~uORF:IOH3496	612	48	564
B42R09C12	42-12-9	Hs~Ref:NM_006145.1~uORF:IOH3496	604	48	556
B42R09C13	42-13-9	Hs~Ref:NM_014176.1~uORF:IOH3736	318	57	261
B42R09C14	42-14-9	Hs~Ref:NM_014176.1~uORF:IOH3736	265	55	210
B42R09C15	42-15-9	Hs~Ref:NM_006169.1~uORF:IOH4357	265	83	182
B42R09C16	42-16-9	Hs~Ref:NM_006169.1~uORF:IOH4357	136	48	88
B42R09C17	42-17-9	Hs~MGC:BC053853.1~uORF:IOH28945	384	199	185
B42R09C18	42-18-9	Hs~MGC:BC053853.1~uORF:IOH28945	171	56	115
B42R09C19	42-19-9	Hs~MGC:BC046173.2~uORF:IOH28861	692	90	602
B42R09C20	42-20-9	Hs~MGC:BC046173.2~uORF:IOH28861	119	55	64
B42R09C21	42-21-9	Hs~MGC:BC052611.1~uORF:IOH29384	342	146	196
B42R09C22	42-22-9	Hs~MGC:BC052611.1~uORF:IOH29384	218	65	153
B42R10C01	42-1-10	Hs~Ref:NM_002059.3~uORF:IOH12292	559	52	507
B42R10C02	42-2-10	Hs~Ref:NM_002059.3~uORF:IOH12292	599	74	525
B42R10C03	42-3-10	Hs~MGC:BC056408.1~uORF:IOH29086	491	78	413
B42R10C04	42-4-10	Hs~MGC:BC056408.1~uORF:IOH29086	470	76	394
B42R10C05	42-5-10	Hs~MGC:BC051301.1~uORF:IOH29359	293	69	224
B42R10C06	42-6-10	Hs~MGC:BC051301.1~uORF:IOH29359	391	126	265
B42R10C07	42-7-10	Hs~MGC:BC051716.1~uORF:IOH28817	408	80	328
B42R10C08	42-8-10	Hs~MGC:BC051716.1~uORF:IOH28817	341	89	252
B42R10C09	42-9-10	Hs~MGC:BC035198.1~uORF:IOH28613	362	53	309
B42R10C10	42-10-10	Hs~MGC:BC035198.1~uORF:IOH28613	277	78	199
B42R10C11	42-11-10	GST1	52	45	7
B42R10C12	42-12-10	GST1	48	45	3
B42R10C13	42-13-10	GST2	50	44	6
B42R10C14	42-14-10	GST2	47	44	3
B42R10C15	42-15-10	GST3	57	46	11
B42R10C16	42-16-10	GST3	53	45	8
B42R10C17	42-17-10	GST4	74	44	30
B42R10C18	42-18-10	GST4	43	48	-5
B42R10C19	42-19-10	Anti-HumanIgA1~N/A	8646	47	8599
B42R10C20	42-20-10	Anti-HumanIgA1~N/A	9442	48	9394
B42R10C21	42-21-10	Anti-HumanIgA2~N/A	16518	58	16460
B42R10C22	42-22-10	Anti-HumanIgA2~N/A	18657	50	18607
B42R11C01	42-1-11	AlexaAntiMouseAb~N/A	25151	49	25102
B42R11C02	42-2-11	AlexaAntiMouseAb~N/A	23703	63	23640
B42R11C03	42-3-11	MAPKAP~N/A	149	74	75
B42R11C04	42-4-11	MAPKAP~N/A	103	72	31
B42R11C05	42-5-11	Buffer	174	74	100
B42R11C06	42-6-11	Buffer	147	65	82
B42R11C07	42-7-11	BSA~N/A	11395	63	11332
B42R11C08	42-8-11	BSA~N/A	10698	52	10646
B42R11C09	42-9-11	Anti-HumanIgG1~N/A	1662	45	1617
B42R11C10	42-10-11	Anti-HumanIgG1~N/A	2084	45	2039
B42R11C11	42-11-11	Anti-HumanIgG2~N/A	3326	45	3281
B42R11C12	42-12-11	Anti-HumanIgG2~N/A	4022	45	3977
B42R11C13	42-13-11	Anti-HumanIgG3~N/A	6056	45	6011
B42R11C14	42-14-11	Anti-HumanIgG3~N/A	6762	43	6719
B42R11C15	42-15-11	Anti-HumanIgG4~N/A	10522	48	10474
B42R11C16	42-16-11	Anti-HumanIgG4~N/A	12876	48	12828
B42R11C17	42-17-11	AntiBiotinAb~N/A	14503	45	14458
B42R11C18	42-18-11	AntiBiotinAb~N/A	14706	45	14661
B42R11C19	42-19-11	Buffer	188	58	130
B42R11C20	42-20-11	Buffer	63	49	14
B42R11C21	42-21-11	Hs~Ref:NM_020651.2~uORF:IOH26519	710	64	646
B42R11C22	42-22-11	Hs~Ref:NM_020651.2~uORF:IOH26519	670	62	608
B42R12C01	42-1-12	Hs~Ref:NM_006116.2~uORF:IOH26991	549	48	501
B42R12C02	42-2-12	Hs~Ref:NM_006116.2~uORF:IOH26991	595	63	532
B42R12C03	42-3-12	Hs~Ref:NM_182539.1~uORF:IOH27104	629	74	555
B42R12C04	42-4-12	Hs~Ref:NM_182539.1~uORF:IOH27104	545	79	466
B42R12C05	42-5-12	Hs~MGC:BC039731.1~uORF:IOH26126	684	85	599
B42R12C06	42-6-12	Hs~MGC:BC039731.1~uORF:IOH26126	572	80	492
B42R12C07	42-7-12	Hs~MGC:BC016768.1~uORF:IOH27892	512	99	413
B42R12C08	42-8-12	Hs~MGC:BC016768.1~uORF:IOH27892	122	59	63
B42R12C09	42-9-12	Hs~Ref:NM_006433.2~uORF:IOH27865	314	62	252
B42R12C10	42-10-12	Hs~Ref:NM_006433.2~uORF:IOH27865	90	45	45
B42R12C11	42-11-12	Hs~Ref:NM_014178.4~uORF:IOH12643	261	46	215
B42R12C12	42-12-12	Hs~Ref:NM_014178.4~uORF:IOH12643	80	46	34
B42R12C13	42-13-12	Hs~Ref:NM_003618.2~N/A	200	48	152
B42R12C14	42-14-12	Hs~Ref:NM_003618.2~N/A	51	46	5
B42R12C15	42-15-12	Hs~MGC:BC104042.1~uORF:IOH63415	186	52	134
B42R12C16	42-16-12	Hs~MGC:BC104042.1~uORF:IOH63415	285	53	232
B42R12C17	42-17-12	Hs~MGC:BC099658.1~uORF:IOH63280	291	81	210
B42R12C18	42-18-12	Hs~MGC:BC099658.1~uORF:IOH63280	267	50	217
B42R12C19	42-19-12	Hs~MGC:BC011618.2~uORF:IOH13944	427	83	344
B42R12C20	42-20-12	Hs~MGC:BC011618.2~uORF:IOH13944	175	65	110
B42R12C21	42-21-12	Hs~MGC:BC103812.1~uORF:IOH63363	2753	70	2683
B42R12C22	42-22-12	Hs~MGC:BC103812.1~uORF:IOH63363	2757	58	2699
B42R13C01	42-1-13	Hs~Ref:XM_378240.1~uORF:IOH44459	224	79	145
B42R13C02	42-2-13	Hs~Ref:XM_378240.1~uORF:IOH44459	170	51	119
B42R13C03	42-3-13	Hs~Ref:NM_018847.1~uORF:IOH42536	1570	65	1505
B42R13C04	42-4-13	Hs~Ref:NM_018847.1~uORF:IOH42536	1496	82	1414
B42R13C05	42-5-13	Hs~Ref:NM_198266.1~uORF:IOH44502	843	102	741
B42R13C06	42-6-13	Hs~Ref:NM_198266.1~uORF:IOH44502	743	103	640
B42R13C07	42-7-13	Hs~Ref:NM_152434.1~uORF:IOH42646	518	91	427
B42R13C08	42-8-13	Hs~Ref:NM_152434.1~uORF:IOH42646	465	73	392
B42R13C09	42-9-13	Hs~MGC:BC025700.1~uORF:IOH11281	729	61	668
B42R13C10	42-10-13	Hs~MGC:BC025700.1~uORF:IOH11281	699	54	645
B42R13C11	42-11-13	Hs~MGC:BC021559.1~uORF:IOH14004	629	52	577
B42R13C12	42-12-13	Hs~MGC:BC021559.1~uORF:IOH14004	607	46	561
B42R13C13	42-13-13	Hs~Ref:NM_007111.2~uORF:IOH13752	195	48	147
B42R13C14	42-14-13	Hs~Ref:NM_007111.2~uORF:IOH13752	321	132	189
B42R13C15	42-15-13	Hs~Ref:NM_002005.2~uORF:IOH21035	482	52	430
B42R13C16	42-16-13	Hs~Ref:NM_002005.2~uORF:IOH21035	456	51	405
B42R13C17	42-17-13	Hs~Ref:NM_006002.2~uORF:IOH11751	81	56	25
B42R13C18	42-18-13	Hs~Ref:NM_006002.2~uORF:IOH11751	449	57	392
B42R13C19	42-19-13	Hs~MGC:BC001743.1~uORF:IOH4884	319	62	257
B42R13C20	42-20-13	Hs~MGC:BC001743.1~uORF:IOH4884	522	54	468
B42R13C21	42-21-13	Hs~MGC:BC002778.1~uORF:IOH5313	587	61	526
B42R13C22	42-22-13	Hs~MGC:BC002778.1~uORF:IOH5313	511	53	458
B42R14C01	42-1-14	Hs~Ref:NM_004708.2~uORF:IOH11821	214	44	170
B42R14C02	42-2-14	Hs~Ref:NM_004708.2~uORF:IOH11821	385	49	336
B42R14C03	42-3-14	Hs~Ref:NM_003212.1~uORF:IOH54730	208	56	152
B42R14C04	42-4-14	Hs~Ref:NM_003212.1~uORF:IOH54730	329	79	250
B42R14C05	42-5-14	Hs~Ref:NM_002039.2~uORF:IOH52632	1548	97	1451
B42R14C06	42-6-14	Hs~Ref:NM_002039.2~uORF:IOH52632	1515	109	1406
B42R14C07	42-7-14	Hs~Ref:NM_002266.2~uORF:IOH54048	805	108	697
B42R14C08	42-8-14	Hs~Ref:NM_002266.2~uORF:IOH54048	766	97	669
B42R14C09	42-9-14	Hs~Ref:NM_130791.1~uORF:IOH59559	398	90	308
B42R14C10	42-10-14	Hs~Ref:NM_130791.1~uORF:IOH59559	333	69	264
B42R14C11	42-11-14	Hs~Ref:NM_006905.2~uORF:IOH12639	471	114	357
B42R14C12	42-12-14	Hs~Ref:NM_006905.2~uORF:IOH12639	228	117	111
B42R14C13	42-13-14	Hs~Ref:NM_021237.3~uORF:IOH50183	676	112	564
B42R14C14	42-14-14	Hs~Ref:NM_021237.3~uORF:IOH50183	172	48	124
B42R14C15	42-15-14	Hs~Ref:NM_130897.1~uORF:IOH50191	350	49	301
B42R14C16	42-16-14	Hs~Ref:NM_130897.1~uORF:IOH50191	319	52	267
B42R14C17	42-17-14	Hs~MGC:BC101026.2~uORF:IOH63533	692	53	639
B42R14C18	42-18-14	Hs~MGC:BC101026.2~uORF:IOH63533	602	56	546
B42R14C19	42-19-14	Hs~MGC:NM_182607.2~uORF:IOH25853	399	59	340
B42R14C20	42-20-14	Hs~MGC:NM_182607.2~uORF:IOH25853	284	56	228
B42R14C21	42-21-14	Hs~MGC:BC030640.1~uORF:IOH26818	491	49	442
B42R14C22	42-22-14	Hs~MGC:BC030640.1~uORF:IOH26818	487	45	442
B42R15C01	42-1-15	Hs~MGC:BC012924.1~uORF:IOH11017	719	41	678
B42R15C02	42-2-15	Hs~MGC:BC012924.1~uORF:IOH11017	718	47	671
B42R15C03	42-3-15	Hs~MGC:BC069092.1~uORF:IOH63641	1686	59	1627
B42R15C04	42-4-15	Hs~MGC:BC069092.1~uORF:IOH63641	1725	70	1655
B42R15C05	42-5-15	Hs~Ref:NM_019845.1~uORF:IOH5716	508	122	386
B42R15C06	42-6-15	Hs~Ref:NM_019845.1~uORF:IOH5716	237	118	119
B42R15C07	42-7-15	Hs~Ref:NM_024309.1~uORF:IOH5379	739	132	607
B42R15C08	42-8-15	Hs~Ref:NM_024309.1~uORF:IOH5379	723	141	582
B42R15C09	42-9-15	Hs~MGC:BC028064.1~uORF:IOH11593	319	116	203
B42R15C10	42-10-15	Hs~MGC:BC028064.1~uORF:IOH11593	245	89	156
B42R15C11	42-11-15	Hs~MGC:BC004410.1~uORF:IOH5586	186	65	121
B42R15C12	42-12-15	Hs~MGC:BC004410.1~uORF:IOH5586	183	78	105
B42R15C13	42-13-15	Hs~IVGN:PM_2150~Ext:Smith~N/A	75	55	20
B42R15C14	42-14-15	Hs~IVGN:PM_2150~Ext:Smith~N/A	114	43	71
B42R15C15	42-15-15	Hs~Ref:NM_021972.2~CAT:PV5214	142	43	99
B42R15C16	42-16-15	Hs~Ref:NM_021972.2~CAT:PV5214	126	45	81
B42R15C17	42-17-15	Hs~Ref:NM_000208.1~CAT:PV3781	89	48	41
B42R15C18	42-18-15	Hs~Ref:NM_000208.1~CAT:PV3781	161	51	110
B42R15C19	42-19-15	Hs~N/A:NM_004333.1~CAT:PV3849	581	54	527
B42R15C20	42-20-15	Hs~N/A:NM_004333.1~CAT:PV3849	726	53	673
B42R15C21	42-21-15	Hs~Ref:NM_004760.1~CAT:PV3783	334	148	186
B42R15C22	42-22-15	Hs~Ref:NM_004760.1~CAT:PV3783	276	52	224
B42R16C01	42-1-16	Hs~Ref:NM_002031.1~CAT:PV3874	1839	43	1796
B42R16C02	42-2-16	Hs~Ref:NM_002031.1~CAT:PV3874	1880	47	1833
B42R16C03	42-3-16	Hs~Ref:NM_004329~CAT_PHC9245	65535	59	65476
B42R16C04	42-4-16	Hs~Ref:NM_004329~CAT_PHC9245	65535	61	65474
B42R16C05	42-5-16	Hs~IVGN:NM_001178131~CAT_PHG0315~N/A	149	65	84
B42R16C06	42-6-16	Hs~IVGN:NM_001178131~CAT_PHG0315~N/A	193	93	100
B42R16C07	42-7-16	Hs~MGC:BC019254.1~uORF:IOH12801	654	160	494
B42R16C08	42-8-16	Hs~MGC:BC019254.1~uORF:IOH12801	535	175	360
B42R16C09	42-9-16	Hs~MGC:BC029560.1~uORF:IOH21582	611	247	364
B42R16C10	42-10-16	Hs~MGC:BC029560.1~uORF:IOH21582	498	258	240
B42R16C11	42-11-16	Hs~MGC:BC031564.1~uORF:IOH22698	561	194	367
B42R16C12	42-12-16	Hs~MGC:BC031564.1~uORF:IOH22698	312	67	245
B42R16C13	42-13-16	Hs~Ref:NM_016449.2~uORF:IOH29060	761	52	709
B42R16C14	42-14-16	Hs~Ref:NM_016449.2~uORF:IOH29060	779	44	735
B42R16C15	42-15-16	Hs~Ref:NM_001014291.1~uORF:IOH57344	410	43	367
B42R16C16	42-16-16	Hs~Ref:NM_001014291.1~uORF:IOH57344	399	45	354
B42R16C17	42-17-16	Hs~MGC:BC038585.1~uORF:IOH26053	891	46	845
B42R16C18	42-18-16	Hs~MGC:BC038585.1~uORF:IOH26053	837	46	791
B42R16C19	42-19-16	Hs~Ref:NM_019025.2~uORF:IOH41563	450	53	397
B42R16C20	42-20-16	Hs~Ref:NM_019025.2~uORF:IOH41563	432	55	377
B42R16C21	42-21-16	Hs~Ref:NM_017974.2~uORF:IOH37886	680	48	632
B42R16C22	42-22-16	Hs~Ref:NM_017974.2~uORF:IOH37886	666	40	626
B42R17C01	42-1-17	Hs~Ref:NM_005720.1~uORF:IOH3992	353	50	303
B42R17C02	42-2-17	Hs~Ref:NM_005720.1~uORF:IOH3992	382	54	328
B42R17C03	42-3-17	Hs~Ref:NM_004635.2~uORF:IOH3889	361	58	303
B42R17C04	42-4-17	Hs~Ref:NM_004635.2~uORF:IOH3889	313	82	231
B42R17C05	42-5-17	Hs~MGC:BC009967.1~uORF:IOH12224	460	165	295
B42R17C06	42-6-17	Hs~MGC:BC009967.1~uORF:IOH12224	372	91	281
B42R17C07	42-7-17	Hs~MGC:BC007530.1~uORF:IOH6875	123	129	-6
B42R17C08	42-8-17	Hs~MGC:BC007530.1~uORF:IOH6875	339	173	166
B42R17C09	42-9-17	Hs~Ref:NM_001764.1~uORF:IOH35547	297	243	54
B42R17C10	42-10-17	Hs~Ref:NM_001764.1~uORF:IOH35547	279	210	69
B42R17C11	42-11-17	Hs~Ref:NM_021062.2~uORF:IOH35040	458	110	348
B42R17C12	42-12-17	Hs~Ref:NM_021062.2~uORF:IOH35040	442	56	386
B42R17C13	42-13-17	Hs~Ref:NM_175055.2~uORF:IOH35043	340	50	290
B42R17C14	42-14-17	Hs~Ref:NM_175055.2~uORF:IOH35043	350	47	303
B42R17C15	42-15-17	Hs~Ref:NM_173597.1~uORF:IOH35045	269	43	226
B42R17C16	42-16-17	Hs~Ref:NM_173597.1~uORF:IOH35045	161	47	114
B42R17C17	42-17-17	Hs~MGC:BC100026.1~uORF:IOH62766	340	83	257
B42R17C18	42-18-17	Hs~MGC:BC100026.1~uORF:IOH62766	141	47	94
B42R17C19	42-19-17	Hs~MGC:BC100954.1~uORF:IOH63439	182	59	123
B42R17C20	42-20-17	Hs~MGC:BC100954.1~uORF:IOH63439	354	80	274
B42R17C21	42-21-17	Hs~MGC:BC001277.1~uORF:IOH3254	181	50	131
B42R17C22	42-22-17	Hs~MGC:BC001277.1~uORF:IOH3254	76	50	26
B42R18C01	42-1-18	Hs~MGC:BC036364.1~uORF:IOH27636	127	53	74
B42R18C02	42-2-18	Hs~MGC:BC036364.1~uORF:IOH27636	108	49	59
B42R18C03	42-3-18	Hs~Ref:NM_005893.1~uORF:IOH2471	74	46	28
B42R18C04	42-4-18	Hs~Ref:NM_005893.1~uORF:IOH2471	345	55	290
B42R18C05	42-5-18	Hs~Ref:NM_001622.1~uORF:IOH2128	437	57	380
B42R18C06	42-6-18	Hs~Ref:NM_001622.1~uORF:IOH2128	117	59	58
B42R18C07	42-7-18	Hs~MGC:BC058000.1~uORF:IOH29426	227	121	106
B42R18C08	42-8-18	Hs~MGC:BC058000.1~uORF:IOH29426	224	190	34
B42R18C09	42-9-18	Hs~MGC:BC058039.1~uORF:IOH29487	364	357	7
B42R18C10	42-10-18	Hs~MGC:BC058039.1~uORF:IOH29487	364	363	1
B42R18C11	42-11-18	Hs~MGC:BC045753.1~uORF:IOH62371	662	184	478
B42R18C12	42-12-18	Hs~MGC:BC045753.1~uORF:IOH62371	425	59	366
B42R18C13	42-13-18	Hs~MGC:BC005403.1~uORF:IOH61712	831	53	778
B42R18C14	42-14-18	Hs~MGC:BC005403.1~uORF:IOH61712	902	49	853
B42R18C15	42-15-18	Hs~MGC:BC065819.1~uORF:IOH61742	479	48	431
B42R18C16	42-16-18	Hs~MGC:BC065819.1~uORF:IOH61742	662	65	597
B42R18C17	42-17-18	Hs~MGC:BC070044.1~uORF:IOH61634	386	60	326
B42R18C18	42-18-18	Hs~MGC:BC070044.1~uORF:IOH61634	268	53	215
B42R18C19	42-19-18	Hs~MGC:BC028573.1~uORF:IOH62077	371	59	312
B42R18C20	42-20-18	Hs~MGC:BC028573.1~uORF:IOH62077	468	53	415
B42R18C21	42-21-18	Hs~Ref:NM_018339.3~uORF:IOH57057	584	45	539
B42R18C22	42-22-18	Hs~Ref:NM_018339.3~uORF:IOH57057	508	41	467
B42R19C01	42-1-19	Hs~Ref:NM_001005337.1~uORF:IOH61080	764	50	714
B42R19C02	42-2-19	Hs~Ref:NM_001005337.1~uORF:IOH61080	818	50	768
B42R19C03	42-3-19	Hs~MGC:BC034481.1~uORF:IOH62054	266	49	217
B42R19C04	42-4-19	Hs~MGC:BC034481.1~uORF:IOH62054	167	50	117
B42R19C05	42-5-19	Hs~MGC:BC047064.1~uORF:IOH61445	1977	53	1924
B42R19C06	42-6-19	Hs~MGC:BC047064.1~uORF:IOH61445	1837	59	1778
B42R19C07	42-7-19	Hs~MGC:BC066941.1~uORF:IOH61467	349	165	184
B42R19C08	42-8-19	Hs~MGC:BC066941.1~uORF:IOH61467	203	200	3
B42R19C09	42-9-19	Hs~MGC:BC005915.1~uORF:IOH62808	888	507	381
B42R19C10	42-10-19	Hs~MGC:BC005915.1~uORF:IOH62808	587	508	79
B42R19C11	42-11-19	Hs~MGC:BC048281.1~uORF:IOH26575	209	172	37
B42R19C12	42-12-19	Hs~MGC:BC048281.1~uORF:IOH26575	117	82	35
B42R19C13	42-13-19	Hs~Ref:NM_018111.1~uORF:IOH57283	230	49	181
B42R19C14	42-14-19	Hs~Ref:NM_018111.1~uORF:IOH57283	120	64	56
B42R19C15	42-15-19	Hs~Ref:NM_000366.5~uORF:IOH56864	2127	49	2078
B42R19C16	42-16-19	Hs~Ref:NM_000366.5~uORF:IOH56864	1893	49	1844
B42R19C17	42-17-19	Hs~Ref:NM_033198.2~uORF:IOH57312	91	44	47
B42R19C18	42-18-19	Hs~Ref:NM_033198.2~uORF:IOH57312	83	50	33
B42R19C19	42-19-19	Hs~Ref:NM_001001552.3~uORF:IOH58612	623	56	567
B42R19C20	42-20-19	Hs~Ref:NM_001001552.3~uORF:IOH58612	653	51	602
B42R19C21	42-21-19	Hs~Ref:NM_005697.3~uORF:IOH3933	322	49	273
B42R19C22	42-22-19	Hs~Ref:NM_005697.3~uORF:IOH3933	251	45	206
B42R20C01	42-1-20	Hs~Ref:NM_024033.1~uORF:IOH2894	404	48	356
B42R20C02	42-2-20	Hs~Ref:NM_024033.1~uORF:IOH2894	484	49	435
B42R20C03	42-3-20	Hs~Ref:NM_007008.1~uORF:IOH4069	453	51	402
B42R20C04	42-4-20	Hs~Ref:NM_007008.1~uORF:IOH4069	225	51	174
B42R20C05	42-5-20	Hs~Ref:NM_006324.1~uORF:IOH3019	844	60	784
B42R20C06	42-6-20	Hs~Ref:NM_006324.1~uORF:IOH3019	658	49	609
B42R20C07	42-7-20	Hs~Ref:NM_020175.1~uORF:IOH13452	896	70	826
B42R20C08	42-8-20	Hs~Ref:NM_020175.1~uORF:IOH13452	879	123	756
B42R20C09	42-9-20	Hs~Ref:NM_018645.3~uORF:IOH6723	950	514	436
B42R20C10	42-10-20	Hs~Ref:NM_018645.3~uORF:IOH6723	967	773	194
B42R20C11	42-11-20	Hs~Ref:NM_007277.3~uORF:IOH40459	709	104	605
B42R20C12	42-12-20	Hs~Ref:NM_007277.3~uORF:IOH40459	663	51	612
B42R20C13	42-13-20	Hs~Ref:NM_004164.2~uORF:IOH40388	48	45	3
B42R20C14	42-14-20	Hs~Ref:NM_004164.2~uORF:IOH40388	42	43	-1
B42R20C15	42-15-20	Hs~Ref:NM_001005414.1~uORF:IOH50078	695	40	655
B42R20C16	42-16-20	Hs~Ref:NM_001005414.1~uORF:IOH50078	773	43	730
B42R20C17	42-17-20	Hs~Ref:NM_181826.1~uORF:IOH50133	921	41	880
B42R20C18	42-18-20	Hs~Ref:NM_181826.1~uORF:IOH50133	849	47	802
B42R20C19	42-19-20	Hs~Ref:NM_198256.1~uORF:IOH50082	917	54	863
B42R20C20	42-20-20	Hs~Ref:NM_198256.1~uORF:IOH50082	848	48	800
B42R20C21	42-21-20	Hs~Ref:NM_183237.1~uORF:IOH50165	847	50	797
B42R20C22	42-22-20	Hs~Ref:NM_183237.1~uORF:IOH50165	834	43	791
B42R21C01	42-1-21	Hs~Ref:NM_207373.1~uORF:IOH50140	775	44	731
B42R21C02	42-2-21	Hs~Ref:NM_207373.1~uORF:IOH50140	785	44	741
B42R21C03	42-3-21	Hs~Ref:NM_033258.1~uORF:IOH50110	681	44	637
B42R21C04	42-4-21	Hs~Ref:NM_033258.1~uORF:IOH50110	675	45	630
B42R21C05	42-5-21	Hs~Ref:NM_153741.1~uORF:IOH50175	648	52	596
B42R21C06	42-6-21	Hs~Ref:NM_153741.1~uORF:IOH50175	557	57	500
B42R21C07	42-7-21	Hs~Ref:NM_001007250.1~uORF:IOH50092	397	132	265
B42R21C08	42-8-21	Hs~Ref:NM_001007250.1~uORF:IOH50092	124	58	66
B42R21C09	42-9-21	Hs~Ref:NP_002167.1~CAT_10704-H02H-25	65535	88	65447
B42R21C10	42-10-21	Hs~Ref:NP_002167.1~CAT_10704-H02H-25	65535	77	65458
B42R21C11	42-11-21	Internal_1007209	154	53	101
B42R21C12	42-12-21	Internal_1007209	171	52	119
B42R21C13	42-13-21	Hs~Ref:NP_001056.1~CAT_10872-H08H-25	122	43	79
B42R21C14	42-14-21	Hs~Ref:NP_001056.1~CAT_10872-H08H-25	114	41	73
B42R21C15	42-15-21	Internal_1007209	169	41	128
B42R21C16	42-16-21	Internal_1007209	354	45	309
B42R21C17	42-17-21	Hs~Ref:NP_003833.3~CAT_10465-H08H-25	102	39	63
B42R21C18	42-18-21	Hs~Ref:NP_003833.3~CAT_10465-H08H-25	57	43	14
B42R21C19	42-19-21	Internal_1007209	2048	46	2002
B42R21C20	42-20-21	Internal_1007209	2315	44	2271
B42R21C21	42-21-21	Internal_1007209	14066	46	14020
B42R21C22	42-22-21	Internal_1007209	15479	41	15438
B42R22C01	42-1-22	ERa~N/A	2651	49	2602
B42R22C02	42-2-22	ERa~N/A	2966	47	2919
B42R22C03	42-3-22	PKCeta~N/A	658	44	614
B42R22C04	42-4-22	PKCeta~N/A	679	44	635
B42R22C05	42-5-22	Calmodulin~N/A	706	49	657
B42R22C06	42-6-22	Calmodulin~N/A	753	54	699
B42R22C07	42-7-22	V5control5~N/A	1201	50	1151
B42R22C08	42-8-22	V5control5~N/A	1218	49	1169
B42R22C09	42-9-22	V5control4~N/A	335	127	208
B42R22C10	42-10-22	V5control4~N/A	335	63	272
B42R22C11	42-11-22	V5control3~N/A	264	49	215
B42R22C12	42-12-22	V5control3~N/A	199	46	153
B42R22C13	42-13-22	V5control2~N/A	242	74	168
B42R22C14	42-14-22	V5control2~N/A	199	84	115
B42R22C15	42-15-22	V5control1~N/A	290	44	246
B42R22C16	42-16-22	V5control1~N/A	279	47	232
B42R22C17	42-17-22	CMK2A~N/A	591	45	546
B42R22C18	42-18-22	CMK2A~N/A	566	50	516
B42R22C19	42-19-22	ERa~N/A	2328	39	2289
B42R22C20	42-20-22	ERa~N/A	2440	38	2402
B42R22C21	42-21-22	AlexaAntiMouseAb~N/A	9378	39	9339
B42R22C22	42-22-22	AlexaAntiMouseAb~N/A	8963	37	8926
B43R01C01	43-1-1	AlexaAntiMouseAb~N/A	36915	41	36874
B43R01C02	43-2-1	AlexaAntiMouseAb~N/A	38493	56	38437
B43R01C03	43-3-1	ERa~N/A	2121	67	2054
B43R01C04	43-4-1	ERa~N/A	2085	59	2026
B43R01C05	43-5-1	HumanIgG1~N/A	1125	67	1058
B43R01C06	43-6-1	HumanIgG1~N/A	1152	60	1092
B43R01C07	43-7-1	HumanIgG2~N/A	3288	59	3229
B43R01C08	43-8-1	HumanIgG2~N/A	2912	49	2863
B43R01C09	43-9-1	HumanIgG3~N/A	11980	43	11937
B43R01C10	43-10-1	HumanIgG3~N/A	11976	42	11934
B43R01C11	43-11-1	HumanIgG4~N/A	37488	44	37444
B43R01C12	43-12-1	HumanIgG4~N/A	37186	43	37143
B43R01C13	43-13-1	BiotinAb~N/A	361	43	318
B43R01C14	43-14-1	BiotinAb~N/A	267	160	107
B43R01C15	43-15-1	RanBP2deltaFG~N/A	3136	61	3075
B43R01C16	43-16-1	RanBP2deltaFG~N/A	3484	68	3416
B43R01C17	43-17-1	hMDM2~N/A	568	49	519
B43R01C18	43-18-1	hMDM2~N/A	410	48	362
B43R01C19	43-19-1	PKCeta~N/A	262	97	165
B43R01C20	43-20-1	PKCeta~N/A	230	45	185
B43R01C21	43-21-1	AlexaAntiMouseAb~N/A	31115	46	31069
B43R01C22	43-22-1	AlexaAntiMouseAb~N/A	34126	49	34077
B43R02C01	43-1-2	PKCeta~N/A	1101	42	1059
B43R02C02	43-2-2	PKCeta~N/A	1392	59	1333
B43R02C03	43-3-2	Buffer	481	98	383
B43R02C04	43-4-2	Buffer	331	53	278
B43R02C05	43-5-2	HumanIgA~N/A	22588	55	22533
B43R02C06	43-6-2	HumanIgA~N/A	21644	57	21587
B43R02C07	43-7-2	Buffer	108	53	55
B43R02C08	43-8-2	Buffer	76	50	26
B43R02C09	43-9-2	BSA~N/A	11727	51	11676
B43R02C10	43-10-2	BSA~N/A	11637	48	11589
B43R02C11	43-11-2	Hs~MGC:BC016922.2~uORF:IOH11182	171	43	128
B43R02C12	43-12-2	Hs~MGC:BC016922.2~uORF:IOH11182	127	45	82
B43R02C13	43-13-2	Hs~MGC:BC013988.1~uORF:IOH13255	352	60	292
B43R02C14	43-14-2	Hs~MGC:BC013988.1~uORF:IOH13255	61	57	4
B43R02C15	43-15-2	Hs~MGC:BC021969.2~uORF:IOH13337	3629	117	3512
B43R02C16	43-16-2	Hs~MGC:BC021969.2~uORF:IOH13337	755	337	418
B43R02C17	43-17-2	Hs~Ref:NM_139201.1~uORF:IOH3954	4576	140	4436
B43R02C18	43-18-2	Hs~Ref:NM_139201.1~uORF:IOH3954	529	173	356
B43R02C19	43-19-2	Hs~MGC:BC010395.1~uORF:IOH13836	48	54	-6
B43R02C20	43-20-2	Hs~MGC:BC010395.1~uORF:IOH13836	66	69	-3
B43R02C21	43-21-2	Hs~Ref:NM_012318.1~uORF:IOH13897	45	72	-27
B43R02C22	43-22-2	Hs~Ref:NM_012318.1~uORF:IOH13897	60	64	-4
B43R03C01	43-1-3	Hs~Ref:NM_001657.2~uORF:IOH13747	441	43	398
B43R03C02	43-2-3	Hs~Ref:NM_001657.2~uORF:IOH13747	292	57	235
B43R03C03	43-3-3	Hs~MGC:BC016745.2~uORF:IOH10673	485	68	417
B43R03C04	43-4-3	Hs~MGC:BC016745.2~uORF:IOH10673	290	56	234
B43R03C05	43-5-3	Hs~MGC:BC009680.1~uORF:IOH9934	617	211	406
B43R03C06	43-6-3	Hs~MGC:BC009680.1~uORF:IOH9934	257	60	197
B43R03C07	43-7-3	Hs~Ref:NM_003847.1~uORF:IOH9834	177	80	97
B43R03C08	43-8-3	Hs~Ref:NM_003847.1~uORF:IOH9834	49	58	-9
B43R03C09	43-9-3	Hs~MGC:BC013424.1~uORF:IOH9880	53	52	1
B43R03C10	43-10-3	Hs~MGC:BC013424.1~uORF:IOH9880	68	74	-6
B43R03C11	43-11-3	Hs~MGC:BC013567.1~uORF:IOH9922	1783	54	1729
B43R03C12	43-12-3	Hs~MGC:BC013567.1~uORF:IOH9922	383	59	324
B43R03C13	43-13-3	Hs~MGC:BC027478.1~uORF:IOH22847	1973	51	1922
B43R03C14	43-14-3	Hs~MGC:BC027478.1~uORF:IOH22847	129	55	74
B43R03C15	43-15-3	Hs~MGC:BC040924.1~uORF:IOH26332	267	140	127
B43R03C16	43-16-3	Hs~MGC:BC040924.1~uORF:IOH26332	4833	305	4528
B43R03C17	43-17-3	Hs~MGC:BC036391.1~uORF:IOH22062	4153	290	3863
B43R03C18	43-18-3	Hs~MGC:BC036391.1~uORF:IOH22062	2447	87	2360
B43R03C19	43-19-3	Hs~MGC:BC031101.1~uORF:IOH27268	3533	65	3468
B43R03C20	43-20-3	Hs~MGC:BC031101.1~uORF:IOH27268	248	58	190
B43R03C21	43-21-3	Hs~Ref:NM_016484.1~uORF:IOH12355	4143	192	3951
B43R03C22	43-22-3	Hs~Ref:NM_016484.1~uORF:IOH12355	118	137	-19
B43R04C01	43-1-4	Hs~MGC:BC009253.1~uORF:IOH13411	707	43	664
B43R04C02	43-2-4	Hs~MGC:BC009253.1~uORF:IOH13411	721	56	665
B43R04C03	43-3-4	Hs~Ref:NM_021809.2~uORF:IOH13079	1240	603	637
B43R04C04	43-4-4	Hs~Ref:NM_021809.2~uORF:IOH13079	860	68	792
B43R04C05	43-5-4	Hs~Ref:NM_014267.2~uORF:IOH7554	882	62	820
B43R04C06	43-6-4	Hs~Ref:NM_014267.2~uORF:IOH7554	779	68	711
B43R04C07	43-7-4	Hs~Ref:NM_001956.1~uORF:IOH22678	354	56	298
B43R04C08	43-8-4	Hs~Ref:NM_001956.1~uORF:IOH22678	293	53	240
B43R04C09	43-9-4	Hs~MGC:BC000175.2~uORF:IOH2926	289	52	237
B43R04C10	43-10-4	Hs~MGC:BC000175.2~uORF:IOH2926	47	78	-31
B43R04C11	43-11-4	Hs~Ref:NM_007262.1~uORF:IOH3149	143	65	78
B43R04C12	43-12-4	Hs~Ref:NM_007262.1~uORF:IOH3149	133	63	70
B43R04C13	43-13-4	Hs~Ref:NM_000398.3~uORF:IOH3023	730	51	679
B43R04C14	43-14-4	Hs~Ref:NM_000398.3~uORF:IOH3023	673	46	627
B43R04C15	43-15-4	Hs~MGC:BC042606.1~uORF:IOH26783	91	64	27
B43R04C16	43-16-4	Hs~MGC:BC042606.1~uORF:IOH26783	371	266	105
B43R04C17	43-17-4	Hs~MGC:BC009289.2~uORF:IOH12925	687	223	464
B43R04C18	43-18-4	Hs~MGC:BC009289.2~uORF:IOH12925	775	145	630
B43R04C19	43-19-4	Hs~Ref:NM_014437.2~uORF:IOH4006	134	51	83
B43R04C20	43-20-4	Hs~Ref:NM_014437.2~uORF:IOH4006	93	53	40
B43R04C21	43-21-4	Hs~MGC:BC026345.1~uORF:IOH10790	878	67	811
B43R04C22	43-22-4	Hs~MGC:BC026345.1~uORF:IOH10790	764	68	696
B43R05C01	43-1-5	Hs~Ref:NM_024613.2~uORF:IOH13017	472	146	326
B43R05C02	43-2-5	Hs~Ref:NM_024613.2~uORF:IOH13017	169	55	114
B43R05C03	43-3-5	Hs~Ref:NM_020548.4~uORF:IOH39853	411	63	348
B43R05C04	43-4-5	Hs~Ref:NM_020548.4~uORF:IOH39853	354	64	290
B43R05C05	43-5-5	Hs~MGC:BC017212.2~uORF:IOH13041	498	78	420
B43R05C06	43-6-5	Hs~MGC:BC017212.2~uORF:IOH13041	395	55	340
B43R05C07	43-7-5	Hs~Ref:NM_203405.1~uORF:IOH39798	132	50	82
B43R05C08	43-8-5	Hs~Ref:NM_203405.1~uORF:IOH39798	50	63	-13
B43R05C09	43-9-5	Hs~Ref:NM_016057.1~uORF:IOH5427	211	73	138
B43R05C10	43-10-5	Hs~Ref:NM_016057.1~uORF:IOH5427	46	66	-20
B43R05C11	43-11-5	Hs~MGC:NM_138730.1~uORF:IOH9857	2116	64	2052
B43R05C12	43-12-5	Hs~MGC:NM_138730.1~uORF:IOH9857	2058	56	2002
B43R05C13	43-13-5	Hs~Ref:NM_002035.1~uORF:IOH6216	692	45	647
B43R05C14	43-14-5	Hs~Ref:NM_002035.1~uORF:IOH6216	650	42	608
B43R05C15	43-15-5	Hs~Ref:NM_032933.1~uORF:IOH6290	790	46	744
B43R05C16	43-16-5	Hs~Ref:NM_032933.1~uORF:IOH6290	1028	89	939
B43R05C17	43-17-5	Hs~Ref:NM_005433.2~uORF:IOH26758	217	68	149
B43R05C18	43-18-5	Hs~Ref:NM_005433.2~uORF:IOH26758	188	69	119
B43R05C19	43-19-5	Hs~MGC:BC044585.1~uORF:IOH26894	122	49	73
B43R05C20	43-20-5	Hs~MGC:BC044585.1~uORF:IOH26894	90	49	41
B43R05C21	43-21-5	Hs~MGC:NM_178450.2~uORF:IOH26430	263	50	213
B43R05C22	43-22-5	Hs~MGC:NM_178450.2~uORF:IOH26430	199	52	147
B43R06C01	43-1-6	Hs~MGC:NM_182756.1~uORF:IOH26877	4348	47	4301
B43R06C02	43-2-6	Hs~MGC:NM_182756.1~uORF:IOH26877	4523	53	4470
B43R06C03	43-3-6	Hs~Ref:NM_020133.1~uORF:IOH12573	241	56	185
B43R06C04	43-4-6	Hs~Ref:NM_020133.1~uORF:IOH12573	181	55	126
B43R06C05	43-5-6	Hs~Ref:NM_138462.1~uORF:IOH10685	364	51	313
B43R06C06	43-6-6	Hs~Ref:NM_138462.1~uORF:IOH10685	319	52	267
B43R06C07	43-7-6	Hs~Ref:NM_001878.2~uORF:IOH1673	347	54	293
B43R06C08	43-8-6	Hs~Ref:NM_001878.2~uORF:IOH1673	60	71	-11
B43R06C09	43-9-6	Hs~Ref:NM_000975.2~uORF:IOH1740	53	91	-38
B43R06C10	43-10-6	Hs~Ref:NM_000975.2~uORF:IOH1740	58	82	-24
B43R06C11	43-11-6	Hs~MGC:BC064553.1~uORF:IOH39901	159	141	18
B43R06C12	43-12-6	Hs~MGC:BC064553.1~uORF:IOH39901	151	92	59
B43R06C13	43-13-6	Hs~Ref:NM_172037.2~uORF:IOH39980	179	89	90
B43R06C14	43-14-6	Hs~Ref:NM_172037.2~uORF:IOH39980	138	46	92
B43R06C15	43-15-6	Hs~MGC:BC066354.1~uORF:IOH40076	67	58	9
B43R06C16	43-16-6	Hs~MGC:BC066354.1~uORF:IOH40076	94	66	28
B43R06C17	43-17-6	Hs~MGC:BC064593.1~uORF:IOH39933	316	57	259
B43R06C18	43-18-6	Hs~MGC:BC064593.1~uORF:IOH39933	273	60	213
B43R06C19	43-19-6	Hs~MGC:BC042036.1~uORF:IOH26443	232	60	172
B43R06C20	43-20-6	Hs~MGC:BC042036.1~uORF:IOH26443	205	56	149
B43R06C21	43-21-6	Hs~MGC:BC023514.2~uORF:IOH27789	236	59	177
B43R06C22	43-22-6	Hs~MGC:BC023514.2~uORF:IOH27789	748	58	690
B43R07C01	43-1-7	Hs~MGC:BC014501.1~uORF:IOH27915	121	57	64
B43R07C02	43-2-7	Hs~MGC:BC014501.1~uORF:IOH27915	61	75	-14
B43R07C03	43-3-7	Hs~Ref:NM_022063.1~uORF:IOH27864	821	347	474
B43R07C04	43-4-7	Hs~Ref:NM_022063.1~uORF:IOH27864	387	54	333
B43R07C05	43-5-7	Hs~MGC:BC017299.1~uORF:IOH14780	120	69	51
B43R07C06	43-6-7	Hs~MGC:BC017299.1~uORF:IOH14780	130	57	73
B43R07C07	43-7-7	Hs~Ref:NM_005643.2~uORF:IOH13738	166	56	110
B43R07C08	43-8-7	Hs~Ref:NM_005643.2~uORF:IOH13738	199	59	140
B43R07C09	43-9-7	Hs~MGC:BC016790.1~uORF:IOH27885	447	56	391
B43R07C10	43-10-7	Hs~MGC:BC016790.1~uORF:IOH27885	428	60	368
B43R07C11	43-11-7	Hs~MGC:BC049215.1~uORF:IOH26613	356	69	287
B43R07C12	43-12-7	Hs~MGC:BC049215.1~uORF:IOH26613	370	48	322
B43R07C13	43-13-7	Hs~Ref:NM_177405.1~uORF:IOH40959	647	47	600
B43R07C14	43-14-7	Hs~Ref:NM_177405.1~uORF:IOH40959	265	50	215
B43R07C15	43-15-7	Hs~Ref:XM_372239.3~uORF:IOH44466	50	74	-24
B43R07C16	43-16-7	Hs~Ref:XM_372239.3~uORF:IOH44466	379	151	228
B43R07C17	43-17-7	Hs~Ref:NM_176783.1~uORF:IOH40962	662	165	497
B43R07C18	43-18-7	Hs~Ref:NM_176783.1~uORF:IOH40962	620	114	506
B43R07C19	43-19-7	Hs~Ref:NM_004449.3~uORF:IOH41014	2281	54	2227
B43R07C20	43-20-7	Hs~Ref:NM_004449.3~uORF:IOH41014	2390	49	2341
B43R07C21	43-21-7	Hs~Ref:NM_052844.1~uORF:IOH13517	596	73	523
B43R07C22	43-22-7	Hs~Ref:NM_052844.1~uORF:IOH13517	538	47	491
B43R08C01	43-1-8	Hs~MGC:BC010176.1~uORF:IOH14168	162	51	111
B43R08C02	43-2-8	Hs~MGC:BC010176.1~uORF:IOH14168	159	55	104
B43R08C03	43-3-8	Hs~MGC:BC014001.1~uORF:IOH13543	367	60	307
B43R08C04	43-4-8	Hs~MGC:BC014001.1~uORF:IOH13543	351	61	290
B43R08C05	43-5-8	Hs~MGC:BC011885.1~uORF:IOH14206	1912	56	1856
B43R08C06	43-6-8	Hs~MGC:BC011885.1~uORF:IOH14206	2041	54	1987
B43R08C07	43-7-8	Hs~Ref:NM_004251.2~uORF:IOH14673	83	73	10
B43R08C08	43-8-8	Hs~Ref:NM_004251.2~uORF:IOH14673	233	60	173
B43R08C09	43-9-8	Hs~MGC:BC005153.1~uORF:IOH5158	705	56	649
B43R08C10	43-10-8	Hs~MGC:BC005153.1~uORF:IOH5158	704	52	652
B43R08C11	43-11-8	Hs~MGC:BC016964.1~uORF:IOH10344	413	45	368
B43R08C12	43-12-8	Hs~MGC:BC016964.1~uORF:IOH10344	409	41	368
B43R08C13	43-13-8	Hs~MGC:BC009877.1~uORF:IOH12614	540	40	500
B43R08C14	43-14-8	Hs~MGC:BC009877.1~uORF:IOH12614	557	40	517
B43R08C15	43-15-8	Hs~MGC:BC001494.1~uORF:IOH14556	731	42	689
B43R08C16	43-16-8	Hs~MGC:BC001494.1~uORF:IOH14556	699	41	658
B43R08C17	43-17-8	Hs~Ref:NM_013385.2~uORF:IOH26246	652	45	607
B43R08C18	43-18-8	Hs~Ref:NM_013385.2~uORF:IOH26246	591	48	543
B43R08C19	43-19-8	Hs~MGC:BC015557.2~uORF:IOH14423	240	49	191
B43R08C20	43-20-8	Hs~MGC:BC015557.2~uORF:IOH14423	213	45	168
B43R08C21	43-21-8	Hs~Ref:NM_000107.1~uORF:IOH4740	481	53	428
B43R08C22	43-22-8	Hs~Ref:NM_000107.1~uORF:IOH4740	473	184	289
B43R09C01	43-1-9	Hs~Ref:NM_138279.1~uORF:IOH35268	93	53	40
B43R09C02	43-2-9	Hs~Ref:NM_138279.1~uORF:IOH35268	668	52	616
B43R09C03	43-3-9	Hs~Ref:NM_006153.3~uORF:IOH6521	637	59	578
B43R09C04	43-4-9	Hs~Ref:NM_006153.3~uORF:IOH6521	650	62	588
B43R09C05	43-5-9	Hs~Ref:NM_175908.3~uORF:IOH35325	252	80	172
B43R09C06	43-6-9	Hs~Ref:NM_175908.3~uORF:IOH35325	155	117	38
B43R09C07	43-7-9	Hs~Ref:NM_021002.1~uORF:IOH35232	87	57	30
B43R09C08	43-8-9	Hs~Ref:NM_021002.1~uORF:IOH35232	436	42	394
B43R09C09	43-9-9	Hs~Ref:NM_145269.1~uORF:IOH10713	442	47	395
B43R09C10	43-10-9	Hs~Ref:NM_145269.1~uORF:IOH10713	396	46	350
B43R09C11	43-11-9	Hs~MGC:NM_015464.1~uORF:IOH7434	274	50	224
B43R09C12	43-12-9	Hs~MGC:NM_015464.1~uORF:IOH7434	307	42	265
B43R09C13	43-13-9	Hs~MGC:BC014323.1~uORF:IOH13941	148	46	102
B43R09C14	43-14-9	Hs~MGC:BC014323.1~uORF:IOH13941	230	69	161
B43R09C15	43-15-9	Hs~Ref:NM_138289.1~uORF:IOH10781	598	42	556
B43R09C16	43-16-9	Hs~Ref:NM_138289.1~uORF:IOH10781	583	41	542
B43R09C17	43-17-9	Hs~MGC:BC008051.2~uORF:IOH7014	263	48	215
B43R09C18	43-18-9	Hs~MGC:BC008051.2~uORF:IOH7014	253	169	84
B43R09C19	43-19-9	Hs~Ref:NM_006166.2~uORF:IOH7129	442	55	387
B43R09C20	43-20-9	Hs~Ref:NM_006166.2~uORF:IOH7129	358	57	301
B43R09C21	43-21-9	Hs~Ref:NM_014234.3~uORF:IOH3322	735	63	672
B43R09C22	43-22-9	Hs~Ref:NM_014234.3~uORF:IOH3322	353	45	308
B43R10C01	43-1-10	Hs~MGC:BC002793.1~uORF:IOH5316	83	58	25
B43R10C02	43-2-10	Hs~MGC:BC002793.1~uORF:IOH5316	127	55	72
B43R10C03	43-3-10	Hs~Ref:NM_058192.2~uORF:IOH12988	517	52	465
B43R10C04	43-4-10	Hs~Ref:NM_058192.2~uORF:IOH12988	489	50	439
B43R10C05	43-5-10	Hs~Ref:NM_031989.2~uORF:IOH4487	367	47	320
B43R10C06	43-6-10	Hs~Ref:NM_031989.2~uORF:IOH4487	379	48	331
B43R10C07	43-7-10	Hs~Ref:NM_017907.1~uORF:IOH4941	664	43	621
B43R10C08	43-8-10	Hs~Ref:NM_017907.1~uORF:IOH4941	574	44	530
B43R10C09	43-9-10	Hs~Ref:NM_014747.2~uORF:IOH4568	788	42	746
B43R10C10	43-10-10	Hs~Ref:NM_014747.2~uORF:IOH4568	695	40	655
B43R10C11	43-11-10	GST1	39	39	0
B43R10C12	43-12-10	GST1	41	39	2
B43R10C13	43-13-10	GST2	40	39	1
B43R10C14	43-14-10	GST2	40	39	1
B43R10C15	43-15-10	GST3	42	40	2
B43R10C16	43-16-10	GST3	44	41	3
B43R10C17	43-17-10	GST4	207	46	161
B43R10C18	43-18-10	GST4	43	42	1
B43R10C19	43-19-10	Anti-HumanIgA1~N/A	7200	45	7155
B43R10C20	43-20-10	Anti-HumanIgA1~N/A	7303	52	7251
B43R10C21	43-21-10	Anti-HumanIgA2~N/A	13015	52	12963
B43R10C22	43-22-10	Anti-HumanIgA2~N/A	13040	43	12997
B43R11C01	43-1-11	AlexaAntiMouseAb~N/A	24971	56	24915
B43R11C02	43-2-11	AlexaAntiMouseAb~N/A	23183	53	23130
B43R11C03	43-3-11	MAPKAP~N/A	55	62	-7
B43R11C04	43-4-11	MAPKAP~N/A	84	43	41
B43R11C05	43-5-11	Buffer	63	39	24
B43R11C06	43-6-11	Buffer	58	39	19
B43R11C07	43-7-11	BSA~N/A	7912	41	7871
B43R11C08	43-8-11	BSA~N/A	8070	41	8029
B43R11C09	43-9-11	Anti-HumanIgG1~N/A	1470	41	1429
B43R11C10	43-10-11	Anti-HumanIgG1~N/A	1797	56	1741
B43R11C11	43-11-11	Anti-HumanIgG2~N/A	2494	43	2451
B43R11C12	43-12-11	Anti-HumanIgG2~N/A	2558	40	2518
B43R11C13	43-13-11	Anti-HumanIgG3~N/A	4739	40	4699
B43R11C14	43-14-11	Anti-HumanIgG3~N/A	4758	41	4717
B43R11C15	43-15-11	Anti-HumanIgG4~N/A	9661	42	9619
B43R11C16	43-16-11	Anti-HumanIgG4~N/A	9292	43	9249
B43R11C17	43-17-11	AntiBiotinAb~N/A	9799	41	9758
B43R11C18	43-18-11	AntiBiotinAb~N/A	9884	40	9844
B43R11C19	43-19-11	Buffer	49	42	7
B43R11C20	43-20-11	Buffer	55	49	6
B43R11C21	43-21-11	Hs~MGC:BC010061.2~uORF:IOH12254	586	51	535
B43R11C22	43-22-11	Hs~MGC:BC010061.2~uORF:IOH12254	583	44	539
B43R12C01	43-1-12	Hs~MGC:BC030833.1~uORF:IOH22239	437	70	367
B43R12C02	43-2-12	Hs~MGC:BC030833.1~uORF:IOH22239	265	81	184
B43R12C03	43-3-12	Hs~MGC:BC029886.1~uORF:IOH22823	758	48	710
B43R12C04	43-4-12	Hs~MGC:BC029886.1~uORF:IOH22823	779	42	737
B43R12C05	43-5-12	Hs~Ref:NM_006419.1~uORF:IOH14282	530	39	491
B43R12C06	43-6-12	Hs~Ref:NM_006419.1~uORF:IOH14282	536	40	496
B43R12C07	43-7-12	Hs~Ref:NM_002488.2~uORF:IOH7216	71	55	16
B43R12C08	43-8-12	Hs~Ref:NM_002488.2~uORF:IOH7216	482	47	435
B43R12C09	43-9-12	Hs~MGC:BC005272.1~uORF:IOH57048	38	47	-9
B43R12C10	43-10-12	Hs~MGC:BC005272.1~uORF:IOH57048	98	92	6
B43R12C11	43-11-12	Hs~Ref:NM_018955.2~uORF:IOH56688	265	56	209
B43R12C12	43-12-12	Hs~Ref:NM_018955.2~uORF:IOH56688	326	51	275
B43R12C13	43-13-12	Hs~Ref:NM_014616.1~uORF:IOH55818	307	57	250
B43R12C14	43-14-12	Hs~Ref:NM_014616.1~uORF:IOH55818	80	53	27
B43R12C15	43-15-12	Hs~Ref:NM_021198.1~uORF:IOH12189	514	46	468
B43R12C16	43-16-12	Hs~Ref:NM_021198.1~uORF:IOH12189	488	46	442
B43R12C17	43-17-12	Hs~MGC:BC027178.1~uORF:IOH10797	539	41	498
B43R12C18	43-18-12	Hs~MGC:BC027178.1~uORF:IOH10797	552	40	512
B43R12C19	43-19-12	Hs~Ref:NM_006573.2~uORF:IOH12947	682	43	639
B43R12C20	43-20-12	Hs~Ref:NM_006573.2~uORF:IOH12947	143	47	96
B43R12C21	43-21-12	Hs~Ref:NM_004264.2~uORF:IOH7394	77	47	30
B43R12C22	43-22-12	Hs~Ref:NM_004264.2~uORF:IOH7394	51	48	3
B43R13C01	43-1-13	Hs~Ref:NM_016619.1~uORF:IOH10473	363	43	320
B43R13C02	43-2-13	Hs~Ref:NM_016619.1~uORF:IOH10473	295	47	248
B43R13C03	43-3-13	Hs~Ref:NM_152786.1~uORF:IOH11171	743	177	566
B43R13C04	43-4-13	Hs~Ref:NM_152786.1~uORF:IOH11171	583	47	536
B43R13C05	43-5-13	Hs~Ref:NM_006628.4~uORF:IOH3044	833	41	792
B43R13C06	43-6-13	Hs~Ref:NM_006628.4~uORF:IOH3044	752	42	710
B43R13C07	43-7-13	Hs~MGC:BC016389.1~uORF:IOH10478	43	56	-13
B43R13C08	43-8-13	Hs~MGC:BC016389.1~uORF:IOH10478	708	54	654
B43R13C09	43-9-13	Hs~Ref:NM_144606.1~uORF:IOH12359	54817	51	54766
B43R13C10	43-10-13	Hs~Ref:NM_144606.1~uORF:IOH12359	53400	61	53339
B43R13C11	43-11-13	Hs~MGC:BC024300.1~uORF:IOH12700	258	63	195
B43R13C12	43-12-13	Hs~MGC:BC024300.1~uORF:IOH12700	259	50	209
B43R13C13	43-13-13	Hs~MGC:BC017799.1~uORF:IOH14286	1340	58	1282
B43R13C14	43-14-13	Hs~MGC:BC017799.1~uORF:IOH14286	1317	56	1261
B43R13C15	43-15-13	Hs~Ref:NM_001668.2~uORF:IOH36815	1893	50	1843
B43R13C16	43-16-13	Hs~Ref:NM_001668.2~uORF:IOH36815	1781	46	1735
B43R13C17	43-17-13	Hs~Ref:NM_052872.3~uORF:IOH35145	330	44	286
B43R13C18	43-18-13	Hs~Ref:NM_052872.3~uORF:IOH35145	87	50	37
B43R13C19	43-19-13	Hs~Ref:NM_006395.1~uORF:IOH52654	53	47	6
B43R13C20	43-20-13	Hs~Ref:NM_006395.1~uORF:IOH52654	60	56	4
B43R13C21	43-21-13	Hs~MGC:BC035978.1~uORF:IOH59049	53	61	-8
B43R13C22	43-22-13	Hs~MGC:BC035978.1~uORF:IOH59049	68	54	14
B43R14C01	43-1-14	Hs~Ref:NM_003846.1~uORF:IOH54873	307	42	265
B43R14C02	43-2-14	Hs~Ref:NM_003846.1~uORF:IOH54873	486	42	444
B43R14C03	43-3-14	Hs~Ref:NM_194290.1~uORF:IOH42276	2514	47	2467
B43R14C04	43-4-14	Hs~Ref:NM_194290.1~uORF:IOH42276	2599	43	2556
B43R14C05	43-5-14	Hs~Ref:NM_001013644.1~uORF:IOH42793	350	39	311
B43R14C06	43-6-14	Hs~Ref:NM_001013644.1~uORF:IOH42793	400	46	354
B43R14C07	43-7-14	Hs~Ref:NM_020152.2~uORF:IOH42211	62	49	13
B43R14C08	43-8-14	Hs~Ref:NM_020152.2~uORF:IOH42211	211	43	168
B43R14C09	43-9-14	Hs~Ref:NM_181481.2~uORF:IOH42514	170	41	129
B43R14C10	43-10-14	Hs~Ref:NM_181481.2~uORF:IOH42514	188	41	147
B43R14C11	43-11-14	Hs~MGC:BC019069.1~uORF:IOH14121	2144	53	2091
B43R14C12	43-12-14	Hs~MGC:BC019069.1~uORF:IOH14121	1993	49	1944
B43R14C13	43-13-14	Hs~Ref:NM_016006.1~uORF:IOH10127	247	48	199
B43R14C14	43-14-14	Hs~Ref:NM_016006.1~uORF:IOH10127	234	49	185
B43R14C15	43-15-14	Hs~MGC:NM_173517.2~uORF:IOH14095	265	41	224
B43R14C16	43-16-14	Hs~MGC:NM_173517.2~uORF:IOH14095	287	40	247
B43R14C17	43-17-14	Hs~MGC:BC020622.1~uORF:IOH12066	796	40	756
B43R14C18	43-18-14	Hs~MGC:BC020622.1~uORF:IOH12066	839	41	798
B43R14C19	43-19-14	Hs~Ref:NM_006454.2~uORF:IOH45932	909	43	866
B43R14C20	43-20-14	Hs~Ref:NM_006454.2~uORF:IOH45932	1155	181	974
B43R14C21	43-21-14	Hs~Ref:NM_023112.2~uORF:IOH45933	413	50	363
B43R14C22	43-22-14	Hs~Ref:NM_023112.2~uORF:IOH45933	410	51	359
B43R15C01	43-1-15	Hs~Ref:NM_014955.2~uORF:IOH45543	516	37	479
B43R15C02	43-2-15	Hs~Ref:NM_014955.2~uORF:IOH45543	499	38	461
B43R15C03	43-3-15	Hs~Ref:NM_018189.2~uORF:IOH45471	1014	38	976
B43R15C04	43-4-15	Hs~Ref:NM_018189.2~uORF:IOH45471	938	38	900
B43R15C05	43-5-15	Hs~MGC:BC044575.1~uORF:IOH26889	406	38	368
B43R15C06	43-6-15	Hs~MGC:BC044575.1~uORF:IOH26889	130	42	88
B43R15C07	43-7-15	Hs~MGC:BC061699.1~uORF:IOH29429	208	43	165
B43R15C08	43-8-15	Hs~MGC:BC061699.1~uORF:IOH29429	195	45	150
B43R15C09	43-9-15	Hs~MGC:BC041615.1~uORF:IOH28053	38	46	-8
B43R15C10	43-10-15	Hs~MGC:BC041615.1~uORF:IOH28053	34	51	-17
B43R15C11	43-11-15	Hs~MGC:BC056409.1~uORF:IOH29119	41	51	-10
B43R15C12	43-12-15	Hs~MGC:BC056409.1~uORF:IOH29119	231	59	172
B43R15C13	43-13-15	Hs~IVGN:PM_2131~Ext:CCP_1BSA~N/A	13814	50	13764
B43R15C14	43-14-15	Hs~IVGN:PM_2131~Ext:CCP_1BSA~N/A	14869	46	14823
B43R15C15	43-15-15	Hs~Ref:NM_004783.1~CAT:PV3760	67	39	28
B43R15C16	43-16-15	Hs~Ref:NM_004783.1~CAT:PV3760	74	38	36
B43R15C17	43-17-15	Hs~Ref:NM_015148.1~CAT:PV3972	81	38	43
B43R15C18	43-18-15	Hs~Ref:NM_015148.1~CAT:PV3972	81	38	43
B43R15C19	43-19-15	Hs~MGC:NM_012224.1~CAT:PV4202	1106	42	1064
B43R15C20	43-20-15	Hs~MGC:NM_012224.1~CAT:PV4202	2103	41	2062
B43R15C21	43-21-15	Hs~Ref:NM_000215.1~CAT:PV3855	65	41	24
B43R15C22	43-22-15	Hs~Ref:NM_000215.1~CAT:PV3855	91	43	48
B43R16C01	43-1-16	Hs~Ref:NM_006255.1~CAT:P2634	406	36	370
B43R16C02	43-2-16	Hs~Ref:NM_006255.1~CAT:P2634	399	39	360
B43R16C03	43-3-16	Hs~Ref:NM_006218.2~CAT:PV4788	103	53	50
B43R16C04	43-4-16	Hs~Ref:NM_006218.2~CAT:PV4788	84	38	46
B43R16C05	43-5-16	Hs~Ref:NM_006035.2~CAT:PV4399	63	36	27
B43R16C06	43-6-16	Hs~Ref:NM_006035.2~CAT:PV4399	43	43	0
B43R16C07	43-7-16	Hs~Ref:NM_021914.3~uORF:IOH14198	1376	55	1321
B43R16C08	43-8-16	Hs~Ref:NM_021914.3~uORF:IOH14198	1069	69	1000
B43R16C09	43-9-16	Hs~MGC:BC012289.1~uORF:IOH11447	784	53	731
B43R16C10	43-10-16	Hs~MGC:BC012289.1~uORF:IOH11447	639	43	596
B43R16C11	43-11-16	Hs~MGC:BC052803.1~uORF:IOH29397	826	46	780
B43R16C12	43-12-16	Hs~MGC:BC052803.1~uORF:IOH29397	805	48	757
B43R16C13	43-13-16	Hs~MGC:BC058926.1~uORF:IOH29101	580	45	535
B43R16C14	43-14-16	Hs~MGC:BC058926.1~uORF:IOH29101	524	44	480
B43R16C15	43-15-16	Hs~Ref:NM_031919.1~uORF:IOH42936	491	40	451
B43R16C16	43-16-16	Hs~Ref:NM_031919.1~uORF:IOH42936	487	40	447
B43R16C17	43-17-16	Hs~Ref:NM_001012425.1~uORF:IOH44762	377	40	337
B43R16C18	43-18-16	Hs~Ref:NM_001012425.1~uORF:IOH44762	417	41	376
B43R16C19	43-19-16	Hs~Ref:NM_003769.2~uORF:IOH41184	894	42	852
B43R16C20	43-20-16	Hs~Ref:NM_003769.2~uORF:IOH41184	1095	44	1051
B43R16C21	43-21-16	Hs~Ref:NM_018173.1~uORF:IOH43927	620	146	474
B43R16C22	43-22-16	Hs~Ref:NM_018173.1~uORF:IOH43927	464	49	415
B43R17C01	43-1-17	Hs~Ref:NM_014741.2~uORF:IOH3624	471	37	434
B43R17C02	43-2-17	Hs~Ref:NM_014741.2~uORF:IOH3624	492	40	452
B43R17C03	43-3-17	Hs~Ref:NM_018348.4~uORF:IOH27159	328	40	288
B43R17C04	43-4-17	Hs~Ref:NM_018348.4~uORF:IOH27159	325	40	285
B43R17C05	43-5-17	Hs~MGC:BC036062.1~uORF:IOH27284	284	45	239
B43R17C06	43-6-17	Hs~MGC:BC036062.1~uORF:IOH27284	135	40	95
B43R17C07	43-7-17	Hs~MGC:BC050424.1~uORF:IOH26735	1313	71	1242
B43R17C08	43-8-17	Hs~MGC:BC050424.1~uORF:IOH26735	218	130	88
B43R17C09	43-9-17	Hs~MGC:BC016879.1~uORF:IOH10754	977	106	871
B43R17C10	43-10-17	Hs~MGC:BC016879.1~uORF:IOH10754	700	58	642
B43R17C11	43-11-17	Hs~MGC:BC036492.2~uORF:IOH22068	1998	56	1942
B43R17C12	43-12-17	Hs~MGC:BC036492.2~uORF:IOH22068	709	92	617
B43R17C13	43-13-17	Hs~Ref:NM_003092.3~uORF:IOH21977	1387	49	1338
B43R17C14	43-14-17	Hs~Ref:NM_003092.3~uORF:IOH21977	1368	43	1325
B43R17C15	43-15-17	Hs~Ref:NM_016388.2~uORF:IOH22617	638	41	597
B43R17C16	43-16-17	Hs~Ref:NM_016388.2~uORF:IOH22617	630	41	589
B43R17C17	43-17-17	Hs~Ref:NM_079834.1~uORF:IOH9634	269	44	225
B43R17C18	43-18-17	Hs~Ref:NM_079834.1~uORF:IOH9634	289	58	231
B43R17C19	43-19-17	Hs~MGC:BC007920.1~uORF:IOH6782	333	54	279
B43R17C20	43-20-17	Hs~MGC:BC007920.1~uORF:IOH6782	63	45	18
B43R17C21	43-21-17	Hs~Ref:NM_004357.2~uORF:IOH3965	261	60	201
B43R17C22	43-22-17	Hs~Ref:NM_004357.2~uORF:IOH3965	296	50	246
B43R18C01	43-1-18	Hs~Ref:NM_024058.1~uORF:IOH3251	180	43	137
B43R18C02	43-2-18	Hs~Ref:NM_024058.1~uORF:IOH3251	210	83	127
B43R18C03	43-3-18	Hs~MGC:BC013879.1~N/A	596	43	553
B43R18C04	43-4-18	Hs~MGC:BC013879.1~N/A	583	42	541
B43R18C05	43-5-18	Hs~MGC:BC020972.1~N/A	3332	42	3290
B43R18C06	43-6-18	Hs~MGC:BC020972.1~N/A	3061	43	3018
B43R18C07	43-7-18	Hs~Ref:NM_014791.1~N/A	2001	129	1872
B43R18C08	43-8-18	Hs~Ref:NM_014791.1~N/A	363	112	251
B43R18C09	43-9-18	Hs~Ref:NM_024776.1~N/A	403	89	314
B43R18C10	43-10-18	Hs~Ref:NM_024776.1~N/A	332	58	274
B43R18C11	43-11-18	Hs~MGC:BC032822.2~uORF:IOH26849	557	61	496
B43R18C12	43-12-18	Hs~MGC:BC032822.2~uORF:IOH26849	582	55	527
B43R18C13	43-13-18	Hs~MGC:NM_020783.2~uORF:IOH22458	355	51	304
B43R18C14	43-14-18	Hs~MGC:NM_020783.2~uORF:IOH22458	294	44	250
B43R18C15	43-15-18	Hs~Ref:NM_014004.2~uORF:IOH36179	253	44	209
B43R18C16	43-16-18	Hs~Ref:NM_014004.2~uORF:IOH36179	152	53	99
B43R18C17	43-17-18	Hs~MGC:BC062564.1~uORF:IOH39851	546	44	502
B43R18C18	43-18-18	Hs~MGC:BC062564.1~uORF:IOH39851	567	44	523
B43R18C19	43-19-18	Hs~MGC:BC098393.1~uORF:IOH62683	267	96	171
B43R18C20	43-20-18	Hs~MGC:BC098393.1~uORF:IOH62683	377	50	327
B43R18C21	43-21-18	Hs~Ref:NM_144610.1~uORF:IOH60533	159	45	114
B43R18C22	43-22-18	Hs~Ref:NM_144610.1~uORF:IOH60533	326	61	265
B43R19C01	43-1-19	Hs~MGC:BC098401.1~uORF:IOH62680	647	40	607
B43R19C02	43-2-19	Hs~MGC:BC098401.1~uORF:IOH62680	534	43	491
B43R19C03	43-3-19	Hs~MGC:BC090938.1~uORF:IOH62696	46547	43	46504
B43R19C04	43-4-19	Hs~MGC:BC090938.1~uORF:IOH62696	45824	41	45783
B43R19C05	43-5-19	Hs~MGC:BC028682.2~uORF:IOH22322	546	39	507
B43R19C06	43-6-19	Hs~MGC:BC028682.2~uORF:IOH22322	599	40	559
B43R19C07	43-7-19	Hs~Ref:NM_018335.2~uORF:IOH45711	249	45	204
B43R19C08	43-8-19	Hs~Ref:NM_018335.2~uORF:IOH45711	224	47	177
B43R19C09	43-9-19	Hs~Ref:NM_152509.1~uORF:IOH44542	1257	52	1205
B43R19C10	43-10-19	Hs~Ref:NM_152509.1~uORF:IOH44542	871	210	661
B43R19C11	43-11-19	Hs~Ref:NM_001018061.1~uORF:IOH57329	1236	61	1175
B43R19C12	43-12-19	Hs~Ref:NM_001018061.1~uORF:IOH57329	1249	47	1202
B43R19C13	43-13-19	Hs~Ref:NM_181515.1~uORF:IOH45751	523	47	476
B43R19C14	43-14-19	Hs~Ref:NM_181515.1~uORF:IOH45751	912	318	594
B43R19C15	43-15-19	Hs~Ref:NM_001002244.1~uORF:IOH45898	708	89	619
B43R19C16	43-16-19	Hs~Ref:NM_001002244.1~uORF:IOH45898	624	49	575
B43R19C17	43-17-19	Hs~Ref:NM_018485.1~uORF:IOH39439	545	47	498
B43R19C18	43-18-19	Hs~Ref:NM_018485.1~uORF:IOH39439	518	46	472
B43R19C19	43-19-19	Hs~Ref:XM_370664.2~uORF:IOH44703	494	45	449
B43R19C20	43-20-19	Hs~Ref:XM_370664.2~uORF:IOH44703	464	44	420
B43R19C21	43-21-19	Hs~Ref:NM_181608.1~uORF:IOH34903	293	51	242
B43R19C22	43-22-19	Hs~Ref:NM_181608.1~uORF:IOH34903	237	63	174
B43R20C01	43-1-20	Hs~Ref:NM_153750.1~uORF:IOH43458	289	42	247
B43R20C02	43-2-20	Hs~Ref:NM_153750.1~uORF:IOH43458	281	47	234
B43R20C03	43-3-20	Hs~Ref:NM_006763.2~uORF:IOH41569	132	42	90
B43R20C04	43-4-20	Hs~Ref:NM_006763.2~uORF:IOH41569	95	41	54
B43R20C05	43-5-20	Hs~Ref:NM_133491.2~uORF:IOH12374	380	40	340
B43R20C06	43-6-20	Hs~Ref:NM_133491.2~uORF:IOH12374	386	42	344
B43R20C07	43-7-20	Hs~MGC:BC005155.1~uORF:IOH5175	123	43	80
B43R20C08	43-8-20	Hs~MGC:BC005155.1~uORF:IOH5175	133	42	91
B43R20C09	43-9-20	Hs~MGC:BC017048.1~uORF:IOH10387	168	41	127
B43R20C10	43-10-20	Hs~MGC:BC017048.1~uORF:IOH10387	135	43	92
B43R20C11	43-11-20	Hs~Ref:NM_004530.1~uORF:IOH4128	234	42	192
B43R20C12	43-12-20	Hs~Ref:NM_004530.1~uORF:IOH4128	95	63	32
B43R20C13	43-13-20	Hs~Ref:NM_002903.1~uORF:IOH4436	464	46	418
B43R20C14	43-14-20	Hs~Ref:NM_002903.1~uORF:IOH4436	526	78	448
B43R20C15	43-15-20	Hs~Ref:NM_006762.1~uORF:IOH41540	205	93	112
B43R20C16	43-16-20	Hs~Ref:NM_006762.1~uORF:IOH41540	144	46	98
B43R20C17	43-17-20	Hs~Ref:NM_001310.2~uORF:IOH41451	626	81	545
B43R20C18	43-18-20	Hs~Ref:NM_001310.2~uORF:IOH41451	502	48	454
B43R20C19	43-19-20	Hs~Ref:NM_002405.2~uORF:IOH41649	308	99	209
B43R20C20	43-20-20	Hs~Ref:NM_002405.2~uORF:IOH41649	294	45	249
B43R20C21	43-21-20	Hs~Ref:NM_001017922.1~uORF:IOH41663	254	45	209
B43R20C22	43-22-20	Hs~Ref:NM_001017922.1~uORF:IOH41663	267	47	220
B43R21C01	43-1-21	Hs~Ref:NM_181894.1~uORF:IOH43140	158	43	115
B43R21C02	43-2-21	Hs~Ref:NM_181894.1~uORF:IOH43140	81	42	39
B43R21C03	43-3-21	Hs~Ref:NM_152449.2~uORF:IOH43379	227	56	171
B43R21C04	43-4-21	Hs~Ref:NM_152449.2~uORF:IOH43379	177	67	110
B43R21C05	43-5-21	Hs~Ref:XM_378687.2~uORF:IOH43359	111	40	71
B43R21C06	43-6-21	Hs~Ref:XM_378687.2~uORF:IOH43359	165	48	117
B43R21C07	43-7-21	Hs~Ref:BC121084.1~uORF:IOH43231	52	42	10
B43R21C08	43-8-21	Hs~Ref:BC121084.1~uORF:IOH43231	127	48	79
B43R21C09	43-9-21	Hs~Ref:NP_001953.1~CAT_10192-H08H-25	40	41	-1
B43R21C10	43-10-21	Hs~Ref:NP_001953.1~CAT_10192-H08H-25	38	40	-2
B43R21C11	43-11-21	Internal_1007209	2291	41	2250
B43R21C12	43-12-21	Internal_1007209	2087	44	2043
B43R21C13	43-13-21	Hs~Ref:P01567~CAT_10341-H01H-25	36	38	-2
B43R21C14	43-14-21	Hs~Ref:P01567~CAT_10341-H01H-25	37	43	-6
B43R21C15	43-15-21	Internal_1007209	41	40	1
B43R21C16	43-16-21	Internal_1007209	40	40	0
B43R21C17	43-17-21	Hs~Ref:Q92843-1~CAT_10059-H08E-25	90	42	48
B43R21C18	43-18-21	Hs~Ref:Q92843-1~CAT_10059-H08E-25	136	60	76
B43R21C19	43-19-21	Internal_1007209	114	42	72
B43R21C20	43-20-21	Internal_1007209	129	40	89
B43R21C21	43-21-21	Hs~Abcam:hu-IgM~CAT_ab90348~N/A	5232	43	5189
B43R21C22	43-22-21	Hs~Abcam:hu-IgM~CAT_ab90348~N/A	5567	44	5523
B43R22C01	43-1-22	ERa~N/A	2173	37	2136
B43R22C02	43-2-22	ERa~N/A	2182	39	2143
B43R22C03	43-3-22	PKCeta~N/A	259	41	218
B43R22C04	43-4-22	PKCeta~N/A	254	40	214
B43R22C05	43-5-22	Calmodulin~N/A	84	45	39
B43R22C06	43-6-22	Calmodulin~N/A	122	45	77
B43R22C07	43-7-22	V5control5~N/A	173	65	108
B43R22C08	43-8-22	V5control5~N/A	276	47	229
B43R22C09	43-9-22	V5control4~N/A	94	40	54
B43R22C10	43-10-22	V5control4~N/A	118	44	74
B43R22C11	43-11-22	V5control3~N/A	64	40	24
B43R22C12	43-12-22	V5control3~N/A	67	40	27
B43R22C13	43-13-22	V5control2~N/A	51	40	11
B43R22C14	43-14-22	V5control2~N/A	53	40	13
B43R22C15	43-15-22	V5control1~N/A	47	40	7
B43R22C16	43-16-22	V5control1~N/A	50	43	7
B43R22C17	43-17-22	CMK2A~N/A	237	42	195
B43R22C18	43-18-22	CMK2A~N/A	41	46	-5
B43R22C19	43-19-22	ERa~N/A	2004	41	1963
B43R22C20	43-20-22	ERa~N/A	1818	42	1776
B43R22C21	43-21-22	AlexaAntiMouseAb~N/A	8688	41	8647
B43R22C22	43-22-22	AlexaAntiMouseAb~N/A	9612	40	9572
B44R01C01	44-1-1	AlexaAntiMouseAb~N/A	33787	47	33740
B44R01C02	44-2-1	AlexaAntiMouseAb~N/A	33827	45	33782
B44R01C03	44-3-1	ERa~N/A	2398	48	2350
B44R01C04	44-4-1	ERa~N/A	1875	44	1831
B44R01C05	44-5-1	HumanIgG1~N/A	787	46	741
B44R01C06	44-6-1	HumanIgG1~N/A	2175	54	2121
B44R01C07	44-7-1	HumanIgG2~N/A	2130	46	2084
B44R01C08	44-8-1	HumanIgG2~N/A	2268	52	2216
B44R01C09	44-9-1	HumanIgG3~N/A	11224	52	11172
B44R01C10	44-10-1	HumanIgG3~N/A	12973	63	12910
B44R01C11	44-11-1	HumanIgG4~N/A	39297	121	39176
B44R01C12	44-12-1	HumanIgG4~N/A	31449	87	31362
B44R01C13	44-13-1	BiotinAb~N/A	350	81	269
B44R01C14	44-14-1	BiotinAb~N/A	411	68	343
B44R01C15	44-15-1	RanBP2deltaFG~N/A	350	52	298
B44R01C16	44-16-1	RanBP2deltaFG~N/A	295	52	243
B44R01C17	44-17-1	hMDM2~N/A	588	50	538
B44R01C18	44-18-1	hMDM2~N/A	152	76	76
B44R01C19	44-19-1	PKCeta~N/A	938	59	879
B44R01C20	44-20-1	PKCeta~N/A	940	69	871
B44R01C21	44-21-1	AlexaAntiMouseAb~N/A	31482	65	31417
B44R01C22	44-22-1	AlexaAntiMouseAb~N/A	32726	59	32667
B44R02C01	44-1-2	PKCeta~N/A	64	52	12
B44R02C02	44-2-2	PKCeta~N/A	114	55	59
B44R02C03	44-3-2	Buffer	2695	58	2637
B44R02C04	44-4-2	Buffer	3040	55	2985
B44R02C05	44-5-2	HumanIgA~N/A	21145	61	21084
B44R02C06	44-6-2	HumanIgA~N/A	18788	67	18721
B44R02C07	44-7-2	Buffer	169	59	110
B44R02C08	44-8-2	Buffer	2267	60	2207
B44R02C09	44-9-2	BSA~N/A	9138	64	9074
B44R02C10	44-10-2	BSA~N/A	9052	70	8982
B44R02C11	44-11-2	Hs~Ref:NM_006651.2~uORF:IOH4343	3917	121	3796
B44R02C12	44-12-2	Hs~Ref:NM_006651.2~uORF:IOH4343	3643	272	3371
B44R02C13	44-13-2	Hs~MGC:BC002437.1~uORF:IOH4246	63	77	-14
B44R02C14	44-14-2	Hs~MGC:BC002437.1~uORF:IOH4246	373	236	137
B44R02C15	44-15-2	Hs~MGC:BC006794.1~uORF:IOH3178	599	82	517
B44R02C16	44-16-2	Hs~MGC:BC006794.1~uORF:IOH3178	66	204	-138
B44R02C17	44-17-2	Hs~MGC:BC029402.1~uORF:IOH23135	51	110	-59
B44R02C18	44-18-2	Hs~MGC:BC029402.1~uORF:IOH23135	60	268	-208
B44R02C19	44-19-2	Hs~Ref:NM_001448.2~uORF:IOH25750	421	85	336
B44R02C20	44-20-2	Hs~Ref:NM_001448.2~uORF:IOH25750	507	64	443
B44R02C21	44-21-2	Hs~Ref:NM_016046.2~uORF:IOH11580	574	81	493
B44R02C22	44-22-2	Hs~Ref:NM_016046.2~uORF:IOH11580	573	66	507
B44R03C01	44-1-3	Hs~MGC:BC018823.2~uORF:IOH14860	5276	339	4937
B44R03C02	44-2-3	Hs~MGC:BC018823.2~uORF:IOH14860	5447	167	5280
B44R03C03	44-3-3	Hs~Ref:NM_012328.1~uORF:IOH22212	5890	344	5546
B44R03C04	44-4-3	Hs~Ref:NM_012328.1~uORF:IOH22212	533	66	467
B44R03C05	44-5-3	Hs~Ref:NM_197957.2~uORF:IOH41003	314	113	201
B44R03C06	44-6-3	Hs~Ref:NM_197957.2~uORF:IOH41003	341	65	276
B44R03C07	44-7-3	Hs~MGC:NM_201263.1~uORF:IOH43175	94	67	27
B44R03C08	44-8-3	Hs~MGC:NM_201263.1~uORF:IOH43175	182	82	100
B44R03C09	44-9-3	Hs~Ref:XM_371311.3~uORF:IOH42993	445	74	371
B44R03C10	44-10-3	Hs~Ref:XM_371311.3~uORF:IOH42993	57	158	-101
B44R03C11	44-11-3	Hs~Ref:NM_138623.2~uORF:IOH42179	382	94	288
B44R03C12	44-12-3	Hs~Ref:NM_138623.2~uORF:IOH42179	361	230	131
B44R03C13	44-13-3	Hs~Ref:XM_378678.1~uORF:IOH42222	907	388	519
B44R03C14	44-14-3	Hs~Ref:XM_378678.1~uORF:IOH42222	457	278	179
B44R03C15	44-15-3	Hs~Ref:NM_198491.1~uORF:IOH41015	351	190	161
B44R03C16	44-16-3	Hs~Ref:NM_198491.1~uORF:IOH41015	94	175	-81
B44R03C17	44-17-3	Hs~Ref:NM_139161.2~uORF:IOH43543	120	102	18
B44R03C18	44-18-3	Hs~Ref:NM_139161.2~uORF:IOH43543	50	116	-66
B44R03C19	44-19-3	Hs~Ref:NM_004875.2~uORF:IOH42058	56	96	-40
B44R03C20	44-20-3	Hs~Ref:NM_004875.2~uORF:IOH42058	66	97	-31
B44R03C21	44-21-3	Hs~MGC:BC011515.1~uORF:IOH9684	94	128	-34
B44R03C22	44-22-3	Hs~MGC:BC011515.1~uORF:IOH9684	77	91	-14
B44R04C01	44-1-4	Hs~MGC:BC007783.2~uORF:IOH6518	199	53	146
B44R04C02	44-2-4	Hs~MGC:BC007783.2~uORF:IOH6518	177	51	126
B44R04C03	44-3-4	Hs~MGC:BC015799.1~uORF:IOH10121	572	63	509
B44R04C04	44-4-4	Hs~MGC:BC015799.1~uORF:IOH10121	227	49	178
B44R04C05	44-5-4	Hs~MGC:BC025369.1~uORF:IOH14349	159	56	103
B44R04C06	44-6-4	Hs~MGC:BC025369.1~uORF:IOH14349	151	54	97
B44R04C07	44-7-4	Hs~MGC:BC033130.1~uORF:IOH23218	349	51	298
B44R04C08	44-8-4	Hs~MGC:BC033130.1~uORF:IOH23218	364	65	299
B44R04C09	44-9-4	Hs~MGC:BC020873.1~uORF:IOH12323	1348	123	1225
B44R04C10	44-10-4	Hs~MGC:BC020873.1~uORF:IOH12323	665	313	352
B44R04C11	44-11-4	Hs~Ref:NM_018464.2~uORF:IOH7211	1154	427	727
B44R04C12	44-12-4	Hs~Ref:NM_018464.2~uORF:IOH7211	1128	54	1074
B44R04C13	44-13-4	Hs~Ref:NM_001544.2~uORF:IOH23172	1013	51	962
B44R04C14	44-14-4	Hs~Ref:NM_001544.2~uORF:IOH23172	935	48	887
B44R04C15	44-15-4	Hs~Ref:NM_016648.1~uORF:IOH41297	1799	46	1753
B44R04C16	44-16-4	Hs~Ref:NM_016648.1~uORF:IOH41297	1534	51	1483
B44R04C17	44-17-4	Hs~Ref:NM_206919.1~uORF:IOH43014	163	48	115
B44R04C18	44-18-4	Hs~Ref:NM_206919.1~uORF:IOH43014	163	51	112
B44R04C19	44-19-4	Hs~Ref:NM_004701.2~uORF:IOH41218	2593	66	2527
B44R04C20	44-20-4	Hs~Ref:NM_004701.2~uORF:IOH41218	3225	80	3145
B44R04C21	44-21-4	Hs~Ref:NM_172178.1~uORF:IOH44756	67	61	6
B44R04C22	44-22-4	Hs~Ref:NM_172178.1~uORF:IOH44756	88	66	22
B44R05C01	44-1-5	Hs~MGC:NM_016533.4~uORF:IOH43470	154	49	105
B44R05C02	44-2-5	Hs~MGC:NM_016533.4~uORF:IOH43470	139	51	88
B44R05C03	44-3-5	Hs~Ref:NM_173084.1~uORF:IOH43187	290	49	241
B44R05C04	44-4-5	Hs~Ref:NM_173084.1~uORF:IOH43187	87	48	39
B44R05C05	44-5-5	Hs~Ref:XM_373824.2~uORF:IOH43375	297	60	237
B44R05C06	44-6-5	Hs~Ref:XM_373824.2~uORF:IOH43375	304	48	256
B44R05C07	44-7-5	Hs~Ref:NM_012451.2~uORF:IOH43189	222	46	176
B44R05C08	44-8-5	Hs~Ref:NM_012451.2~uORF:IOH43189	211	47	164
B44R05C09	44-9-5	Hs~MGC:BC048980.1~uORF:IOH26755	161	58	103
B44R05C10	44-10-5	Hs~MGC:BC048980.1~uORF:IOH26755	213	49	164
B44R05C11	44-11-5	Hs~Ref:NM_001007545.1~uORF:IOH40706	283	48	235
B44R05C12	44-12-5	Hs~Ref:NM_001007545.1~uORF:IOH40706	307	48	259
B44R05C13	44-13-5	Hs~MGC:BC045655.1~uORF:IOH27726	275	53	222
B44R05C14	44-14-5	Hs~MGC:BC045655.1~uORF:IOH27726	42	60	-18
B44R05C15	44-15-5	Hs~Ref:NM_016167.3~uORF:IOH40609	656	47	609
B44R05C16	44-16-5	Hs~Ref:NM_016167.3~uORF:IOH40609	731	58	673
B44R05C17	44-17-5	Hs~Ref:NM_133640.3~uORF:IOH42523	794	56	738
B44R05C18	44-18-5	Hs~Ref:NM_133640.3~uORF:IOH42523	755	50	705
B44R05C19	44-19-5	Hs~Ref:NM_173842.1~uORF:IOH42169	277	55	222
B44R05C20	44-20-5	Hs~Ref:NM_173842.1~uORF:IOH42169	66	178	-112
B44R05C21	44-21-5	Hs~Ref:NM_007066.3~uORF:IOH42371	489	60	429
B44R05C22	44-22-5	Hs~Ref:NM_007066.3~uORF:IOH42371	62	96	-34
B44R06C01	44-1-6	Hs~Ref:NM_002735.1~uORF:IOH42254	179	51	128
B44R06C02	44-2-6	Hs~Ref:NM_002735.1~uORF:IOH42254	196	59	137
B44R06C03	44-3-6	Hs~MGC:BC004440.1~uORF:IOH5013	923	121	802
B44R06C04	44-4-6	Hs~MGC:BC004440.1~uORF:IOH5013	231	47	184
B44R06C05	44-5-6	Hs~Ref:NM_004738.1~uORF:IOH4934	46	47	-1
B44R06C06	44-6-6	Hs~Ref:NM_004738.1~uORF:IOH4934	45	48	-3
B44R06C07	44-7-6	Hs~MGC:BC009010.1~uORF:IOH3292	605	55	550
B44R06C08	44-8-6	Hs~MGC:BC009010.1~uORF:IOH3292	552	64	488
B44R06C09	44-9-6	Hs~Ref:NM_019103.1~uORF:IOH9858	58	53	5
B44R06C10	44-10-6	Hs~Ref:NM_019103.1~uORF:IOH9858	159	47	112
B44R06C11	44-11-6	Hs~Ref:NM_138278.1~uORF:IOH11810	623	187	436
B44R06C12	44-12-6	Hs~Ref:NM_138278.1~uORF:IOH11810	351	49	302
B44R06C13	44-13-6	Hs~MGC:BC033726.1~uORF:IOH21784	1153	69	1084
B44R06C14	44-14-6	Hs~MGC:BC033726.1~uORF:IOH21784	55	65	-10
B44R06C15	44-15-6	Hs~MGC:BC033752.1~uORF:IOH21873	61	73	-12
B44R06C16	44-16-6	Hs~MGC:BC033752.1~uORF:IOH21873	47	57	-10
B44R06C17	44-17-6	Hs~MGC:BC029112.1~uORF:IOH22118	953	612	341
B44R06C18	44-18-6	Hs~MGC:BC029112.1~uORF:IOH22118	841	65	776
B44R06C19	44-19-6	Hs~Ref:NM_201262.1~uORF:IOH41260	1263	57	1206
B44R06C20	44-20-6	Hs~Ref:NM_201262.1~uORF:IOH41260	1264	58	1206
B44R06C21	44-21-6	Hs~Ref:NM_153045.2~uORF:IOH41169	69	53	16
B44R06C22	44-22-6	Hs~Ref:NM_153045.2~uORF:IOH41169	72	52	20
B44R07C01	44-1-7	Hs~Ref:NM_003996.2~uORF:IOH60395	243	52	191
B44R07C02	44-2-7	Hs~Ref:NM_003996.2~uORF:IOH60395	254	150	104
B44R07C03	44-3-7	Hs~MGC:BC096243.1~uORF:IOH63228	776	211	565
B44R07C04	44-4-7	Hs~MGC:BC096243.1~uORF:IOH63228	496	53	443
B44R07C05	44-5-7	Hs~Ref:NM_005465.3~uORF:IOH37801	425	52	373
B44R07C06	44-6-7	Hs~Ref:NM_005465.3~uORF:IOH37801	416	49	367
B44R07C07	44-7-7	Hs~Ref:NM_016369.3~uORF:IOH41005	215	46	169
B44R07C08	44-8-7	Hs~Ref:NM_016369.3~uORF:IOH41005	40	48	-8
B44R07C09	44-9-7	Hs~Ref:NM_000148.2~uORF:IOH41006	361	47	314
B44R07C10	44-10-7	Hs~Ref:NM_000148.2~uORF:IOH41006	350	45	305
B44R07C11	44-11-7	Hs~Ref:NM_014445.2~uORF:IOH41298	804	48	756
B44R07C12	44-12-7	Hs~Ref:NM_014445.2~uORF:IOH41298	762	50	712
B44R07C13	44-13-7	Hs~MGC:BC002519.2~uORF:IOH62827	1472	49	1423
B44R07C14	44-14-7	Hs~MGC:BC002519.2~uORF:IOH62827	1587	49	1538
B44R07C15	44-15-7	Hs~MGC:BC000660.2~uORF:IOH62893	188	48	140
B44R07C16	44-16-7	Hs~MGC:BC000660.2~uORF:IOH62893	85	53	32
B44R07C17	44-17-7	Hs~MGC:BC066341.1~uORF:IOH61487	203	47	156
B44R07C18	44-18-7	Hs~MGC:BC066341.1~uORF:IOH61487	214	51	163
B44R07C19	44-19-7	Hs~MGC:BC089041.1~uORF:IOH63113	503	318	185
B44R07C20	44-20-7	Hs~MGC:BC089041.1~uORF:IOH63113	382	306	76
B44R07C21	44-21-7	Hs~MGC:BC065731.1~uORF:IOH62864	3750	52	3698
B44R07C22	44-22-7	Hs~MGC:BC065731.1~uORF:IOH62864	3895	51	3844
B44R08C01	44-1-8	Hs~MGC:BC047476.1~uORF:IOH62399	39	66	-27
B44R08C02	44-2-8	Hs~MGC:BC047476.1~uORF:IOH62399	53	69	-16
B44R08C03	44-3-8	Hs~Ref:NM_000577.3~uORF:IOH57147	122	61	61
B44R08C04	44-4-8	Hs~Ref:NM_000577.3~uORF:IOH57147	112	52	60
B44R08C05	44-5-8	Hs~Ref:NM_000689.3~uORF:IOH57094	86	46	40
B44R08C06	44-6-8	Hs~Ref:NM_000689.3~uORF:IOH57094	72	44	28
B44R08C07	44-7-8	Hs~MGC:BC031655.1~uORF:IOH22760	535	43	492
B44R08C08	44-8-8	Hs~MGC:BC031655.1~uORF:IOH22760	658	55	603
B44R08C09	44-9-8	Hs~MGC:BC000788.1~uORF:IOH4609	173	120	53
B44R08C10	44-10-8	Hs~MGC:BC000788.1~uORF:IOH4609	127	49	78
B44R08C11	44-11-8	Hs~Ref:NM_006623.1~uORF:IOH3438	142	52	90
B44R08C12	44-12-8	Hs~Ref:NM_006623.1~uORF:IOH3438	153	58	95
B44R08C13	44-13-8	Hs~MGC:BC004349.1~uORF:IOH4355	546	51	495
B44R08C14	44-14-8	Hs~MGC:BC004349.1~uORF:IOH4355	648	52	596
B44R08C15	44-15-8	Hs~Ref:NM_002243.2~uORF:IOH13007	108	53	55
B44R08C16	44-16-8	Hs~Ref:NM_002243.2~uORF:IOH13007	141	63	78
B44R08C17	44-17-8	Hs~MGC:BC014095.2~uORF:IOH14089	211	60	151
B44R08C18	44-18-8	Hs~MGC:BC014095.2~uORF:IOH14089	296	61	235
B44R08C19	44-19-8	Hs~MGC:BC001709.1~uORF:IOH4911	420	173	247
B44R08C20	44-20-8	Hs~MGC:BC001709.1~uORF:IOH4911	318	65	253
B44R08C21	44-21-8	Hs~Ref:NM_003943.1~uORF:IOH14388	300	52	248
B44R08C22	44-22-8	Hs~Ref:NM_003943.1~uORF:IOH14388	142	50	92
B44R09C01	44-1-9	Hs~Ref:NM_153012.1~uORF:IOH12147	364	45	319
B44R09C02	44-2-9	Hs~Ref:NM_153012.1~uORF:IOH12147	415	47	368
B44R09C03	44-3-9	Hs~MGC:BC006375.2~uORF:IOH6475	195	50	145
B44R09C04	44-4-9	Hs~MGC:BC006375.2~uORF:IOH6475	190	52	138
B44R09C05	44-5-9	Hs~MGC:BC001222.1~uORF:IOH4460	360	81	279
B44R09C06	44-6-9	Hs~MGC:BC001222.1~uORF:IOH4460	115	48	67
B44R09C07	44-7-9	Hs~Ref:NM_001183.3~uORF:IOH4722	109	43	66
B44R09C08	44-8-9	Hs~Ref:NM_001183.3~uORF:IOH4722	95	45	50
B44R09C09	44-9-9	Hs~Ref:NM_005804.2~uORF:IOH3477	246	47	199
B44R09C10	44-10-9	Hs~Ref:NM_005804.2~uORF:IOH3477	40	66	-26
B44R09C11	44-11-9	Hs~MGC:BC001467.1~uORF:IOH4030	44	89	-45
B44R09C12	44-12-9	Hs~MGC:BC001467.1~uORF:IOH4030	95	62	33
B44R09C13	44-13-9	Hs~Ref:NM_006701.2~uORF:IOH3749	1330	46	1284
B44R09C14	44-14-9	Hs~Ref:NM_006701.2~uORF:IOH3749	1738	49	1689
B44R09C15	44-15-9	Hs~Ref:NM_021130.1~uORF:IOH4329	908	45	863
B44R09C16	44-16-9	Hs~Ref:NM_021130.1~uORF:IOH4329	771	47	724
B44R09C17	44-17-9	Hs~MGC:BC057792.1~uORF:IOH29128	109	59	50
B44R09C18	44-18-9	Hs~MGC:BC057792.1~uORF:IOH29128	52	95	-43
B44R09C19	44-19-9	Hs~MGC:BC035721.1~uORF:IOH28747	55	70	-15
B44R09C20	44-20-9	Hs~MGC:BC035721.1~uORF:IOH28747	61	92	-31
B44R09C21	44-21-9	Hs~MGC:BC058882.1~uORF:IOH29064	83	51	32
B44R09C22	44-22-9	Hs~MGC:BC058882.1~uORF:IOH29064	59	60	-1
B44R10C01	44-1-10	Hs~MGC:BC022319.1~uORF:IOH12335	614	42	572
B44R10C02	44-2-10	Hs~MGC:BC022319.1~uORF:IOH12335	567	46	521
B44R10C03	44-3-10	Hs~MGC:BC004368.1~uORF:IOH5600	231	161	70
B44R10C04	44-4-10	Hs~MGC:BC004368.1~uORF:IOH5600	154	127	27
B44R10C05	44-5-10	Hs~MGC:BC053866.1~uORF:IOH28947	597	47	550
B44R10C06	44-6-10	Hs~MGC:BC053866.1~uORF:IOH28947	576	45	531
B44R10C07	44-7-10	Hs~MGC:BC053365.1~uORF:IOH29003	713	43	670
B44R10C08	44-8-10	Hs~MGC:BC053365.1~uORF:IOH29003	623	41	582
B44R10C09	44-9-10	Hs~MGC:BC036456.1~uORF:IOH22421	166	41	125
B44R10C10	44-10-10	Hs~MGC:BC036456.1~uORF:IOH22421	52	53	-1
B44R10C11	44-11-10	GST1	45	44	1
B44R10C12	44-12-10	GST1	43	44	-1
B44R10C13	44-13-10	GST2	531	44	487
B44R10C14	44-14-10	GST2	2085	55	2030
B44R10C15	44-15-10	GST3	828	48	780
B44R10C16	44-16-10	GST3	48	44	4
B44R10C17	44-17-10	GST4	133	48	85
B44R10C18	44-18-10	GST4	52	45	7
B44R10C19	44-19-10	Anti-HumanIgA1~N/A	5973	47	5926
B44R10C20	44-20-10	Anti-HumanIgA1~N/A	6140	53	6087
B44R10C21	44-21-10	Anti-HumanIgA2~N/A	11038	65	10973
B44R10C22	44-22-10	Anti-HumanIgA2~N/A	11928	69	11859
B44R11C01	44-1-11	AlexaAntiMouseAb~N/A	18357	41	18316
B44R11C02	44-2-11	AlexaAntiMouseAb~N/A	22231	46	22185
B44R11C03	44-3-11	MAPKAP~N/A	99	48	51
B44R11C04	44-4-11	MAPKAP~N/A	74	43	31
B44R11C05	44-5-11	Buffer	806	46	760
B44R11C06	44-6-11	Buffer	976	45	931
B44R11C07	44-7-11	BSA~N/A	7079	44	7035
B44R11C08	44-8-11	BSA~N/A	6704	42	6662
B44R11C09	44-9-11	Anti-HumanIgG1~N/A	1369	40	1329
B44R11C10	44-10-11	Anti-HumanIgG1~N/A	1584	44	1540
B44R11C11	44-11-11	Anti-HumanIgG2~N/A	2342	43	2299
B44R11C12	44-12-11	Anti-HumanIgG2~N/A	2703	44	2659
B44R11C13	44-13-11	Anti-HumanIgG3~N/A	4372	45	4327
B44R11C14	44-14-11	Anti-HumanIgG3~N/A	4241	48	4193
B44R11C15	44-15-11	Anti-HumanIgG4~N/A	7236	48	7188
B44R11C16	44-16-11	Anti-HumanIgG4~N/A	8362	49	8313
B44R11C17	44-17-11	AntiBiotinAb~N/A	9709	47	9662
B44R11C18	44-18-11	AntiBiotinAb~N/A	9861	45	9816
B44R11C19	44-19-11	Buffer	58	46	12
B44R11C20	44-20-11	Buffer	99	58	41
B44R11C21	44-21-11	Hs~MGC:BC050419.1~uORF:IOH26677	790	63	727
B44R11C22	44-22-11	Hs~MGC:BC050419.1~uORF:IOH26677	771	79	692
B44R12C01	44-1-12	Hs~Ref:NM_003668.2~uORF:IOH28010	2010	43	1967
B44R12C02	44-2-12	Hs~Ref:NM_003668.2~uORF:IOH28010	1840	45	1795
B44R12C03	44-3-12	Hs~MGC:BC005072.1~uORF:IOH6573	574	42	532
B44R12C04	44-4-12	Hs~MGC:BC005072.1~uORF:IOH6573	480	42	438
B44R12C05	44-5-12	Hs~Ref:NM_022006.1~uORF:IOH12523	516	47	469
B44R12C06	44-6-12	Hs~Ref:NM_022006.1~uORF:IOH12523	375	49	326
B44R12C07	44-7-12	Hs~Ref:NM_014551.3~uORF:IOH3660	64	53	11
B44R12C08	44-8-12	Hs~Ref:NM_014551.3~uORF:IOH3660	81	53	28
B44R12C09	44-9-12	Hs~Ref:NM_001130.5~uORF:IOH59679	650	51	599
B44R12C10	44-10-12	Hs~Ref:NM_001130.5~uORF:IOH59679	578	50	528
B44R12C11	44-11-12	Hs~MGC:BC103694.1~uORF:IOH63599	50	44	6
B44R12C12	44-12-12	Hs~MGC:BC103694.1~uORF:IOH63599	47	42	5
B44R12C13	44-13-12	Hs~MGC:BC010852.1~uORF:IOH9927	241	178	63
B44R12C14	44-14-12	Hs~MGC:BC010852.1~uORF:IOH9927	344	47	297
B44R12C15	44-15-12	Hs~MGC:BC030665.1~uORF:IOH22451	241	47	194
B44R12C16	44-16-12	Hs~MGC:BC030665.1~uORF:IOH22451	285	195	90
B44R12C17	44-17-12	Hs~MGC:BC027476.1~uORF:IOH11961	57	50	7
B44R12C18	44-18-12	Hs~MGC:BC027476.1~uORF:IOH11961	149	47	102
B44R12C19	44-19-12	Hs~MGC:BC100766.2~uORF:IOH63422	92	81	11
B44R12C20	44-20-12	Hs~MGC:BC100766.2~uORF:IOH63422	202	51	151
B44R12C21	44-21-12	Hs~MGC:BC100813.1~uORF:IOH63506	159	68	91
B44R12C22	44-22-12	Hs~MGC:BC100813.1~uORF:IOH63506	86	66	20
B44R13C01	44-1-13	Hs~Ref:NM_024692.3~uORF:IOH42634	1571	45	1526
B44R13C02	44-2-13	Hs~Ref:NM_024692.3~uORF:IOH42634	1256	40	1216
B44R13C03	44-3-13	Hs~Ref:NM_014622.4~uORF:IOH41880	707	41	666
B44R13C04	44-4-13	Hs~Ref:NM_014622.4~uORF:IOH41880	749	41	708
B44R13C05	44-5-13	Hs~Ref:NM_023015.3~uORF:IOH41890	315	43	272
B44R13C06	44-6-13	Hs~Ref:NM_023015.3~uORF:IOH41890	344	51	293
B44R13C07	44-7-13	Hs~Ref:NM_182597.1~uORF:IOH44503	856	48	808
B44R13C08	44-8-13	Hs~Ref:NM_182597.1~uORF:IOH44503	877	59	818
B44R13C09	44-9-13	Hs~Ref:NM_080650.1~uORF:IOH7567	186	47	139
B44R13C10	44-10-13	Hs~Ref:NM_080650.1~uORF:IOH7567	188	50	138
B44R13C11	44-11-13	Hs~MGC:BC017237.1~uORF:IOH14458	60	59	1
B44R13C12	44-12-13	Hs~MGC:BC017237.1~uORF:IOH14458	815	62	753
B44R13C13	44-13-13	Hs~MGC:NM_014346.1~uORF:IOH22792	214	48	166
B44R13C14	44-14-13	Hs~MGC:NM_014346.1~uORF:IOH22792	214	46	168
B44R13C15	44-15-13	Hs~Ref:NM_001394.3~uORF:IOH21147	77	42	35
B44R13C16	44-16-13	Hs~Ref:NM_001394.3~uORF:IOH21147	41	45	-4
B44R13C17	44-17-13	Hs~MGC:BC015165.1~uORF:IOH9890	297	47	250
B44R13C18	44-18-13	Hs~MGC:BC015165.1~uORF:IOH9890	241	44	197
B44R13C19	44-19-13	Hs~MGC:BC022893.1~uORF:IOH13672	139	94	45
B44R13C20	44-20-13	Hs~MGC:BC022893.1~uORF:IOH13672	89	77	12
B44R13C21	44-21-13	Hs~MGC:BC004921.1~uORF:IOH5220	61	64	-3
B44R13C22	44-22-13	Hs~MGC:BC004921.1~uORF:IOH5220	99	59	40
B44R14C01	44-1-14	Hs~MGC:BC001430.1~uORF:IOH3991	255	47	208
B44R14C02	44-2-14	Hs~MGC:BC001430.1~uORF:IOH3991	55	47	8
B44R14C03	44-3-14	Hs~Ref:NM_001801.2~uORF:IOH54757	279	43	236
B44R14C04	44-4-14	Hs~Ref:NM_001801.2~uORF:IOH54757	276	41	235
B44R14C05	44-5-14	Hs~Ref:NM_015547.2~uORF:IOH52438	219	42	177
B44R14C06	44-6-14	Hs~Ref:NM_015547.2~uORF:IOH52438	272	52	220
B44R14C07	44-7-14	Hs~Ref:NM_018363.1~uORF:IOH59345	130	41	89
B44R14C08	44-8-14	Hs~Ref:NM_018363.1~uORF:IOH59345	114	45	69
B44R14C09	44-9-14	Hs~Ref:NM_001012732.1~uORF:IOH54732	345	57	288
B44R14C10	44-10-14	Hs~Ref:NM_001012732.1~uORF:IOH54732	362	64	298
B44R14C11	44-11-14	Hs~MGC:BC016828.1~uORF:IOH23007	117	49	68
B44R14C12	44-12-14	Hs~MGC:BC016828.1~uORF:IOH23007	51	54	-3
B44R14C13	44-13-14	Hs~Ref:NM_000790.1~uORF:IOH3416	103	52	51
B44R14C14	44-14-14	Hs~Ref:NM_000790.1~uORF:IOH3416	101	52	49
B44R14C15	44-15-14	Hs~Ref:NM_002924.2~uORF:IOH11294	162	49	113
B44R14C16	44-16-14	Hs~Ref:NM_002924.2~uORF:IOH11294	46	69	-23
B44R14C17	44-17-14	Hs~MGC:BC103919.1~uORF:IOH63517	127	106	21
B44R14C18	44-18-14	Hs~MGC:BC103919.1~uORF:IOH63517	173	48	125
B44R14C19	44-19-14	Hs~MGC:BC036193.1~uORF:IOH27486	499	50	449
B44R14C20	44-20-14	Hs~MGC:BC036193.1~uORF:IOH27486	289	73	216
B44R14C21	44-21-14	Hs~Ref:NM_006225.1~uORF:IOH20956	181	91	90
B44R14C22	44-22-14	Hs~Ref:NM_006225.1~uORF:IOH20956	136	65	71
B44R15C01	44-1-15	Hs~MGC:BC104468.1~uORF:IOH63630	419	46	373
B44R15C02	44-2-15	Hs~MGC:BC104468.1~uORF:IOH63630	329	43	286
B44R15C03	44-3-15	Hs~Ref:NM_016557.2~uORF:IOH60821	788	44	744
B44R15C04	44-4-15	Hs~Ref:NM_016557.2~uORF:IOH60821	689	44	645
B44R15C05	44-5-15	Hs~Ref:NM_024294.1~uORF:IOH5168	553	44	509
B44R15C06	44-6-15	Hs~Ref:NM_024294.1~uORF:IOH5168	563	52	511
B44R15C07	44-7-15	Hs~MGC:BC014441.1~uORF:IOH13328	45	57	-12
B44R15C08	44-8-15	Hs~MGC:BC014441.1~uORF:IOH13328	39	66	-27
B44R15C09	44-9-15	Hs~Ref:NM_032655.1~uORF:IOH5573	801	184	617
B44R15C10	44-10-15	Hs~Ref:NM_032655.1~uORF:IOH5573	48	51	-3
B44R15C11	44-11-15	Hs~MGC:BC004376.1~uORF:IOH5584	56	42	14
B44R15C12	44-12-15	Hs~MGC:BC004376.1~uORF:IOH5584	68	45	23
B44R15C13	44-13-15	Hs~Ref:NM_002576.2~CAT:PV3820	503	367	136
B44R15C14	44-14-15	Hs~Ref:NM_002576.2~CAT:PV3820	119	50	69
B44R15C15	44-15-15	Hs~Ref:NM_001006943.1~CAT:PV3844	378	46	332
B44R15C16	44-16-15	Hs~Ref:NM_001006943.1~CAT:PV3844	340	50	290
B44R15C17	44-17-15	Hs~Ref:NM_004834.2~CAT:PV3687	287	51	236
B44R15C18	44-18-15	Hs~Ref:NM_004834.2~CAT:PV3687	160	45	115
B44R15C19	44-19-15	Hs~Ref:NM_133494.1~CAT:PV3833	258	46	212
B44R15C20	44-20-15	Hs~Ref:NM_133494.1~CAT:PV3833	63	71	-8
B44R15C21	44-21-15	Hs~Ref:NM_000141.2~CAT:PV3368	126	63	63
B44R15C22	44-22-15	Hs~Ref:NM_000141.2~CAT:PV3368	127	51	76
B44R16C01	44-1-16	Hs~Ref:NM_000586.2~CAT_PHC0027	376	46	330
B44R16C02	44-2-16	Hs~Ref:NM_000586.2~CAT_PHC0027	383	42	341
B44R16C03	44-3-16	Hs~Ref:NM_002982.1~CAT_PHC1015	43	40	3
B44R16C04	44-4-16	Hs~Ref:NM_002982.1~CAT_PHC1015	53	42	11
B44R16C05	44-5-16	Hs~Ref:NM_002651.1~CAT:PV5277	442	79	363
B44R16C06	44-6-16	Hs~Ref:NM_002651.1~CAT:PV5277	471	40	431
B44R16C07	44-7-16	Hs~Ref:NM_032315.1~uORF:IOH5083	179	42	137
B44R16C08	44-8-16	Hs~Ref:NM_032315.1~uORF:IOH5083	161	42	119
B44R16C09	44-9-16	Hs~Ref:NM_006370.1~uORF:IOH5143	293	50	243
B44R16C10	44-10-16	Hs~Ref:NM_006370.1~uORF:IOH5143	192	46	146
B44R16C11	44-11-16	Hs~Ref:NM_000628.3~uORF:IOH4959	154	44	110
B44R16C12	44-12-16	Hs~Ref:NM_000628.3~uORF:IOH4959	144	46	98
B44R16C13	44-13-16	Hs~Ref:NM_007263.3~uORF:IOH5090	168	52	116
B44R16C14	44-14-16	Hs~Ref:NM_007263.3~uORF:IOH5090	167	52	115
B44R16C15	44-15-16	Hs~Ref:NM_199359.1~uORF:IOH41594	520	88	432
B44R16C16	44-16-16	Hs~Ref:NM_199359.1~uORF:IOH41594	446	74	372
B44R16C17	44-17-16	Hs~Ref:NM_181337.2~uORF:IOH50149	586	339	247
B44R16C18	44-18-16	Hs~Ref:NM_181337.2~uORF:IOH50149	400	208	192
B44R16C19	44-19-16	Hs~Ref:NM_181655.1~uORF:IOH50196	950	56	894
B44R16C20	44-20-16	Hs~Ref:NM_181655.1~uORF:IOH50196	876	58	818
B44R16C21	44-21-16	Hs~Ref:NM_152876.1~uORF:IOH50154	479	58	421
B44R16C22	44-22-16	Hs~Ref:NM_152876.1~uORF:IOH50154	69	48	21
B44R17C01	44-1-17	Hs~Ref:NM_002512.1~uORF:IOH4345	248	113	135
B44R17C02	44-2-17	Hs~Ref:NM_002512.1~uORF:IOH4345	205	53	152
B44R17C03	44-3-17	Hs~MGC:BC015547.1~uORF:IOH10337	678	207	471
B44R17C04	44-4-17	Hs~MGC:BC015547.1~uORF:IOH10337	563	44	519
B44R17C05	44-5-17	Hs~MGC:BC011365.1~uORF:IOH9656	42	44	-2
B44R17C06	44-6-17	Hs~MGC:BC011365.1~uORF:IOH9656	42	43	-1
B44R17C07	44-7-17	Hs~MGC:NM_015138.2~uORF:IOH10055	408	46	362
B44R17C08	44-8-17	Hs~MGC:NM_015138.2~uORF:IOH10055	374	45	329
B44R17C09	44-9-17	Hs~Ref:NM_016212.1~uORF:IOH35032	276	70	206
B44R17C10	44-10-17	Hs~Ref:NM_016212.1~uORF:IOH35032	224	118	106
B44R17C11	44-11-17	Hs~Ref:NM_019618.2~uORF:IOH35169	172	49	123
B44R17C12	44-12-17	Hs~Ref:NM_019618.2~uORF:IOH35169	168	50	118
B44R17C13	44-13-17	Hs~Ref:NM_013357.2~uORF:IOH35581	65	63	2
B44R17C14	44-14-17	Hs~Ref:NM_013357.2~uORF:IOH35581	253	50	203
B44R17C15	44-15-17	Hs~Ref:NM_175065.2~uORF:IOH35055	277	49	228
B44R17C16	44-16-17	Hs~Ref:NM_175065.2~uORF:IOH35055	181	76	105
B44R17C17	44-17-17	Hs~MGC:BC090049.1~uORF:IOH62587	600	53	547
B44R17C18	44-18-17	Hs~MGC:BC090049.1~uORF:IOH62587	85	46	39
B44R17C19	44-19-17	Hs~MGC:XM_291439.1~uORF:IOH28506	62	45	17
B44R17C20	44-20-17	Hs~MGC:XM_291439.1~uORF:IOH28506	62	47	15
B44R17C21	44-21-17	Hs~MGC:BC056414.1~uORF:IOH29116	57	46	11
B44R17C22	44-22-17	Hs~MGC:BC056414.1~uORF:IOH29116	136	45	91
B44R18C01	44-1-18	Hs~MGC:BC033537.1~uORF:IOH27639	75	45	30
B44R18C02	44-2-18	Hs~MGC:BC033537.1~uORF:IOH27639	75	45	30
B44R18C03	44-3-18	Hs~MGC:BC034528.1~uORF:IOH22201	60	41	19
B44R18C04	44-4-18	Hs~MGC:BC034528.1~uORF:IOH22201	60	42	18
B44R18C05	44-5-18	Hs~Ref:NM_002790.1~uORF:IOH29609	452	222	230
B44R18C06	44-6-18	Hs~Ref:NM_002790.1~uORF:IOH29609	300	49	251
B44R18C07	44-7-18	Hs~Ref:NM_018400.1~uORF:IOH29595	169	44	125
B44R18C08	44-8-18	Hs~Ref:NM_018400.1~uORF:IOH29595	160	42	118
B44R18C09	44-9-18	Hs~MGC:BC058031.1~uORF:IOH29444	88	42	46
B44R18C10	44-10-18	Hs~MGC:BC058031.1~uORF:IOH29444	93	45	48
B44R18C11	44-11-18	Hs~MGC:BC073841.1~uORF:IOH61759	1759	47	1712
B44R18C12	44-12-18	Hs~MGC:BC073841.1~uORF:IOH61759	1549	50	1499
B44R18C13	44-13-18	Hs~MGC:BC064998.1~uORF:IOH61578	560	60	500
B44R18C14	44-14-18	Hs~MGC:BC064998.1~uORF:IOH61578	579	478	101
B44R18C15	44-15-18	Hs~MGC:BC093068.1~uORF:IOH63191	448	54	394
B44R18C16	44-16-18	Hs~MGC:BC093068.1~uORF:IOH63191	400	54	346
B44R18C17	44-17-18	Hs~MGC:BC068456.1~uORF:IOH62464	782	563	219
B44R18C18	44-18-18	Hs~MGC:BC068456.1~uORF:IOH62464	981	73	908
B44R18C19	44-19-18	Hs~Ref:NM_021065.2~uORF:IOH61993	52	44	8
B44R18C20	44-20-18	Hs~Ref:NM_021065.2~uORF:IOH61993	47	48	-1
B44R18C21	44-21-18	Hs~Ref:NM_013371.2~uORF:IOH34776	450	69	381
B44R18C22	44-22-18	Hs~Ref:NM_013371.2~uORF:IOH34776	647	59	588
B44R19C01	44-1-19	Hs~MGC:BC036582.1~uORF:IOH62204	1365	46	1319
B44R19C02	44-2-19	Hs~MGC:BC036582.1~uORF:IOH62204	1399	49	1350
B44R19C03	44-3-19	Hs~MGC:BC032842.1~uORF:IOH62113	247	46	201
B44R19C04	44-4-19	Hs~MGC:BC032842.1~uORF:IOH62113	194	47	147
B44R19C05	44-5-19	Hs~MGC:BC066948.1~uORF:IOH61473	1511	47	1464
B44R19C06	44-6-19	Hs~MGC:BC066948.1~uORF:IOH61473	1875	47	1828
B44R19C07	44-7-19	Hs~MGC:BC080557.1~uORF:IOH63120	39138	47	39091
B44R19C08	44-8-19	Hs~MGC:BC080557.1~uORF:IOH63120	37720	48	37672
B44R19C09	44-9-19	Hs~MGC:BC050696.1~uORF:IOH27004	315	56	259
B44R19C10	44-10-19	Hs~MGC:BC050696.1~uORF:IOH27004	272	52	220
B44R19C11	44-11-19	Hs~MGC:BC040152.1~uORF:IOH26252	315	47	268
B44R19C12	44-12-19	Hs~MGC:BC040152.1~uORF:IOH26252	404	45	359
B44R19C13	44-13-19	Hs~Ref:NM_052965.1~uORF:IOH56031	88	48	40
B44R19C14	44-14-19	Hs~Ref:NM_052965.1~uORF:IOH56031	83	54	29
B44R19C15	44-15-19	Hs~Ref:NM_004595.2~uORF:IOH57117	57	67	-10
B44R19C16	44-16-19	Hs~Ref:NM_004595.2~uORF:IOH57117	70	69	1
B44R19C17	44-17-19	Hs~Ref:NM_002575.1~uORF:IOH53975	296	112	184
B44R19C18	44-18-19	Hs~Ref:NM_002575.1~uORF:IOH53975	129	64	65
B44R19C19	44-19-19	Hs~Ref:NM_032958.3~uORF:IOH58649	374	63	311
B44R19C20	44-20-19	Hs~Ref:NM_032958.3~uORF:IOH58649	300	52	248
B44R19C21	44-21-19	Hs~Ref:NM_015492.2~uORF:IOH4170	177	51	126
B44R19C22	44-22-19	Hs~Ref:NM_015492.2~uORF:IOH4170	172	51	121
B44R20C01	44-1-20	Hs~Ref:NM_002469.1~uORF:IOH13806	289	55	234
B44R20C02	44-2-20	Hs~Ref:NM_002469.1~uORF:IOH13806	242	52	190
B44R20C03	44-3-20	Hs~Ref:NM_005032.2~uORF:IOH2504	282	96	186
B44R20C04	44-4-20	Hs~Ref:NM_005032.2~uORF:IOH2504	331	50	281
B44R20C05	44-5-20	Hs~MGC:BC001120.1~uORF:IOH3920	611	45	566
B44R20C06	44-6-20	Hs~MGC:BC001120.1~uORF:IOH3920	609	44	565
B44R20C07	44-7-20	Hs~Ref:NM_138422.1~uORF:IOH13417	958	45	913
B44R20C08	44-8-20	Hs~Ref:NM_138422.1~uORF:IOH13417	998	49	949
B44R20C09	44-9-20	Hs~Ref:NM_001833.1~uORF:IOH13701	475	364	111
B44R20C10	44-10-20	Hs~Ref:NM_001833.1~uORF:IOH13701	413	123	290
B44R20C11	44-11-20	Hs~Ref:NM_004394.1~uORF:IOH40583	591	48	543
B44R20C12	44-12-20	Hs~Ref:NM_004394.1~uORF:IOH40583	607	44	563
B44R20C13	44-13-20	Hs~MGC:BC065552.1~uORF:IOH40470	48	44	4
B44R20C14	44-14-20	Hs~MGC:BC065552.1~uORF:IOH40470	53	48	5
B44R20C15	44-15-20	Hs~Ref:P59093~uORF:IOH50106	980	56	924
B44R20C16	44-16-20	Hs~Ref:P59093~uORF:IOH50106	1144	614	530
B44R20C17	44-17-20	Hs~Ref:NM_001003684.1~uORF:IOH50100	703	52	651
B44R20C18	44-18-20	Hs~Ref:NM_001003684.1~uORF:IOH50100	686	50	636
B44R20C19	44-19-20	Hs~Ref:NM_180981.1~uORF:IOH50087	875	54	821
B44R20C20	44-20-20	Hs~Ref:NM_180981.1~uORF:IOH50087	935	409	526
B44R20C21	44-21-20	Hs~Ref:NM_133627.1~uORF:IOH50080	288	52	236
B44R20C22	44-22-20	Hs~Ref:NM_133627.1~uORF:IOH50080	277	52	225
B44R21C01	44-1-21	Hs~Ref:BC061920.1~uORF:IOH50138	845	42	803
B44R21C02	44-2-21	Hs~Ref:BC061920.1~uORF:IOH50138	863	44	819
B44R21C03	44-3-21	Hs~Ref:NM_203495.1~uORF:IOH50151	2614	48	2566
B44R21C04	44-4-21	Hs~Ref:NM_203495.1~uORF:IOH50151	2664	44	2620
B44R21C05	44-5-21	Hs~Ref:NM_175622.3~uORF:IOH50067	571	41	530
B44R21C06	44-6-21	Hs~Ref:NM_175622.3~uORF:IOH50067	538	41	497
B44R21C07	44-7-21	Hs~Ref:NM_001002035.1~uORF:IOH50119	717	39	678
B44R21C08	44-8-21	Hs~Ref:NM_001002035.1~uORF:IOH50119	722	39	683
B44R21C09	44-9-21	Hs~Ref:NP_001001547.1~CAT_10752-H08H-25	672	50	622
B44R21C10	44-10-21	Hs~Ref:NP_001001547.1~CAT_10752-H08H-25	665	57	608
B44R21C11	44-11-21	Internal_1007209	3458	43	3415
B44R21C12	44-12-21	Internal_1007209	3516	40	3476
B44R21C13	44-13-21	Hs~Ref:NP_004084.1~CAT_10881-H03H-25	61	43	18
B44R21C14	44-14-21	Hs~Ref:NP_004084.1~CAT_10881-H03H-25	3621	44	3577
B44R21C15	44-15-21	Internal_1007209	118	46	72
B44R21C16	44-16-21	Internal_1007209	46	48	-2
B44R21C17	44-17-21	Hs~Ref:NP_004047.3~CAT_10469-H08E-25	43	43	0
B44R21C18	44-18-21	Hs~Ref:NP_004047.3~CAT_10469-H08E-25	235	47	188
B44R21C19	44-19-21	Internal_1007209	811	72	739
B44R21C20	44-20-21	Internal_1007209	1420	62	1358
B44R21C21	44-21-21	Internal_1007209	1712	51	1661
B44R21C22	44-22-21	Internal_1007209	1886	44	1842
B44R22C01	44-1-22	ERa~N/A	2689	39	2650
B44R22C02	44-2-22	ERa~N/A	2372	44	2328
B44R22C03	44-3-22	PKCeta~N/A	368	46	322
B44R22C04	44-4-22	PKCeta~N/A	356	42	314
B44R22C05	44-5-22	Calmodulin~N/A	256	43	213
B44R22C06	44-6-22	Calmodulin~N/A	274	42	232
B44R22C07	44-7-22	V5control5~N/A	396	37	359
B44R22C08	44-8-22	V5control5~N/A	404	38	366
B44R22C09	44-9-22	V5control4~N/A	91	39	52
B44R22C10	44-10-22	V5control4~N/A	100	42	58
B44R22C11	44-11-22	V5control3~N/A	60	43	17
B44R22C12	44-12-22	V5control3~N/A	45	43	2
B44R22C13	44-13-22	V5control2~N/A	66	46	20
B44R22C14	44-14-22	V5control2~N/A	110	47	63
B44R22C15	44-15-22	V5control1~N/A	76	49	27
B44R22C16	44-16-22	V5control1~N/A	56	47	9
B44R22C17	44-17-22	CMK2A~N/A	551	59	492
B44R22C18	44-18-22	CMK2A~N/A	780	56	724
B44R22C19	44-19-22	ERa~N/A	2160	48	2112
B44R22C20	44-20-22	ERa~N/A	2383	46	2337
B44R22C21	44-21-22	AlexaAntiMouseAb~N/A	6669	45	6624
B44R22C22	44-22-22	AlexaAntiMouseAb~N/A	6612	43	6569
B45R01C01	45-1-1	AlexaAntiMouseAb~N/A	32172	38	32134
B45R01C02	45-2-1	AlexaAntiMouseAb~N/A	34277	37	34240
B45R01C03	45-3-1	ERa~N/A	2271	35	2236
B45R01C04	45-4-1	ERa~N/A	2026	35	1991
B45R01C05	45-5-1	HumanIgG1~N/A	706	36	670
B45R01C06	45-6-1	HumanIgG1~N/A	788	35	753
B45R01C07	45-7-1	HumanIgG2~N/A	2567	36	2531
B45R01C08	45-8-1	HumanIgG2~N/A	3238	43	3195
B45R01C09	45-9-1	HumanIgG3~N/A	13445	44	13401
B45R01C10	45-10-1	HumanIgG3~N/A	15153	45	15108
B45R01C11	45-11-1	HumanIgG4~N/A	45549	47	45502
B45R01C12	45-12-1	HumanIgG4~N/A	52097	44	52053
B45R01C13	45-13-1	BiotinAb~N/A	373	44	329
B45R01C14	45-14-1	BiotinAb~N/A	376	44	332
B45R01C15	45-15-1	RanBP2deltaFG~N/A	313	43	270
B45R01C16	45-16-1	RanBP2deltaFG~N/A	286	52	234
B45R01C17	45-17-1	hMDM2~N/A	691	51	640
B45R01C18	45-18-1	hMDM2~N/A	626	46	580
B45R01C19	45-19-1	PKCeta~N/A	327	48	279
B45R01C20	45-20-1	PKCeta~N/A	383	48	335
B45R01C21	45-21-1	AlexaAntiMouseAb~N/A	37455	47	37408
B45R01C22	45-22-1	AlexaAntiMouseAb~N/A	37484	48	37436
B45R02C01	45-1-2	PKCeta~N/A	579	38	541
B45R02C02	45-2-2	PKCeta~N/A	673	36	637
B45R02C03	45-3-2	Buffer	257	35	222
B45R02C04	45-4-2	Buffer	264	37	227
B45R02C05	45-5-2	HumanIgA~N/A	21525	42	21483
B45R02C06	45-6-2	HumanIgA~N/A	22098	42	22056
B45R02C07	45-7-2	Buffer	120	40	80
B45R02C08	45-8-2	Buffer	63	41	22
B45R02C09	45-9-2	BSA~N/A	13081	44	13037
B45R02C10	45-10-2	BSA~N/A	13131	46	13085
B45R02C11	45-11-2	Hs~Ref:NM_024514.4~uORF:IOH41000	645	63	582
B45R02C12	45-12-2	Hs~Ref:NM_024514.4~uORF:IOH41000	157	43	114
B45R02C13	45-13-2	Hs~Ref:NM_018039.2~uORF:IOH43857	1577	45	1532
B45R02C14	45-14-2	Hs~Ref:NM_018039.2~uORF:IOH43857	1339	45	1294
B45R02C15	45-15-2	Hs~Ref:XM_379717.2~uORF:IOH43678	253	63	190
B45R02C16	45-16-2	Hs~Ref:XM_379717.2~uORF:IOH43678	104	64	40
B45R02C17	45-17-2	Hs~Ref:XM_210860.4~uORF:IOH44696	298	148	150
B45R02C18	45-18-2	Hs~Ref:XM_210860.4~uORF:IOH44696	190	49	141
B45R02C19	45-19-2	Hs~Ref:XM_211447.4~uORF:IOH42904	374	54	320
B45R02C20	45-20-2	Hs~Ref:XM_211447.4~uORF:IOH42904	352	45	307
B45R02C21	45-21-2	Hs~Ref:NM_138395.2~uORF:IOH43092	502	45	457
B45R02C22	45-22-2	Hs~Ref:NM_138395.2~uORF:IOH43092	488	45	443
B45R03C01	45-1-3	Hs~Ref:NM_145174.1~uORF:IOH44767	321	37	284
B45R03C02	45-2-3	Hs~Ref:NM_145174.1~uORF:IOH44767	298	40	258
B45R03C03	45-3-3	Hs~Ref:NM_197958.1~uORF:IOH43099	248	47	201
B45R03C04	45-4-3	Hs~Ref:NM_197958.1~uORF:IOH43099	262	57	205
B45R03C05	45-5-3	Hs~MGC:BC004969.1~uORF:IOH5105	320	49	271
B45R03C06	45-6-3	Hs~MGC:BC004969.1~uORF:IOH5105	374	57	317
B45R03C07	45-7-3	Hs~Ref:NM_032886.1~uORF:IOH6980	497	53	444
B45R03C08	45-8-3	Hs~Ref:NM_032886.1~uORF:IOH6980	495	47	448
B45R03C09	45-9-3	Hs~Ref:NM_000999.2~uORF:IOH4263	591	52	539
B45R03C10	45-10-3	Hs~Ref:NM_000999.2~uORF:IOH4263	406	69	337
B45R03C11	45-11-3	Hs~Ref:NM_052861.1~uORF:IOH21487	566	48	518
B45R03C12	45-12-3	Hs~Ref:NM_052861.1~uORF:IOH21487	360	48	312
B45R03C13	45-13-3	Hs~Ref:NM_015633.1~uORF:IOH59821	231	55	176
B45R03C14	45-14-3	Hs~Ref:NM_015633.1~uORF:IOH59821	250	47	203
B45R03C15	45-15-3	Hs~Ref:NM_005340.1~uORF:IOH3136	326	49	277
B45R03C16	45-16-3	Hs~Ref:NM_005340.1~uORF:IOH3136	283	98	185
B45R03C17	45-17-3	Hs~Ref:NM_012396.1~uORF:IOH12626	774	63	711
B45R03C18	45-18-3	Hs~Ref:NM_012396.1~uORF:IOH12626	697	51	646
B45R03C19	45-19-3	Hs~Ref:NM_006022.1~uORF:IOH3511	445	52	393
B45R03C20	45-20-3	Hs~Ref:NM_006022.1~uORF:IOH3511	411	49	362
B45R03C21	45-21-3	Hs~Ref:NM_016491.1~uORF:IOH4665	348	108	240
B45R03C22	45-22-3	Hs~Ref:NM_016491.1~uORF:IOH4665	109	48	61
B45R04C01	45-1-4	Hs~Ref:NM_016638.1~uORF:IOH4953	893	36	857
B45R04C02	45-2-4	Hs~Ref:NM_016638.1~uORF:IOH4953	896	41	855
B45R04C03	45-3-4	Hs~Ref:NM_021048.2~uORF:IOH5670	255	73	182
B45R04C04	45-4-4	Hs~Ref:NM_021048.2~uORF:IOH5670	243	73	170
B45R04C05	45-5-4	Hs~Ref:NM_004813.1~uORF:IOH5041	251	48	203
B45R04C06	45-6-4	Hs~Ref:NM_004813.1~uORF:IOH5041	148	52	96
B45R04C07	45-7-4	Hs~Ref:NM_014315.1~uORF:IOH4690	537	65	472
B45R04C08	45-8-4	Hs~Ref:NM_014315.1~uORF:IOH4690	186	53	133
B45R04C09	45-9-4	Hs~Ref:NM_000984.2~uORF:IOH13591	1092	52	1040
B45R04C10	45-10-4	Hs~Ref:NM_000984.2~uORF:IOH13591	1117	52	1065
B45R04C11	45-11-4	Hs~Ref:NM_016467.1~uORF:IOH7173	458	49	409
B45R04C12	45-12-4	Hs~Ref:NM_016467.1~uORF:IOH7173	305	66	239
B45R04C13	45-13-4	Hs~MGC:BC022302.1~uORF:IOH14393	185	47	138
B45R04C14	45-14-4	Hs~MGC:BC022302.1~uORF:IOH14393	119	46	73
B45R04C15	45-15-4	Hs~Ref:NM_001324.1~uORF:IOH6092	410	53	357
B45R04C16	45-16-4	Hs~Ref:NM_001324.1~uORF:IOH6092	264	91	173
B45R04C17	45-17-4	Hs~Ref:NM_020165.2~uORF:IOH3060	689	52	637
B45R04C18	45-18-4	Hs~Ref:NM_020165.2~uORF:IOH3060	626	47	579
B45R04C19	45-19-4	Hs~MGC:BC001600.1~uORF:IOH4905	227	82	145
B45R04C20	45-20-4	Hs~MGC:BC001600.1~uORF:IOH4905	237	92	145
B45R04C21	45-21-4	Hs~Ref:NM_016091.1~uORF:IOH4743	390	47	343
B45R04C22	45-22-4	Hs~Ref:NM_016091.1~uORF:IOH4743	176	48	128
B45R05C01	45-1-5	Hs~MGC:BC005241.1~uORF:IOH7257	191	46	145
B45R05C02	45-2-5	Hs~MGC:BC005241.1~uORF:IOH7257	219	43	176
B45R05C03	45-3-5	Hs~Ref:NM_022165.1~uORF:IOH12041	33	34	-1
B45R05C04	45-4-5	Hs~Ref:NM_022165.1~uORF:IOH12041	34	37	-3
B45R05C05	45-5-5	Hs~MGC:NM_153217.1~uORF:IOH13241	943	46	897
B45R05C06	45-6-5	Hs~MGC:NM_153217.1~uORF:IOH13241	987	46	941
B45R05C07	45-7-5	Hs~MGC:BC016914.1~uORF:IOH10995	723	46	677
B45R05C08	45-8-5	Hs~MGC:BC016914.1~uORF:IOH10995	690	44	646
B45R05C09	45-9-5	Hs~Ref:NM_144977.1~uORF:IOH11157	206	44	162
B45R05C10	45-10-5	Hs~Ref:NM_144977.1~uORF:IOH11157	444	46	398
B45R05C11	45-11-5	Hs~Ref:NM_014172.1~uORF:IOH10635	992	117	875
B45R05C12	45-12-5	Hs~Ref:NM_014172.1~uORF:IOH10635	124	53	71
B45R05C13	45-13-5	Hs~Ref:NM_144642.1~uORF:IOH10744	286	80	206
B45R05C14	45-14-5	Hs~Ref:NM_144642.1~uORF:IOH10744	376	111	265
B45R05C15	45-15-5	Hs~MGC:BC026349.1~uORF:IOH10888	273	50	223
B45R05C16	45-16-5	Hs~MGC:BC026349.1~uORF:IOH10888	252	69	183
B45R05C17	45-17-5	Hs~MGC:BC014181.1~uORF:IOH12954	295	59	236
B45R05C18	45-18-5	Hs~MGC:BC014181.1~uORF:IOH12954	245	52	193
B45R05C19	45-19-5	Hs~Ref:NM_017825.1~uORF:IOH12841	226	208	18
B45R05C20	45-20-5	Hs~Ref:NM_017825.1~uORF:IOH12841	268	166	102
B45R05C21	45-21-5	Hs~MGC:BC019268.1~uORF:IOH13177	1723	49	1674
B45R05C22	45-22-5	Hs~MGC:BC019268.1~uORF:IOH13177	1724	47	1677
B45R06C01	45-1-6	Hs~Ref:NM_001381.2~uORF:IOH2343	9026	51	8975
B45R06C02	45-2-6	Hs~Ref:NM_001381.2~uORF:IOH2343	9207	47	9160
B45R06C03	45-3-6	Hs~Ref:NM_207005.1~uORF:IOH45744	300	39	261
B45R06C04	45-4-6	Hs~Ref:NM_207005.1~uORF:IOH45744	294	49	245
B45R06C05	45-5-6	Hs~Ref:NM_001001713.1~uORF:IOH45822	429	74	355
B45R06C06	45-6-6	Hs~Ref:NM_001001713.1~uORF:IOH45822	74	48	26
B45R06C07	45-7-6	Hs~Ref:NM_033481.2~uORF:IOH45897	575	114	461
B45R06C08	45-8-6	Hs~Ref:NM_033481.2~uORF:IOH45897	187	46	141
B45R06C09	45-9-6	Hs~Ref:NM_007310.1~uORF:IOH45773	374	58	316
B45R06C10	45-10-6	Hs~Ref:NM_007310.1~uORF:IOH45773	353	57	296
B45R06C11	45-11-6	Hs~MGC:BC001801.1~uORF:IOH4461	668	56	612
B45R06C12	45-12-6	Hs~MGC:BC001801.1~uORF:IOH4461	619	50	569
B45R06C13	45-13-6	Hs~Ref:NM_014487.2~uORF:IOH4416	346	47	299
B45R06C14	45-14-6	Hs~Ref:NM_014487.2~uORF:IOH4416	467	50	417
B45R06C15	45-15-6	Hs~MGC:BC000718.1~uORF:IOH4584	505	51	454
B45R06C16	45-16-6	Hs~MGC:BC000718.1~uORF:IOH4584	495	57	438
B45R06C17	45-17-6	Hs~MGC:BC015221.1~uORF:IOH11566	211	68	143
B45R06C18	45-18-6	Hs~MGC:BC015221.1~uORF:IOH11566	217	59	158
B45R06C19	45-19-6	Hs~Ref:NM_006861.2~uORF:IOH10011	150	47	103
B45R06C20	45-20-6	Hs~Ref:NM_006861.2~uORF:IOH10011	273	48	225
B45R06C21	45-21-6	Hs~Ref:NM_021252.2~uORF:IOH10139	277	82	195
B45R06C22	45-22-6	Hs~Ref:NM_021252.2~uORF:IOH10139	166	53	113
B45R07C01	45-1-7	Hs~Ref:NM_016530.1~uORF:IOH12810	280	40	240
B45R07C02	45-2-7	Hs~Ref:NM_016530.1~uORF:IOH12810	428	127	301
B45R07C03	45-3-7	Hs~MGC:BC008950.2~uORF:IOH56909	243	55	188
B45R07C04	45-4-7	Hs~MGC:BC008950.2~uORF:IOH56909	254	113	141
B45R07C05	45-5-7	Hs~Ref:NM_020990.2~uORF:IOH5022	793	77	716
B45R07C06	45-6-7	Hs~Ref:NM_020990.2~uORF:IOH5022	231	52	179
B45R07C07	45-7-7	Hs~MGC:BC007023.1~uORF:IOH7270	576	51	525
B45R07C08	45-8-7	Hs~MGC:BC007023.1~uORF:IOH7270	479	47	432
B45R07C09	45-9-7	Hs~MGC:BC007462.1~uORF:IOH7287	475	50	425
B45R07C10	45-10-7	Hs~MGC:BC007462.1~uORF:IOH7287	185	51	134
B45R07C11	45-11-7	Hs~Ref:NM_006374.2~uORF:IOH6735	805	55	750
B45R07C12	45-12-7	Hs~Ref:NM_006374.2~uORF:IOH6735	794	47	747
B45R07C13	45-13-7	Hs~MGC:BC016645.2~uORF:IOH25785	650	48	602
B45R07C14	45-14-7	Hs~MGC:BC016645.2~uORF:IOH25785	593	49	544
B45R07C15	45-15-7	Hs~MGC:BC022967.1~uORF:IOH11792	487	113	374
B45R07C16	45-16-7	Hs~MGC:BC022967.1~uORF:IOH11792	531	73	458
B45R07C17	45-17-7	Hs~Ref:NM_030770.1~uORF:IOH39634	236	59	177
B45R07C18	45-18-7	Hs~Ref:NM_030770.1~uORF:IOH39634	107	60	47
B45R07C19	45-19-7	Hs~Ref:NM_020444.2~uORF:IOH12012	3921	48	3873
B45R07C20	45-20-7	Hs~Ref:NM_020444.2~uORF:IOH12012	3605	47	3558
B45R07C21	45-21-7	Hs~Ref:NM_001616.2~N/A	1567	51	1516
B45R07C22	45-22-7	Hs~Ref:NM_001616.2~N/A	1554	55	1499
B45R08C01	45-1-8	Hs~Ref:NM_004383.1~N/A	335	240	95
B45R08C02	45-2-8	Hs~Ref:NM_004383.1~N/A	377	233	144
B45R08C03	45-3-8	Hs~Ref:NM_005235.1~N/A	269	51	218
B45R08C04	45-4-8	Hs~Ref:NM_005235.1~N/A	540	50	490
B45R08C05	45-5-8	Hs~Ref:NM_004444.2~N/A	593	52	541
B45R08C06	45-6-8	Hs~Ref:NM_004444.2~N/A	652	48	604
B45R08C07	45-7-8	Hs~MGC:BC011821.1~uORF:IOH14728	421	49	372
B45R08C08	45-8-8	Hs~MGC:BC011821.1~uORF:IOH14728	512	50	462
B45R08C09	45-9-8	Hs~Ref:NM_002677.1~uORF:IOH27101	460	47	413
B45R08C10	45-10-8	Hs~Ref:NM_002677.1~uORF:IOH27101	489	66	423
B45R08C11	45-11-8	Hs~MGC:BC033824.1~uORF:IOH21887	510	178	332
B45R08C12	45-12-8	Hs~MGC:BC033824.1~uORF:IOH21887	239	70	169
B45R08C13	45-13-8	Hs~MGC:BC030767.1~uORF:IOH22043	342	50	292
B45R08C14	45-14-8	Hs~MGC:BC030767.1~uORF:IOH22043	353	49	304
B45R08C15	45-15-8	Hs~Ref:NM_002515.2~uORF:IOH45733	953	48	905
B45R08C16	45-16-8	Hs~Ref:NM_002515.2~uORF:IOH45733	953	53	900
B45R08C17	45-17-8	Hs~Ref:NM_021014.2~uORF:IOH43685	916	56	860
B45R08C18	45-18-8	Hs~Ref:NM_021014.2~uORF:IOH43685	884	59	825
B45R08C19	45-19-8	Hs~Ref:NM_018945.3~uORF:IOH45738	780	58	722
B45R08C20	45-20-8	Hs~Ref:NM_018945.3~uORF:IOH45738	619	54	565
B45R08C21	45-21-8	Hs~MGC:BC028295.1~uORF:IOH25815	498	52	446
B45R08C22	45-22-8	Hs~MGC:BC028295.1~uORF:IOH25815	383	54	329
B45R09C01	45-1-9	Hs~MGC:BC009894.2~uORF:IOH14557	4447	42	4405
B45R09C02	45-2-9	Hs~MGC:BC009894.2~uORF:IOH14557	4653	52	4601
B45R09C03	45-3-9	Hs~MGC:BC031688.1~uORF:IOH22878	242	100	142
B45R09C04	45-4-9	Hs~MGC:BC031688.1~uORF:IOH22878	209	47	162
B45R09C05	45-5-9	Hs~MGC:BC019883.1~uORF:IOH11101	376	65	311
B45R09C06	45-6-9	Hs~MGC:BC019883.1~uORF:IOH11101	280	46	234
B45R09C07	45-7-9	Hs~Ref:NM_000499.2~uORF:IOH10675	313	46	267
B45R09C08	45-8-9	Hs~Ref:NM_000499.2~uORF:IOH10675	165	54	111
B45R09C09	45-9-9	Hs~MGC:BC007693.1~uORF:IOH6315	585	66	519
B45R09C10	45-10-9	Hs~MGC:BC007693.1~uORF:IOH6315	638	81	557
B45R09C11	45-11-9	Hs~MGC:BC001772.1~uORF:IOH4925	1545	241	1304
B45R09C12	45-12-9	Hs~MGC:BC001772.1~uORF:IOH4925	1452	64	1388
B45R09C13	45-13-9	Hs~MGC:BC008790.1~uORF:IOH6239	280	48	232
B45R09C14	45-14-9	Hs~MGC:BC008790.1~uORF:IOH6239	287	46	241
B45R09C15	45-15-9	Hs~MGC:BC005029.1~uORF:IOH6657	320	44	276
B45R09C16	45-16-9	Hs~MGC:BC005029.1~uORF:IOH6657	460	55	405
B45R09C17	45-17-9	Hs~MGC:BC068070.1~uORF:IOH40777	486	54	432
B45R09C18	45-18-9	Hs~MGC:BC068070.1~uORF:IOH40777	474	55	419
B45R09C19	45-19-9	Hs~Ref:NM_004669.2~uORF:IOH46100	239	54	185
B45R09C20	45-20-9	Hs~Ref:NM_004669.2~uORF:IOH46100	369	150	219
B45R09C21	45-21-9	Hs~Ref:NM_005898.4~uORF:IOH46168	2347	56	2291
B45R09C22	45-22-9	Hs~Ref:NM_005898.4~uORF:IOH46168	2302	52	2250
B45R10C01	45-1-10	Hs~MGC:BC022893.1~uORF:IOH46101	1671	42	1629
B45R10C02	45-2-10	Hs~MGC:BC022893.1~uORF:IOH46101	1725	47	1678
B45R10C03	45-3-10	Hs~MGC:BC020596.1~uORF:IOH12740	318	49	269
B45R10C04	45-4-10	Hs~MGC:BC020596.1~uORF:IOH12740	411	132	279
B45R10C05	45-5-10	Hs~MGC:BC062323.1~uORF:IOH40678	357	47	310
B45R10C06	45-6-10	Hs~MGC:BC062323.1~uORF:IOH40678	431	44	387
B45R10C07	45-7-10	Hs~Ref:NM_177938.1~uORF:IOH40630	684	46	638
B45R10C08	45-8-10	Hs~Ref:NM_177938.1~uORF:IOH40630	461	53	408
B45R10C09	45-9-10	Hs~Ref:NM_144679.1~uORF:IOH40679	917	75	842
B45R10C10	45-10-10	Hs~Ref:NM_144679.1~uORF:IOH40679	902	52	850
B45R10C11	45-11-10	GST1	156	47	109
B45R10C12	45-12-10	GST1	48	43	5
B45R10C13	45-13-10	GST2	129	44	85
B45R10C14	45-14-10	GST2	83	42	41
B45R10C15	45-15-10	GST3	53	44	9
B45R10C16	45-16-10	GST3	58	53	5
B45R10C17	45-17-10	GST4	76	49	27
B45R10C18	45-18-10	GST4	163	60	103
B45R10C19	45-19-10	Anti-HumanIgA1~N/A	9929	48	9881
B45R10C20	45-20-10	Anti-HumanIgA1~N/A	9540	47	9493
B45R10C21	45-21-10	Anti-HumanIgA2~N/A	16661	49	16612
B45R10C22	45-22-10	Anti-HumanIgA2~N/A	17463	47	17416
B45R11C01	45-1-11	AlexaAntiMouseAb~N/A	27514	46	27468
B45R11C02	45-2-11	AlexaAntiMouseAb~N/A	29360	45	29315
B45R11C03	45-3-11	MAPKAP~N/A	85	45	40
B45R11C04	45-4-11	MAPKAP~N/A	85	45	40
B45R11C05	45-5-11	Buffer	69	43	26
B45R11C06	45-6-11	Buffer	73	42	31
B45R11C07	45-7-11	BSA~N/A	11294	43	11251
B45R11C08	45-8-11	BSA~N/A	12105	44	12061
B45R11C09	45-9-11	Anti-HumanIgG1~N/A	2062	45	2017
B45R11C10	45-10-11	Anti-HumanIgG1~N/A	2241	47	2194
B45R11C11	45-11-11	Anti-HumanIgG2~N/A	3555	51	3504
B45R11C12	45-12-11	Anti-HumanIgG2~N/A	3696	48	3648
B45R11C13	45-13-11	Anti-HumanIgG3~N/A	5934	44	5890
B45R11C14	45-14-11	Anti-HumanIgG3~N/A	6905	45	6860
B45R11C15	45-15-11	Anti-HumanIgG4~N/A	13183	50	13133
B45R11C16	45-16-11	Anti-HumanIgG4~N/A	13101	51	13050
B45R11C17	45-17-11	AntiBiotinAb~N/A	14687	47	14640
B45R11C18	45-18-11	AntiBiotinAb~N/A	14225	50	14175
B45R11C19	45-19-11	Buffer	48	44	4
B45R11C20	45-20-11	Buffer	65	44	21
B45R11C21	45-21-11	Hs~MGC:BC033529.2~uORF:IOH27634	224	68	156
B45R11C22	45-22-11	Hs~MGC:BC033529.2~uORF:IOH27634	128	47	81
B45R12C01	45-1-12	Hs~MGC:BC053545.1~uORF:IOH28972	921	49	872
B45R12C02	45-2-12	Hs~MGC:BC053545.1~uORF:IOH28972	853	46	807
B45R12C03	45-3-12	Hs~MGC:BC000870.1~uORF:IOH3246	846	58	788
B45R12C04	45-4-12	Hs~MGC:BC000870.1~uORF:IOH3246	118	46	72
B45R12C05	45-5-12	Hs~Ref:NM_057089.1~uORF:IOH4579	281	46	235
B45R12C06	45-6-12	Hs~Ref:NM_057089.1~uORF:IOH4579	270	50	220
B45R12C07	45-7-12	Hs~Ref:NM_006519.1~uORF:IOH23129	381	44	337
B45R12C08	45-8-12	Hs~Ref:NM_006519.1~uORF:IOH23129	384	44	340
B45R12C09	45-9-12	Hs~MGC:BC033710.1~uORF:IOH21756	993	44	949
B45R12C10	45-10-12	Hs~MGC:BC033710.1~uORF:IOH21756	990	47	943
B45R12C11	45-11-12	Hs~MGC:BC010155.2~uORF:IOH12990	1397	54	1343
B45R12C12	45-12-12	Hs~MGC:BC010155.2~uORF:IOH12990	1419	47	1372
B45R12C13	45-13-12	Hs~Ref:NM_015973.1~uORF:IOH21513	427	44	383
B45R12C14	45-14-12	Hs~Ref:NM_015973.1~uORF:IOH21513	429	47	382
B45R12C15	45-15-12	Hs~Ref:NM_001092.3~uORF:IOH39490	1237	47	1190
B45R12C16	45-16-12	Hs~Ref:NM_001092.3~uORF:IOH39490	1252	48	1204
B45R12C17	45-17-12	Hs~Ref:NM_002714.2~uORF:IOH39632	3587	49	3538
B45R12C18	45-18-12	Hs~Ref:NM_002714.2~uORF:IOH39632	4019	53	3966
B45R12C19	45-19-12	Hs~Ref:NM_001002021.1~uORF:IOH6659	788	51	737
B45R12C20	45-20-12	Hs~Ref:NM_001002021.1~uORF:IOH6659	575	44	531
B45R12C21	45-21-12	Hs~Ref:NM_005825.2~uORF:IOH39691	828	49	779
B45R12C22	45-22-12	Hs~Ref:NM_005825.2~uORF:IOH39691	838	47	791
B45R13C01	45-1-13	Hs~Ref:NM_006110.1~uORF:IOH3469	513	50	463
B45R13C02	45-2-13	Hs~Ref:NM_006110.1~uORF:IOH3469	205	54	151
B45R13C03	45-3-13	Hs~MGC:BC007606.1~uORF:IOH6915	336	51	285
B45R13C04	45-4-13	Hs~MGC:BC007606.1~uORF:IOH6915	421	51	370
B45R13C05	45-5-13	Hs~Ref:NM_002044.1~uORF:IOH4633	446	52	394
B45R13C06	45-6-13	Hs~Ref:NM_002044.1~uORF:IOH4633	261	46	215
B45R13C07	45-7-13	Hs~Ref:NM_000269.1~uORF:IOH6979	405	46	359
B45R13C08	45-8-13	Hs~Ref:NM_000269.1~uORF:IOH6979	428	48	380
B45R13C09	45-9-13	Hs~Ref:NM_024104.1~uORF:IOH3754	745	47	698
B45R13C10	45-10-13	Hs~Ref:NM_024104.1~uORF:IOH3754	688	44	644
B45R13C11	45-11-13	Hs~Ref:NM_004710.2~uORF:IOH3613	351	43	308
B45R13C12	45-12-13	Hs~Ref:NM_004710.2~uORF:IOH3613	283	43	240
B45R13C13	45-13-13	Hs~Ref:NM_004060.2~uORF:IOH4393	373	44	329
B45R13C14	45-14-13	Hs~Ref:NM_004060.2~uORF:IOH4393	397	45	352
B45R13C15	45-15-13	Hs~Ref:NM_003021.2~uORF:IOH3498	513	45	468
B45R13C16	45-16-13	Hs~Ref:NM_003021.2~uORF:IOH3498	631	48	583
B45R13C17	45-17-13	Hs~MGC:BC020605.1~uORF:IOH12851	413	210	203
B45R13C18	45-18-13	Hs~MGC:BC020605.1~uORF:IOH12851	261	56	205
B45R13C19	45-19-13	Hs~Ref:NM_054023.2~uORF:IOH12827	258	60	198
B45R13C20	45-20-13	Hs~Ref:NM_054023.2~uORF:IOH12827	242	51	191
B45R13C21	45-21-13	Hs~MGC:BC017969.1~uORF:IOH12941	394	55	339
B45R13C22	45-22-13	Hs~MGC:BC017969.1~uORF:IOH12941	252	49	203
B45R14C01	45-1-14	Hs~MGC:BC012026.1~uORF:IOH10767	647	52	595
B45R14C02	45-2-14	Hs~MGC:BC012026.1~uORF:IOH10767	1479	57	1422
B45R14C03	45-3-14	Hs~Ref:NM_175862.2~uORF:IOH53922	588	53	535
B45R14C04	45-4-14	Hs~Ref:NM_175862.2~uORF:IOH53922	2315	131	2184
B45R14C05	45-5-14	Hs~Ref:NM_001221.2~uORF:IOH54032	440	48	392
B45R14C06	45-6-14	Hs~Ref:NM_001221.2~uORF:IOH54032	465	45	420
B45R14C07	45-7-14	Hs~Ref:NM_003584.1~uORF:IOH53923	412	48	364
B45R14C08	45-8-14	Hs~Ref:NM_003584.1~uORF:IOH53923	479	48	431
B45R14C09	45-9-14	Hs~Ref:NM_007161.2~uORF:IOH58659	285	48	237
B45R14C10	45-10-14	Hs~Ref:NM_007161.2~uORF:IOH58659	319	50	269
B45R14C11	45-11-14	Hs~MGC:BC028954.1~uORF:IOH28639	476	43	433
B45R14C12	45-12-14	Hs~MGC:BC028954.1~uORF:IOH28639	516	46	470
B45R14C13	45-13-14	Hs~MGC:BC009195.2~uORF:IOH12344	325	43	282
B45R14C14	45-14-14	Hs~MGC:BC009195.2~uORF:IOH12344	364	43	321
B45R14C15	45-15-14	Hs~Ref:NM_004936.2~uORF:IOH12785	274	46	228
B45R14C16	45-16-14	Hs~Ref:NM_004936.2~uORF:IOH12785	224	50	174
B45R14C17	45-17-14	Hs~Ref:NM_030952.1~uORF:IOH21129	942	57	885
B45R14C18	45-18-14	Hs~Ref:NM_030952.1~uORF:IOH21129	783	55	728
B45R14C19	45-19-14	Hs~MGC:BC039337.1~uORF:IOH62273	709	55	654
B45R14C20	45-20-14	Hs~MGC:BC039337.1~uORF:IOH62273	643	47	596
B45R14C21	45-21-14	Hs~MGC:BC030025.1~uORF:IOH62095	185	48	137
B45R14C22	45-22-14	Hs~MGC:BC030025.1~uORF:IOH62095	260	61	199
B45R15C01	45-1-15	Hs~MGC:BC036064.1~uORF:IOH62147	134	42	92
B45R15C02	45-2-15	Hs~MGC:BC036064.1~uORF:IOH62147	63	46	17
B45R15C03	45-3-15	Hs~MGC:BC093864.1~uORF:IOH62000	396	49	347
B45R15C04	45-4-15	Hs~MGC:BC093864.1~uORF:IOH62000	353	48	305
B45R15C05	45-5-15	Hs~MGC:BC039317.1~uORF:IOH28723	326	46	280
B45R15C06	45-6-15	Hs~MGC:BC039317.1~uORF:IOH28723	248	44	204
B45R15C07	45-7-15	Hs~MGC:BC033034.2~uORF:IOH28643	356	44	312
B45R15C08	45-8-15	Hs~MGC:BC033034.2~uORF:IOH28643	307	44	263
B45R15C09	45-9-15	Hs~MGC:BC057770.1~uORF:IOH29234	402	58	344
B45R15C10	45-10-15	Hs~MGC:BC057770.1~uORF:IOH29234	327	102	225
B45R15C11	45-11-15	Hs~MGC:BC011776.1~uORF:IOH13876	410	46	364
B45R15C12	45-12-15	Hs~MGC:BC011776.1~uORF:IOH13876	382	44	338
B45R15C13	45-13-15	Hs~IVGN:PM_2135~Ext:VIMENTIN~N/A	412	41	371
B45R15C14	45-14-15	Hs~IVGN:PM_2135~Ext:VIMENTIN~N/A	477	42	435
B45R15C15	45-15-15	Hs~Ref:NM_001259.5~CAT:PV4401	346	61	285
B45R15C16	45-16-15	Hs~Ref:NM_001259.5~CAT:PV4401	342	60	282
B45R15C17	45-17-15	Hs~Ref:NM_001025105.1~CAT:PV3850	1803	47	1756
B45R15C18	45-18-15	Hs~Ref:NM_001025105.1~CAT:PV3850	1914	48	1866
B45R15C19	45-19-15	Hs~Ref:NM_003318.3~CAT:PV3792	343	48	295
B45R15C20	45-20-15	Hs~Ref:NM_003318.3~CAT:PV3792	318	46	272
B45R15C21	45-21-15	Hs~Ref:NM_001031812.2~CAT:PV3838	425	45	380
B45R15C22	45-22-15	Hs~Ref:NM_001031812.2~CAT:PV3838	406	44	362
B45R16C01	45-1-16	Hs~Ref:NM_005157.2~CAT:P3049	1049	46	1003
B45R16C02	45-2-16	Hs~Ref:NM_005157.2~CAT:P3049	915	43	872
B45R16C03	45-3-16	Hs~Ref:NM_000926.2~CAT:P2899	309	47	262
B45R16C04	45-4-16	Hs~Ref:NM_000926.2~CAT:P2899	295	49	246
B45R16C05	45-5-16	Hs~N/A:NM_005228.3~CAT:PV4803	438	45	393
B45R16C06	45-6-16	Hs~N/A:NM_005228.3~CAT:PV4803	407	43	364
B45R16C07	45-7-16	Hs~MGC:BC048970.1~uORF:IOH26893	904	43	861
B45R16C08	45-8-16	Hs~MGC:BC048970.1~uORF:IOH26893	874	45	829
B45R16C09	45-9-16	Hs~MGC:BC036908.1~uORF:IOH28734	859	46	813
B45R16C10	45-10-16	Hs~MGC:BC036908.1~uORF:IOH28734	948	46	902
B45R16C11	45-11-16	Hs~MGC:BC038241.1~uORF:IOH28735	483	45	438
B45R16C12	45-12-16	Hs~MGC:BC038241.1~uORF:IOH28735	446	45	401
B45R16C13	45-13-16	Hs~MGC:BC050538.1~uORF:IOH26922	558	44	514
B45R16C14	45-14-16	Hs~MGC:BC050538.1~uORF:IOH26922	532	46	486
B45R16C15	45-15-16	Hs~Ref:NM_003277.1~uORF:IOH3589	289	63	226
B45R16C16	45-16-16	Hs~Ref:NM_003277.1~uORF:IOH3589	103	48	55
B45R16C17	45-17-16	Hs~Ref:NM_001004.2~uORF:IOH6844	73	48	25
B45R16C18	45-18-16	Hs~Ref:NM_001004.2~uORF:IOH6844	75	49	26
B45R16C19	45-19-16	Hs~MGC:BC057772.1~uORF:IOH29154	450	49	401
B45R16C20	45-20-16	Hs~MGC:BC057772.1~uORF:IOH29154	291	48	243
B45R16C21	45-21-16	Hs~MGC:BC035875.2~uORF:IOH28741	515	46	469
B45R16C22	45-22-16	Hs~MGC:BC035875.2~uORF:IOH28741	514	45	469
B45R17C01	45-1-17	Hs~MGC:BC066256.1~uORF:IOH61852	419	66	353
B45R17C02	45-2-17	Hs~MGC:BC066256.1~uORF:IOH61852	790	99	691
B45R17C03	45-3-17	Hs~MGC:BC053371.1~uORF:IOH62445	668	58	610
B45R17C04	45-4-17	Hs~MGC:BC053371.1~uORF:IOH62445	307	49	258
B45R17C05	45-5-17	Hs~MGC:BC068518.1~uORF:IOH61668	334	47	287
B45R17C06	45-6-17	Hs~MGC:BC068518.1~uORF:IOH61668	162	66	96
B45R17C07	45-7-17	Hs~Ref:NM_001040633.1~uORF:IOH61663	325	49	276
B45R17C08	45-8-17	Hs~Ref:NM_001040633.1~uORF:IOH61663	382	52	330
B45R17C09	45-9-17	Hs~Ref:NM_016050.1~uORF:IOH4903	508	50	458
B45R17C10	45-10-17	Hs~Ref:NM_016050.1~uORF:IOH4903	507	49	458
B45R17C11	45-11-17	Hs~MGC:BC029388.1~uORF:IOH23167	641	46	595
B45R17C12	45-12-17	Hs~MGC:BC029388.1~uORF:IOH23167	600	47	553
B45R17C13	45-13-17	Hs~Ref:NM_000345.2~uORF:IOH14008	264	47	217
B45R17C14	45-14-17	Hs~Ref:NM_000345.2~uORF:IOH14008	313	54	259
B45R17C15	45-15-17	Hs~Ref:NM_013242.1~uORF:IOH5166	2161	50	2111
B45R17C16	45-16-17	Hs~Ref:NM_013242.1~uORF:IOH5166	2128	47	2081
B45R17C17	45-17-17	Hs~Ref:NM_014667.1~uORF:IOH29305	1367	48	1319
B45R17C18	45-18-17	Hs~Ref:NM_014667.1~uORF:IOH29305	1442	50	1392
B45R17C19	45-19-17	Hs~MGC:BC040173.1~uORF:IOH27622	332	67	265
B45R17C20	45-20-17	Hs~MGC:BC040173.1~uORF:IOH27622	200	58	142
B45R17C21	45-21-17	Hs~MGC:BC047765.1~uORF:IOH26665	245	50	195
B45R17C22	45-22-17	Hs~MGC:BC047765.1~uORF:IOH26665	154	47	107
B45R18C01	45-1-18	Hs~MGC:BC021987.2~uORF:IOH27886	359	50	309
B45R18C02	45-2-18	Hs~MGC:BC021987.2~uORF:IOH27886	713	54	659
B45R18C03	45-3-18	Hs~Ref:NM_030810.1~uORF:IOH4474	467	69	398
B45R18C04	45-4-18	Hs~Ref:NM_030810.1~uORF:IOH4474	343	61	282
B45R18C05	45-5-18	Hs~Ref:NM_016286.1~uORF:IOH4017	246	52	194
B45R18C06	45-6-18	Hs~Ref:NM_016286.1~uORF:IOH4017	299	56	243
B45R18C07	45-7-18	Hs~Ref:NM_007108.1~uORF:IOH14150	382	55	327
B45R18C08	45-8-18	Hs~Ref:NM_007108.1~uORF:IOH14150	254	65	189
B45R18C09	45-9-18	Hs~MGC:BC000190.1~uORF:IOH4410	561	51	510
B45R18C10	45-10-18	Hs~MGC:BC000190.1~uORF:IOH4410	689	125	564
B45R18C11	45-11-18	Hs~MGC:BC045640.1~uORF:IOH25879	398	49	349
B45R18C12	45-12-18	Hs~MGC:BC045640.1~uORF:IOH25879	318	104	214
B45R18C13	45-13-18	Hs~Ref:NM_178493.3~uORF:IOH29141	159	41	118
B45R18C14	45-14-18	Hs~Ref:NM_178493.3~uORF:IOH29141	351	49	302
B45R18C15	45-15-18	Hs~MGC:BC041132.1~uORF:IOH26140	928	46	882
B45R18C16	45-16-18	Hs~MGC:BC041132.1~uORF:IOH26140	890	46	844
B45R18C17	45-17-18	Hs~MGC:BC039583.2~uORF:IOH28773	213	56	157
B45R18C18	45-18-18	Hs~MGC:BC039583.2~uORF:IOH28773	196	50	146
B45R18C19	45-19-18	Hs~Ref:NM_182571.2~uORF:IOH57364	887	55	832
B45R18C20	45-20-18	Hs~Ref:NM_182571.2~uORF:IOH57364	819	63	756
B45R18C21	45-21-18	Hs~Ref:NM_052838.2~uORF:IOH12732	396	66	330
B45R18C22	45-22-18	Hs~Ref:NM_052838.2~uORF:IOH12732	419	61	358
B45R19C01	45-1-19	Hs~MGC:BC007014.1~uORF:IOH7141	429	68	361
B45R19C02	45-2-19	Hs~MGC:BC007014.1~uORF:IOH7141	396	148	248
B45R19C03	45-3-19	Hs~MGC:BC008902.2~uORF:IOH7022	767	44	723
B45R19C04	45-4-19	Hs~MGC:BC008902.2~uORF:IOH7022	46	48	-2
B45R19C05	45-5-19	Hs~Ref:NM_021123.1~uORF:IOH27363	358	48	310
B45R19C06	45-6-19	Hs~Ref:NM_021123.1~uORF:IOH27363	462	57	405
B45R19C07	45-7-19	Hs~MGC:BC010124.2~uORF:IOH22972	283	56	227
B45R19C08	45-8-19	Hs~MGC:BC010124.2~uORF:IOH22972	278	58	220
B45R19C09	45-9-19	Hs~MGC:BC032101.1~uORF:IOH22993	494	49	445
B45R19C10	45-10-19	Hs~MGC:BC032101.1~uORF:IOH22993	339	45	294
B45R19C11	45-11-19	Hs~MGC:NM_152614.1~uORF:IOH22756	525	55	470
B45R19C12	45-12-19	Hs~MGC:NM_152614.1~uORF:IOH22756	403	44	359
B45R19C13	45-13-19	Hs~MGC:BC034222.1~uORF:IOH21594	42	41	1
B45R19C14	45-14-19	Hs~MGC:BC034222.1~uORF:IOH21594	42	42	0
B45R19C15	45-15-19	Hs~Ref:NM_177924.1~uORF:IOH21469	410	57	353
B45R19C16	45-16-19	Hs~Ref:NM_177924.1~uORF:IOH21469	168	55	113
B45R19C17	45-17-19	Hs~Ref:NM_016588.2~uORF:IOH5242	549	64	485
B45R19C18	45-18-19	Hs~Ref:NM_016588.2~uORF:IOH5242	407	53	354
B45R19C19	45-19-19	Hs~MGC:BC013878.2~uORF:IOH27784	371	75	296
B45R19C20	45-20-19	Hs~MGC:BC013878.2~uORF:IOH27784	341	159	182
B45R19C21	45-21-19	Hs~MGC:BC053509.1~uORF:IOH29394	64	59	5
B45R19C22	45-22-19	Hs~MGC:BC053509.1~uORF:IOH29394	791	52	739
B45R20C01	45-1-20	Hs~MGC:BC000878.1~uORF:IOH3267	573	274	299
B45R20C02	45-2-20	Hs~MGC:BC000878.1~uORF:IOH3267	335	86	249
B45R20C03	45-3-20	Hs~Ref:NM_000262.1~uORF:IOH4589	1203	56	1147
B45R20C04	45-4-20	Hs~Ref:NM_000262.1~uORF:IOH4589	1065	49	1016
B45R20C05	45-5-20	Hs~Ref:NM_024314.1~uORF:IOH5409	1449	49	1400
B45R20C06	45-6-20	Hs~Ref:NM_024314.1~uORF:IOH5409	1417	49	1368
B45R20C07	45-7-20	Hs~Ref:NM_145050.1~uORF:IOH12883	41	44	-3
B45R20C08	45-8-20	Hs~Ref:NM_145050.1~uORF:IOH12883	41	44	-3
B45R20C09	45-9-20	Hs~MGC:NM_032550.1~uORF:IOH10814	403	48	355
B45R20C10	45-10-20	Hs~MGC:NM_032550.1~uORF:IOH10814	342	44	298
B45R20C11	45-11-20	Hs~MGC:BC016755.1~uORF:IOH12873	431	48	383
B45R20C12	45-12-20	Hs~MGC:BC016755.1~uORF:IOH12873	305	60	245
B45R20C13	45-13-20	Hs~Ref:NM_003115.2~uORF:IOH13054	432	44	388
B45R20C14	45-14-20	Hs~Ref:NM_003115.2~uORF:IOH13054	426	44	382
B45R20C15	45-15-20	Hs~MGC:BC017387.1~uORF:IOH13923	456	54	402
B45R20C16	45-16-20	Hs~MGC:BC017387.1~uORF:IOH13923	243	58	185
B45R20C17	45-17-20	Hs~Ref:NM_057161.2~uORF:IOH2157	170	59	111
B45R20C18	45-18-20	Hs~Ref:NM_057161.2~uORF:IOH2157	151	54	97
B45R20C19	45-19-20	Hs~MGC:BC010954.1~uORF:IOH13677	391	146	245
B45R20C20	45-20-20	Hs~MGC:BC010954.1~uORF:IOH13677	263	52	211
B45R20C21	45-21-20	Hs~Ref:NM_145304.1~uORF:IOH12701	210	73	137
B45R20C22	45-22-20	Hs~Ref:NM_145304.1~uORF:IOH12701	262	60	202
B45R21C01	45-1-21	Hs~MGC:BC060845.1~uORF:IOH29194	588	45	543
B45R21C02	45-2-21	Hs~MGC:BC060845.1~uORF:IOH29194	642	47	595
B45R21C03	45-3-21	Hs~MGC:BC059387.1~uORF:IOH29181	226	51	175
B45R21C04	45-4-21	Hs~MGC:BC059387.1~uORF:IOH29181	384	76	308
B45R21C05	45-5-21	Hs~MGC:BC009371.1~uORF:IOH13210	497	137	360
B45R21C06	45-6-21	Hs~MGC:BC009371.1~uORF:IOH13210	261	55	206
B45R21C07	45-7-21	Hs~Ref:NM_002233.1~uORF:IOH29649	297	48	249
B45R21C08	45-8-21	Hs~Ref:NM_002233.1~uORF:IOH29649	258	46	212
B45R21C09	45-9-21	Hs~Ref:CAD91166~CAT_10314-H08H-25	40	44	-4
B45R21C10	45-10-21	Hs~Ref:CAD91166~CAT_10314-H08H-25	243	42	201
B45R21C11	45-11-21	Internal_1007209	59	46	13
B45R21C12	45-12-21	Internal_1007209	60	48	12
B45R21C13	45-13-21	Hs~Ref:NP_001138.1~CAT_10691-H08H-25	39	43	-4
B45R21C14	45-14-21	Hs~Ref:NP_001138.1~CAT_10691-H08H-25	43	42	1
B45R21C15	45-15-21	Internal_1007209	46	44	2
B45R21C16	45-16-21	Internal_1007209	43	46	-3
B45R21C17	45-17-21	Hs~Ref:NP_001019799.1~CAT_10011-H02H-25	42	46	-4
B45R21C18	45-18-21	Hs~Ref:NP_001019799.1~CAT_10011-H02H-25	92	43	49
B45R21C19	45-19-21	Internal_1007209	51	43	8
B45R21C20	45-20-21	Internal_1007209	142	47	95
B45R21C21	45-21-21	Hs~IVGN:anti-hu-IgE~CAT_AHI0501~N/A	211	48	163
B45R21C22	45-22-21	Hs~IVGN:anti-hu-IgE~CAT_AHI0501~N/A	205	46	159
B45R22C01	45-1-22	ERa~N/A	1625	43	1582
B45R22C02	45-2-22	ERa~N/A	1672	44	1628
B45R22C03	45-3-22	PKCeta~N/A	437	46	391
B45R22C04	45-4-22	PKCeta~N/A	463	48	415
B45R22C05	45-5-22	Calmodulin~N/A	126	51	75
B45R22C06	45-6-22	Calmodulin~N/A	959	61	898
B45R22C07	45-7-22	V5control5~N/A	1106	45	1061
B45R22C08	45-8-22	V5control5~N/A	937	45	892
B45R22C09	45-9-22	V5control4~N/A	305	46	259
B45R22C10	45-10-22	V5control4~N/A	53	50	3
B45R22C11	45-11-22	V5control3~N/A	312	66	246
B45R22C12	45-12-22	V5control3~N/A	145	56	89
B45R22C13	45-13-22	V5control2~N/A	65	49	16
B45R22C14	45-14-22	V5control2~N/A	68	45	23
B45R22C15	45-15-22	V5control1~N/A	54	44	10
B45R22C16	45-16-22	V5control1~N/A	48	50	-2
B45R22C17	45-17-22	CMK2A~N/A	354	61	293
B45R22C18	45-18-22	CMK2A~N/A	285	43	242
B45R22C19	45-19-22	ERa~N/A	1858	43	1815
B45R22C20	45-20-22	ERa~N/A	1929	46	1883
B45R22C21	45-21-22	AlexaAntiMouseAb~N/A	10481	45	10436
B45R22C22	45-22-22	AlexaAntiMouseAb~N/A	10553	44	10509
B46R01C01	46-1-1	AlexaAntiMouseAb~N/A	38246	54	38192
B46R01C02	46-2-1	AlexaAntiMouseAb~N/A	36317	53	36264
B46R01C03	46-3-1	ERa~N/A	1950	45	1905
B46R01C04	46-4-1	ERa~N/A	1994	45	1949
B46R01C05	46-5-1	HumanIgG1~N/A	1227	48	1179
B46R01C06	46-6-1	HumanIgG1~N/A	1257	58	1199
B46R01C07	46-7-1	HumanIgG2~N/A	3809	55	3754
B46R01C08	46-8-1	HumanIgG2~N/A	3878	47	3831
B46R01C09	46-9-1	HumanIgG3~N/A	16237	48	16189
B46R01C10	46-10-1	HumanIgG3~N/A	16556	50	16506
B46R01C11	46-11-1	HumanIgG4~N/A	51012	63	50949
B46R01C12	46-12-1	HumanIgG4~N/A	48659	53	48606
B46R01C13	46-13-1	BiotinAb~N/A	394	47	347
B46R01C14	46-14-1	BiotinAb~N/A	337	51	286
B46R01C15	46-15-1	RanBP2deltaFG~N/A	574	56	518
B46R01C16	46-16-1	RanBP2deltaFG~N/A	557	53	504
B46R01C17	46-17-1	hMDM2~N/A	750	49	701
B46R01C18	46-18-1	hMDM2~N/A	762	49	713
B46R01C19	46-19-1	PKCeta~N/A	716	42	674
B46R01C20	46-20-1	PKCeta~N/A	794	41	753
B46R01C21	46-21-1	AlexaAntiMouseAb~N/A	31901	42	31859
B46R01C22	46-22-1	AlexaAntiMouseAb~N/A	33241	42	33199
B46R02C01	46-1-2	PKCeta~N/A	1181	47	1134
B46R02C02	46-2-2	PKCeta~N/A	1210	46	1164
B46R02C03	46-3-2	Buffer	708	44	664
B46R02C04	46-4-2	Buffer	681	43	638
B46R02C05	46-5-2	HumanIgA~N/A	28241	48	28193
B46R02C06	46-6-2	HumanIgA~N/A	25881	54	25827
B46R02C07	46-7-2	Buffer	241	66	175
B46R02C08	46-8-2	Buffer	261	194	67
B46R02C09	46-9-2	BSA~N/A	13210	48	13162
B46R02C10	46-10-2	BSA~N/A	12691	53	12638
B46R02C11	46-11-2	Hs~MGC:BC000440.1~uORF:IOH3468	720	124	596
B46R02C12	46-12-2	Hs~MGC:BC000440.1~uORF:IOH3468	545	71	474
B46R02C13	46-13-2	Hs~Ref:NM_006325.2~uORF:IOH10063	1088	52	1036
B46R02C14	46-14-2	Hs~Ref:NM_006325.2~uORF:IOH10063	998	55	943
B46R02C15	46-15-2	Hs~MGC:BC057760.1~uORF:IOH29220	1127	71	1056
B46R02C16	46-16-2	Hs~MGC:BC057760.1~uORF:IOH29220	1148	65	1083
B46R02C17	46-17-2	Hs~Ref:NM_023942.1~uORF:IOH4176	459	65	394
B46R02C18	46-18-2	Hs~Ref:NM_023942.1~uORF:IOH4176	492	61	431
B46R02C19	46-19-2	Hs~MGC:BC020637.1~uORF:IOH12160	2257	48	2209
B46R02C20	46-20-2	Hs~MGC:BC020637.1~uORF:IOH12160	2113	45	2068
B46R02C21	46-21-2	Hs~MGC:BC020838.1~uORF:IOH13454	395	46	349
B46R02C22	46-22-2	Hs~MGC:BC020838.1~uORF:IOH13454	323	44	279
B46R03C01	46-1-3	Hs~Ref:NM_001306.2~uORF:IOH13619	395	53	342
B46R03C02	46-2-3	Hs~Ref:NM_001306.2~uORF:IOH13619	388	49	339
B46R03C03	46-3-3	Hs~MGC:BC029224.1~uORF:IOH22788	377	47	330
B46R03C04	46-4-3	Hs~MGC:BC029224.1~uORF:IOH22788	372	49	323
B46R03C05	46-5-3	Hs~Ref:NM_181618.1~uORF:IOH40951	572	53	519
B46R03C06	46-6-3	Hs~Ref:NM_181618.1~uORF:IOH40951	239	53	186
B46R03C07	46-7-3	Hs~Ref:NM_022568.2~uORF:IOH41048	320	72	248
B46R03C08	46-8-3	Hs~Ref:NM_022568.2~uORF:IOH41048	400	214	186
B46R03C09	46-9-3	Hs~Ref:NM_024966.2~uORF:IOH35829	139	47	92
B46R03C10	46-10-3	Hs~Ref:NM_024966.2~uORF:IOH35829	133	46	87
B46R03C11	46-11-3	Hs~Ref:NM_020465.2~uORF:IOH40985	4447	79	4368
B46R03C12	46-12-3	Hs~Ref:NM_020465.2~uORF:IOH40985	4234	82	4152
B46R03C13	46-13-3	Hs~Ref:NM_002477.1~uORF:IOH44370	242	110	132
B46R03C14	46-14-3	Hs~Ref:NM_002477.1~uORF:IOH44370	313	75	238
B46R03C15	46-15-3	Hs~Ref:NM_001002232.1~uORF:IOH45883	546	228	318
B46R03C16	46-16-3	Hs~Ref:NM_001002232.1~uORF:IOH45883	253	109	144
B46R03C17	46-17-3	Hs~Ref:NM_004113.3~uORF:IOH34727	1535	64	1471
B46R03C18	46-18-3	Hs~Ref:NM_004113.3~uORF:IOH34727	1548	50	1498
B46R03C19	46-19-3	Hs~Ref:XM_378988.2~uORF:IOH41598	373	46	327
B46R03C20	46-20-3	Hs~Ref:XM_378988.2~uORF:IOH41598	502	50	452
B46R03C21	46-21-3	Hs~Ref:NM_052877.1~uORF:IOH10269	411	45	366
B46R03C22	46-22-3	Hs~Ref:NM_052877.1~uORF:IOH10269	411	42	369
B46R04C01	46-1-4	Hs~MGC:BC010555.1~uORF:IOH10297	328	53	275
B46R04C02	46-2-4	Hs~MGC:BC010555.1~uORF:IOH10297	416	58	358
B46R04C03	46-3-4	Hs~Ref:NM_031910.2~uORF:IOH10302	663	68	595
B46R04C04	46-4-4	Hs~Ref:NM_031910.2~uORF:IOH10302	625	69	556
B46R04C05	46-5-4	Hs~Ref:NM_006978.1~uORF:IOH10306	300	80	220
B46R04C06	46-6-4	Hs~Ref:NM_006978.1~uORF:IOH10306	295	67	228
B46R04C07	46-7-4	Hs~MGC:BC014991.1~uORF:IOH12177	65535	67	65468
B46R04C08	46-8-4	Hs~MGC:BC014991.1~uORF:IOH12177	65535	64	65471
B46R04C09	46-9-4	Hs~Ref:NM_033416.1~uORF:IOH12991	606	61	545
B46R04C10	46-10-4	Hs~Ref:NM_033416.1~uORF:IOH12991	580	52	528
B46R04C11	46-11-4	Hs~Ref:NM_013328.2~uORF:IOH11728	395	64	331
B46R04C12	46-12-4	Hs~Ref:NM_013328.2~uORF:IOH11728	319	65	254
B46R04C13	46-13-4	Hs~MGC:BC004271.1~uORF:IOH5483	426	51	375
B46R04C14	46-14-4	Hs~MGC:BC004271.1~uORF:IOH5483	474	57	417
B46R04C15	46-15-4	Hs~Ref:NM_172070.2~uORF:IOH38243	666	487	179
B46R04C16	46-16-4	Hs~Ref:NM_172070.2~uORF:IOH38243	1067	376	691
B46R04C17	46-17-4	Hs~MGC:BC040339.1~uORF:IOH25738	166	62	104
B46R04C18	46-18-4	Hs~MGC:BC040339.1~uORF:IOH25738	248	44	204
B46R04C19	46-19-4	Hs~Ref:NM_080600.1~uORF:IOH38014	555	47	508
B46R04C20	46-20-4	Hs~Ref:NM_080600.1~uORF:IOH38014	635	55	580
B46R04C21	46-21-4	Hs~Ref:NM_004912.3~uORF:IOH38232	3330	49	3281
B46R04C22	46-22-4	Hs~Ref:NM_004912.3~uORF:IOH38232	3780	42	3738
B46R05C01	46-1-5	Hs~Ref:NM_015959.1~uORF:IOH4346	670	50	620
B46R05C02	46-2-5	Hs~Ref:NM_015959.1~uORF:IOH4346	620	57	563
B46R05C03	46-3-5	Hs~Ref:NM_006439.3~uORF:IOH12221	1399	79	1320
B46R05C04	46-4-5	Hs~Ref:NM_006439.3~uORF:IOH12221	1463	75	1388
B46R05C05	46-5-5	Hs~Ref:NM_001157.2~uORF:IOH6821	552	61	491
B46R05C06	46-6-5	Hs~Ref:NM_001157.2~uORF:IOH6821	624	60	564
B46R05C07	46-7-5	Hs~MGC:BC012895.1~uORF:IOH9632	94	55	39
B46R05C08	46-8-5	Hs~MGC:BC012895.1~uORF:IOH9632	94	54	40
B46R05C09	46-9-5	Hs~Ref:NM_003942.1~N/A	532	57	475
B46R05C10	46-10-5	Hs~Ref:NM_003942.1~N/A	679	75	604
B46R05C11	46-11-5	Hs~Ref:NM_020421.1~N/A	518	130	388
B46R05C12	46-12-5	Hs~Ref:NM_020421.1~N/A	418	61	357
B46R05C13	46-13-5	Hs~Ref:NM_002314.2~N/A	308	53	255
B46R05C14	46-14-5	Hs~Ref:NM_002314.2~N/A	418	57	361
B46R05C15	46-15-5	Hs~Ref:NM_002741.1~N/A	378	243	135
B46R05C16	46-16-5	Hs~Ref:NM_002741.1~N/A	160	59	101
B46R05C17	46-17-5	Hs~MGC:BC069328.1~uORF:IOH40255	294	112	182
B46R05C18	46-18-5	Hs~MGC:BC069328.1~uORF:IOH40255	184	110	74
B46R05C19	46-19-5	Hs~Ref:NM_025029.2~uORF:IOH40105	372	68	304
B46R05C20	46-20-5	Hs~Ref:NM_025029.2~uORF:IOH40105	498	60	438
B46R05C21	46-21-5	Hs~MGC:BC067445.1~uORF:IOH40160	778	54	724
B46R05C22	46-22-5	Hs~MGC:BC067445.1~uORF:IOH40160	683	45	638
B46R06C01	46-1-6	Hs~Ref:NM_004527.2~uORF:IOH40231	35687	52	35635
B46R06C02	46-2-6	Hs~Ref:NM_004527.2~uORF:IOH40231	32606	52	32554
B46R06C03	46-3-6	Hs~MGC:BC015732.1~uORF:IOH13370	533	58	475
B46R06C04	46-4-6	Hs~MGC:BC015732.1~uORF:IOH13370	562	67	495
B46R06C05	46-5-6	Hs~Ref:NM_145280.1~uORF:IOH21779	724	56	668
B46R06C06	46-6-6	Hs~Ref:NM_145280.1~uORF:IOH21779	809	53	756
B46R06C07	46-7-6	Hs~Ref:NM_080387.1~uORF:IOH21717	662	54	608
B46R06C08	46-8-6	Hs~Ref:NM_080387.1~uORF:IOH21717	688	50	638
B46R06C09	46-9-6	Hs~Ref:NM_013290.1~uORF:IOH6212	774	76	698
B46R06C10	46-10-6	Hs~Ref:NM_013290.1~uORF:IOH6212	707	477	230
B46R06C11	46-11-6	Hs~Ref:NM_002133.1~uORF:IOH54938	402	127	275
B46R06C12	46-12-6	Hs~Ref:NM_002133.1~uORF:IOH54938	425	308	117
B46R06C13	46-13-6	Hs~Ref:NM_004092.2~uORF:IOH54943	799	60	739
B46R06C14	46-14-6	Hs~Ref:NM_004092.2~uORF:IOH54943	762	51	711
B46R06C15	46-15-6	Hs~Ref:NM_003011.1~uORF:IOH59459	196	48	148
B46R06C16	46-16-6	Hs~Ref:NM_003011.1~uORF:IOH59459	183	98	85
B46R06C17	46-17-6	Hs~Ref:NM_145014.1~uORF:IOH59272	452	94	358
B46R06C18	46-18-6	Hs~Ref:NM_145014.1~uORF:IOH59272	394	63	331
B46R06C19	46-19-6	Hs~MGC:BC016730.1~uORF:IOH27890	647	57	590
B46R06C20	46-20-6	Hs~MGC:BC016730.1~uORF:IOH27890	653	248	405
B46R06C21	46-21-6	Hs~MGC:BC050328.1~uORF:IOH26426	1032	58	974
B46R06C22	46-22-6	Hs~MGC:BC050328.1~uORF:IOH26426	822	46	776
B46R07C01	46-1-7	Hs~MGC:BC031073.1~uORF:IOH22537	399	61	338
B46R07C02	46-2-7	Hs~MGC:BC031073.1~uORF:IOH22537	420	60	360
B46R07C03	46-3-7	Hs~MGC:BC048107.1~uORF:IOH26749	431	54	377
B46R07C04	46-4-7	Hs~MGC:BC048107.1~uORF:IOH26749	457	167	290
B46R07C05	46-5-7	Hs~MGC:BC003096.1~uORF:IOH4534	515	55	460
B46R07C06	46-6-7	Hs~MGC:BC003096.1~uORF:IOH4534	514	54	460
B46R07C07	46-7-7	Hs~MGC:BC016821.1~uORF:IOH23009	720	50	670
B46R07C08	46-8-7	Hs~MGC:BC016821.1~uORF:IOH23009	687	51	636
B46R07C09	46-9-7	Hs~MGC:BC001375.1~uORF:IOH3976	788	70	718
B46R07C10	46-10-7	Hs~MGC:BC001375.1~uORF:IOH3976	825	84	741
B46R07C11	46-11-7	Hs~MGC:BC022816.1~uORF:IOH14672	1728	135	1593
B46R07C12	46-12-7	Hs~MGC:BC022816.1~uORF:IOH14672	1686	133	1553
B46R07C13	46-13-7	Hs~Ref:NM_000906.1~N/A	577	57	520
B46R07C14	46-14-7	Hs~Ref:NM_000906.1~N/A	480	50	430
B46R07C15	46-15-7	Hs~Ref:NM_004333.1~N/A	585	47	538
B46R07C16	46-16-7	Hs~Ref:NM_004333.1~N/A	571	50	521
B46R07C17	46-17-7	Hs~Ref:NM_004734.1~N/A	1351	53	1298
B46R07C18	46-18-7	Hs~Ref:NM_004734.1~N/A	1273	54	1219
B46R07C19	46-19-7	Hs~Ref:NM_001569.2~N/A	488	47	441
B46R07C20	46-20-7	Hs~Ref:NM_001569.2~N/A	465	53	412
B46R07C21	46-21-7	Hs~MGC:BC014271.2~uORF:IOH13908	14434	49	14385
B46R07C22	46-22-7	Hs~MGC:BC014271.2~uORF:IOH13908	13626	44	13582
B46R08C01	46-1-8	Hs~MGC:BC009993.2~uORF:IOH27830	1213	54	1159
B46R08C02	46-2-8	Hs~MGC:BC009993.2~uORF:IOH27830	1159	50	1109
B46R08C03	46-3-8	Hs~Ref:NM_005159.3~uORF:IOH14126	437	55	382
B46R08C04	46-4-8	Hs~Ref:NM_005159.3~uORF:IOH14126	346	59	287
B46R08C05	46-5-8	Hs~Ref:NM_006442.2~uORF:IOH14520	731	59	672
B46R08C06	46-6-8	Hs~Ref:NM_006442.2~uORF:IOH14520	726	60	666
B46R08C07	46-7-8	Hs~Ref:NM_019601.3~uORF:IOH23286	327	153	174
B46R08C08	46-8-8	Hs~Ref:NM_019601.3~uORF:IOH23286	327	87	240
B46R08C09	46-9-8	Hs~Ref:NM_006480.4~uORF:IOH13081	362	50	312
B46R08C10	46-10-8	Hs~Ref:NM_006480.4~uORF:IOH13081	434	267	167
B46R08C11	46-11-8	Hs~Ref:NM_003335.2~uORF:IOH6479	410	73	337
B46R08C12	46-12-8	Hs~Ref:NM_003335.2~uORF:IOH6479	475	275	200
B46R08C13	46-13-8	Hs~Ref:NM_003321.3~uORF:IOH4865	688	57	631
B46R08C14	46-14-8	Hs~Ref:NM_003321.3~uORF:IOH4865	696	50	646
B46R08C15	46-15-8	Hs~Ref:NM_003633.1~uORF:IOH3669	386	49	337
B46R08C16	46-16-8	Hs~Ref:NM_003633.1~uORF:IOH3669	434	52	382
B46R08C17	46-17-8	Hs~Ref:NM_004401.1~uORF:IOH4671	160	55	105
B46R08C18	46-18-8	Hs~Ref:NM_004401.1~uORF:IOH4671	186	125	61
B46R08C19	46-19-8	Hs~MGC:BC037779.2~uORF:IOH27741	600	47	553
B46R08C20	46-20-8	Hs~MGC:BC037779.2~uORF:IOH27741	607	48	559
B46R08C21	46-21-8	Hs~Ref:NM_004117.2~uORF:IOH27424	563	46	517
B46R08C22	46-22-8	Hs~Ref:NM_004117.2~uORF:IOH27424	529	44	485
B46R09C01	46-1-9	Hs~Ref:NM_014478.3~uORF:IOH59924	770	46	724
B46R09C02	46-2-9	Hs~Ref:NM_014478.3~uORF:IOH59924	770	44	726
B46R09C03	46-3-9	Hs~Ref:NM_002416.1~uORF:IOH57247	356	46	310
B46R09C04	46-4-9	Hs~Ref:NM_002416.1~uORF:IOH57247	489	52	437
B46R09C05	46-5-9	Hs~Ref:NM_181893.1~uORF:IOH59929	324	64	260
B46R09C06	46-6-9	Hs~Ref:NM_181893.1~uORF:IOH59929	349	286	63
B46R09C07	46-7-9	Hs~MGC:BC035017.2~uORF:IOH28642	497	51	446
B46R09C08	46-8-9	Hs~MGC:BC035017.2~uORF:IOH28642	434	46	388
B46R09C09	46-9-9	Hs~MGC:BC008964.2~uORF:IOH56888	795	59	736
B46R09C10	46-10-9	Hs~MGC:BC008964.2~uORF:IOH56888	236	65	171
B46R09C11	46-11-9	Hs~Ref:NM_001937.3~uORF:IOH53854	134	61	73
B46R09C12	46-12-9	Hs~Ref:NM_001937.3~uORF:IOH53854	787	65	722
B46R09C13	46-13-9	Hs~Ref:NM_182729.1~uORF:IOH52112	583	49	534
B46R09C14	46-14-9	Hs~Ref:NM_182729.1~uORF:IOH52112	547	45	502
B46R09C15	46-15-9	Hs~Ref:NM_006294.2~uORF:IOH57049	615	49	566
B46R09C16	46-16-9	Hs~Ref:NM_006294.2~uORF:IOH57049	520	50	470
B46R09C17	46-17-9	Hs~Ref:NM_033316.2~uORF:IOH6835	529	45	484
B46R09C18	46-18-9	Hs~Ref:NM_033316.2~uORF:IOH6835	533	46	487
B46R09C19	46-19-9	Hs~Ref:NM_022483.2~uORF:IOH13312	148	46	102
B46R09C20	46-20-9	Hs~Ref:NM_022483.2~uORF:IOH13312	419	63	356
B46R09C21	46-21-9	Hs~MGC:BC000953.2~uORF:IOH3022	621	54	567
B46R09C22	46-22-9	Hs~MGC:BC000953.2~uORF:IOH3022	750	79	671
B46R10C01	46-1-10	Hs~Ref:NM_014702.1~uORF:IOH21412	627	46	581
B46R10C02	46-2-10	Hs~Ref:NM_014702.1~uORF:IOH21412	659	47	612
B46R10C03	46-3-10	Hs~Ref:NM_000442.2~uORF:IOH10695	609	47	562
B46R10C04	46-4-10	Hs~Ref:NM_000442.2~uORF:IOH10695	635	49	586
B46R10C05	46-5-10	Hs~Ref:NM_024695.1~uORF:IOH10911	518	63	455
B46R10C06	46-6-10	Hs~Ref:NM_024695.1~uORF:IOH10911	567	340	227
B46R10C07	46-7-10	Hs~MGC:BC007382.1~uORF:IOH7027	349	148	201
B46R10C08	46-8-10	Hs~MGC:BC007382.1~uORF:IOH7027	220	47	173
B46R10C09	46-9-10	Hs~Ref:NM_017871.3~uORF:IOH7042	594	46	548
B46R10C10	46-10-10	Hs~Ref:NM_017871.3~uORF:IOH7042	584	50	534
B46R10C11	46-11-10	GST1	46	48	-2
B46R10C12	46-12-10	GST1	50	49	1
B46R10C13	46-13-10	GST2	43	45	-2
B46R10C14	46-14-10	GST2	44	43	1
B46R10C15	46-15-10	GST3	1840	45	1795
B46R10C16	46-16-10	GST3	278	46	232
B46R10C17	46-17-10	GST4	62	41	21
B46R10C18	46-18-10	GST4	61	43	18
B46R10C19	46-19-10	Anti-HumanIgA1~N/A	10509	45	10464
B46R10C20	46-20-10	Anti-HumanIgA1~N/A	10428	54	10374
B46R10C21	46-21-10	Anti-HumanIgA2~N/A	18479	62	18417
B46R10C22	46-22-10	Anti-HumanIgA2~N/A	18116	60	18056
B46R11C01	46-1-11	AlexaAntiMouseAb~N/A	24803	46	24757
B46R11C02	46-2-11	AlexaAntiMouseAb~N/A	27116	50	27066
B46R11C03	46-3-11	MAPKAP~N/A	94	47	47
B46R11C04	46-4-11	MAPKAP~N/A	90	50	40
B46R11C05	46-5-11	Buffer	292	71	221
B46R11C06	46-6-11	Buffer	293	72	221
B46R11C07	46-7-11	BSA~N/A	10142	48	10094
B46R11C08	46-8-11	BSA~N/A	10650	46	10604
B46R11C09	46-9-11	Anti-HumanIgG1~N/A	1984	46	1938
B46R11C10	46-10-11	Anti-HumanIgG1~N/A	2159	48	2111
B46R11C11	46-11-11	Anti-HumanIgG2~N/A	4161	50	4111
B46R11C12	46-12-11	Anti-HumanIgG2~N/A	4350	49	4301
B46R11C13	46-13-11	Anti-HumanIgG3~N/A	7053	47	7006
B46R11C14	46-14-11	Anti-HumanIgG3~N/A	6838	45	6793
B46R11C15	46-15-11	Anti-HumanIgG4~N/A	13275	46	13229
B46R11C16	46-16-11	Anti-HumanIgG4~N/A	12462	46	12416
B46R11C17	46-17-11	AntiBiotinAb~N/A	14139	43	14096
B46R11C18	46-18-11	AntiBiotinAb~N/A	14466	45	14421
B46R11C19	46-19-11	Buffer	66	48	18
B46R11C20	46-20-11	Buffer	88	51	37
B46R11C21	46-21-11	Hs~Ref:NM_002364.1~uORF:IOH11315	1438	54	1384
B46R11C22	46-22-11	Hs~Ref:NM_002364.1~uORF:IOH11315	1432	48	1384
B46R12C01	46-1-12	Hs~Ref:NM_032341.1~uORF:IOH7525	479	47	432
B46R12C02	46-2-12	Hs~Ref:NM_032341.1~uORF:IOH7525	516	50	466
B46R12C03	46-3-12	Hs~Ref:NM_007217.2~uORF:IOH3934	462	57	405
B46R12C04	46-4-12	Hs~Ref:NM_007217.2~uORF:IOH3934	413	56	357
B46R12C05	46-5-12	Hs~Ref:NM_015933.1~uORF:IOH3769	1076	69	1007
B46R12C06	46-6-12	Hs~Ref:NM_015933.1~uORF:IOH3769	1041	66	975
B46R12C07	46-7-12	Hs~MGC:BC053989.1~uORF:IOH29368	553	49	504
B46R12C08	46-8-12	Hs~MGC:BC053989.1~uORF:IOH29368	578	48	530
B46R12C09	46-9-12	Hs~MGC:BC059364.1~uORF:IOH29285	300	53	247
B46R12C10	46-10-12	Hs~MGC:BC059364.1~uORF:IOH29285	137	102	35
B46R12C11	46-11-12	Hs~MGC:BC054517.1~uORF:IOH28882	270	69	201
B46R12C12	46-12-12	Hs~MGC:BC054517.1~uORF:IOH28882	136	72	64
B46R12C13	46-13-12	Hs~Ref:NM_002447.1~N/A	768	53	715
B46R12C14	46-14-12	Hs~Ref:NM_002447.1~N/A	515	52	463
B46R12C15	46-15-12	Hs~MGC:BC016640.1~uORF:IOH21476	533	45	488
B46R12C16	46-16-12	Hs~MGC:BC016640.1~uORF:IOH21476	502	45	457
B46R12C17	46-17-12	Hs~MGC:NM_152634.1~uORF:IOH21490	591	46	545
B46R12C18	46-18-12	Hs~MGC:NM_152634.1~uORF:IOH21490	572	48	524
B46R12C19	46-19-12	Hs~Ref:NM_005038.1~uORF:IOH22406	324	101	223
B46R12C20	46-20-12	Hs~Ref:NM_005038.1~uORF:IOH22406	308	150	158
B46R12C21	46-21-12	Hs~Ref:NM_031856.1~uORF:IOH36170	78	47	31
B46R12C22	46-22-12	Hs~Ref:NM_031856.1~uORF:IOH36170	287	76	211
B46R13C01	46-1-13	Hs~MGC:BC009016.1~uORF:IOH3326	329	50	279
B46R13C02	46-2-13	Hs~MGC:BC009016.1~uORF:IOH3326	384	135	249
B46R13C03	46-3-13	Hs~MGC:BC017922.1~uORF:IOH12726	187	53	134
B46R13C04	46-4-13	Hs~MGC:BC017922.1~uORF:IOH12726	434	51	383
B46R13C05	46-5-13	Hs~MGC:BC020729.1~uORF:IOH12978	506	49	457
B46R13C06	46-6-13	Hs~MGC:BC020729.1~uORF:IOH12978	514	48	466
B46R13C07	46-7-13	Hs~MGC:BC015877.1~uORF:IOH13013	502	53	449
B46R13C08	46-8-13	Hs~MGC:BC015877.1~uORF:IOH13013	450	57	393
B46R13C09	46-9-13	Hs~MGC:BC051841.1~uORF:IOH28892	483	176	307
B46R13C10	46-10-13	Hs~MGC:BC051841.1~uORF:IOH28892	447	142	305
B46R13C11	46-11-13	Hs~MGC:BC060847.1~uORF:IOH29212	234	127	107
B46R13C12	46-12-13	Hs~MGC:BC060847.1~uORF:IOH29212	197	49	148
B46R13C13	46-13-13	Hs~MGC:BC053984.1~uORF:IOH29361	177	52	125
B46R13C14	46-14-13	Hs~MGC:BC053984.1~uORF:IOH29361	134	51	83
B46R13C15	46-15-13	Hs~MGC:BC053656.1~uORF:IOH28981	213	45	168
B46R13C16	46-16-13	Hs~MGC:BC053656.1~uORF:IOH28981	296	47	249
B46R13C17	46-17-13	Hs~Ref:NM_023080.1~uORF:IOH13369	579	51	528
B46R13C18	46-18-13	Hs~Ref:NM_023080.1~uORF:IOH13369	592	56	536
B46R13C19	46-19-13	Hs~MGC:BC056418.1~uORF:IOH29118	308	71	237
B46R13C20	46-20-13	Hs~MGC:BC056418.1~uORF:IOH29118	400	159	241
B46R13C21	46-21-13	Hs~Ref:NM_000484.1~uORF:IOH29583	167	46	121
B46R13C22	46-22-13	Hs~Ref:NM_000484.1~uORF:IOH29583	269	55	214
B46R14C01	46-1-14	Hs~MGC:BC028736.1~uORF:IOH28644	206	49	157
B46R14C02	46-2-14	Hs~MGC:BC028736.1~uORF:IOH28644	400	128	272
B46R14C03	46-3-14	Hs~MGC:BC017072.1~uORF:IOH10334	346	48	298
B46R14C04	46-4-14	Hs~MGC:BC017072.1~uORF:IOH10334	295	49	246
B46R14C05	46-5-14	Hs~Ref:NM_001013.2~uORF:IOH5840	655	47	608
B46R14C06	46-6-14	Hs~Ref:NM_001013.2~uORF:IOH5840	629	48	581
B46R14C07	46-7-14	Hs~Ref:NM_020347.1~uORF:IOH27664	454	55	399
B46R14C08	46-8-14	Hs~Ref:NM_020347.1~uORF:IOH27664	350	64	286
B46R14C09	46-9-14	Hs~Ref:NM_002822.1~uORF:IOH25866	3295	99	3196
B46R14C10	46-10-14	Hs~Ref:NM_002822.1~uORF:IOH25866	3633	78	3555
B46R14C11	46-11-14	Hs~Ref:NM_183012.1~uORF:IOH53457	532	95	437
B46R14C12	46-12-14	Hs~Ref:NM_183012.1~uORF:IOH53457	475	58	417
B46R14C13	46-13-14	Hs~Ref:NM_001886.1~uORF:IOH59021	421	60	361
B46R14C14	46-14-14	Hs~Ref:NM_001886.1~uORF:IOH59021	372	55	317
B46R14C15	46-15-14	Hs~Ref:NM_001017367.1~uORF:IOH59815	296	55	241
B46R14C16	46-16-14	Hs~Ref:NM_001017367.1~uORF:IOH59815	254	72	182
B46R14C17	46-17-14	Hs~Ref:NM_005079.2~uORF:IOH59008	238	61	177
B46R14C18	46-18-14	Hs~Ref:NM_005079.2~uORF:IOH59008	234	166	68
B46R14C19	46-19-14	Hs~MGC:BC042820.1~uORF:IOH26481	388	64	324
B46R14C20	46-20-14	Hs~MGC:BC042820.1~uORF:IOH26481	613	442	171
B46R14C21	46-21-14	Hs~Ref:NM_173475.1~uORF:IOH26231	136	49	87
B46R14C22	46-22-14	Hs~Ref:NM_173475.1~uORF:IOH26231	132	46	86
B46R15C01	46-1-15	Hs~Ref:NM_005441.2~uORF:IOH13577	542	47	495
B46R15C02	46-2-15	Hs~Ref:NM_005441.2~uORF:IOH13577	506	47	459
B46R15C03	46-3-15	Hs~Ref:NM_173618.1~uORF:IOH26714	929	46	883
B46R15C04	46-4-15	Hs~Ref:NM_173618.1~uORF:IOH26714	902	46	856
B46R15C05	46-5-15	Hs~Ref:NM_203422.1~uORF:IOH29035	435	51	384
B46R15C06	46-6-15	Hs~Ref:NM_203422.1~uORF:IOH29035	375	48	327
B46R15C07	46-7-15	Hs~MGC:BC057767.1~uORF:IOH29267	743	48	695
B46R15C08	46-8-15	Hs~MGC:BC057767.1~uORF:IOH29267	749	54	695
B46R15C09	46-9-15	Hs~MGC:BC056907.1~uORF:IOH29059	889	192	697
B46R15C10	46-10-15	Hs~MGC:BC056907.1~uORF:IOH29059	402	242	160
B46R15C11	46-11-15	Hs~MGC:BC057783.1~uORF:IOH29271	1573	134	1439
B46R15C12	46-12-15	Hs~MGC:BC057783.1~uORF:IOH29271	1765	62	1703
B46R15C13	46-13-15	Hs~IVGN:PM_2138~Ext:RNP_COMPLEX~N/A	299	47	252
B46R15C14	46-14-15	Hs~IVGN:PM_2138~Ext:RNP_COMPLEX~N/A	266	49	217
B46R15C15	46-15-15	Hs~Ref:NM_005160.2~CAT:PV3827	1123	45	1078
B46R15C16	46-16-15	Hs~Ref:NM_005160.2~CAT:PV3827	1032	44	988
B46R15C17	46-17-15	Hs~Ref:NM_001798.2~CAT:PV3267	314	49	265
B46R15C18	46-18-15	Hs~Ref:NM_001798.2~CAT:PV3267	288	65	223
B46R15C19	46-19-15	Hs~Ref:NM_001220.2~CAT:PV4205	62	47	15
B46R15C20	46-20-15	Hs~Ref:NM_001220.2~CAT:PV4205	861	69	792
B46R15C21	46-21-15	Hs~Ref:NM_006609.2~CAT:PV3822	852	46	806
B46R15C22	46-22-15	Hs~Ref:NM_006609.2~CAT:PV3822	849	42	807
B46R16C01	46-1-16	Hs~Ref:NM_020168.3~CAT:PV3502	1650	48	1602
B46R16C02	46-2-16	Hs~Ref:NM_020168.3~CAT:PV3502	1572	46	1526
B46R16C03	46-3-16	Hs~Ref:NM_000619.2~CAT_PHC4031	420	42	378
B46R16C04	46-4-16	Hs~Ref:NM_000619.2~CAT_PHC4031	450	43	407
B46R16C05	46-5-16	Hs~IVGN:NM_000230~CAT_PHP0013~N/A	201	53	148
B46R16C06	46-6-16	Hs~IVGN:NM_000230~CAT_PHP0013~N/A	79	47	32
B46R16C07	46-7-16	Hs~Ref:NM_001003806.1~uORF:IOH58623	503	46	457
B46R16C08	46-8-16	Hs~Ref:NM_001003806.1~uORF:IOH58623	452	42	410
B46R16C09	46-9-16	Hs~Ref:NM_022442.3~uORF:IOH58595	278	50	228
B46R16C10	46-10-16	Hs~Ref:NM_022442.3~uORF:IOH58595	1189	184	1005
B46R16C11	46-11-16	Hs~Ref:NM_182717.1~uORF:IOH58667	311	177	134
B46R16C12	46-12-16	Hs~Ref:NM_182717.1~uORF:IOH58667	260	45	215
B46R16C13	46-13-16	Hs~Ref:NM_198125.1~uORF:IOH58629	220	43	177
B46R16C14	46-14-16	Hs~Ref:NM_198125.1~uORF:IOH58629	288	46	242
B46R16C15	46-15-16	Hs~MGC:BC069677.1~uORF:IOH61907	395	48	347
B46R16C16	46-16-16	Hs~MGC:BC069677.1~uORF:IOH61907	578	46	532
B46R16C17	46-17-16	Hs~Ref:NM_006148.1~uORF:IOH54875	505	57	448
B46R16C18	46-18-16	Hs~Ref:NM_006148.1~uORF:IOH54875	594	66	528
B46R16C19	46-19-16	Hs~MGC:BC040545.1~uORF:IOH62182	202	50	152
B46R16C20	46-20-16	Hs~MGC:BC040545.1~uORF:IOH62182	206	55	151
B46R16C21	46-21-16	Hs~Ref:NM_005861.2~uORF:IOH56981	548	473	75
B46R16C22	46-22-16	Hs~Ref:NM_005861.2~uORF:IOH56981	562	65	497
B46R17C01	46-1-17	Hs~Ref:NM_003302.1~uORF:IOH5518	1455	49	1406
B46R17C02	46-2-17	Hs~Ref:NM_003302.1~uORF:IOH5518	1490	48	1442
B46R17C03	46-3-17	Hs~MGC:BC001874.1~uORF:IOH4836	532	44	488
B46R17C04	46-4-17	Hs~MGC:BC001874.1~uORF:IOH4836	553	46	507
B46R17C05	46-5-17	Hs~MGC:BC000331.1~uORF:IOH3559	634	46	588
B46R17C06	46-6-17	Hs~MGC:BC000331.1~uORF:IOH3559	614	43	571
B46R17C07	46-7-17	Hs~Ref:NM_015665.3~uORF:IOH4287	421	44	377
B46R17C08	46-8-17	Hs~Ref:NM_015665.3~uORF:IOH4287	434	42	392
B46R17C09	46-9-17	Hs~Ref:NM_003673.2~uORF:IOH13813	177	48	129
B46R17C10	46-10-17	Hs~Ref:NM_003673.2~uORF:IOH13813	317	118	199
B46R17C11	46-11-17	Hs~Ref:NM_025231.1~uORF:IOH5460	718	241	477
B46R17C12	46-12-17	Hs~Ref:NM_025231.1~uORF:IOH5460	444	45	399
B46R17C13	46-13-17	Hs~Ref:NM_005610.1~uORF:IOH4480	114	43	71
B46R17C14	46-14-17	Hs~Ref:NM_005610.1~uORF:IOH4480	110	45	65
B46R17C15	46-15-17	Hs~MGC:BC000247.1~uORF:IOH4476	145	46	99
B46R17C16	46-16-17	Hs~MGC:BC000247.1~uORF:IOH4476	76	53	23
B46R17C17	46-17-17	Hs~Ref:NM_025125.2~uORF:IOH12854	511	64	447
B46R17C18	46-18-17	Hs~Ref:NM_025125.2~uORF:IOH12854	470	241	229
B46R17C19	46-19-17	Hs~MGC:BC008386.1~uORF:IOH7171	266	184	82
B46R17C20	46-20-17	Hs~MGC:BC008386.1~uORF:IOH7171	183	54	129
B46R17C21	46-21-17	Hs~MGC:BC008720.2~uORF:IOH6530	602	213	389
B46R17C22	46-22-17	Hs~MGC:BC008720.2~uORF:IOH6530	519	64	455
B46R18C01	46-1-18	Hs~Ref:NM_033440.1~uORF:IOH7156	204	52	152
B46R18C02	46-2-18	Hs~Ref:NM_033440.1~uORF:IOH7156	331	48	283
B46R18C03	46-3-18	Hs~MGC:BC104226.1~uORF:IOH63629	327	119	208
B46R18C04	46-4-18	Hs~MGC:BC104226.1~uORF:IOH63629	325	60	265
B46R18C05	46-5-18	Hs~Ref:NM_018638.4~uORF:IOH60258	700	48	652
B46R18C06	46-6-18	Hs~Ref:NM_018638.4~uORF:IOH60258	682	46	636
B46R18C07	46-7-18	Hs~Ref:NM_148978.1~uORF:IOH35641	705	45	660
B46R18C08	46-8-18	Hs~Ref:NM_148978.1~uORF:IOH35641	666	47	619
B46R18C09	46-9-18	Hs~Ref:NM_173611.1~uORF:IOH35542	207	65	142
B46R18C10	46-10-18	Hs~Ref:NM_173611.1~uORF:IOH35542	348	47	301
B46R18C11	46-11-18	Hs~Ref:NM_024578.1~uORF:IOH23128	874	47	827
B46R18C12	46-12-18	Hs~Ref:NM_024578.1~uORF:IOH23128	763	46	717
B46R18C13	46-13-18	Hs~MGC:BC062344.1~uORF:IOH40702	671	88	583
B46R18C14	46-14-18	Hs~MGC:BC062344.1~uORF:IOH40702	448	47	401
B46R18C15	46-15-18	Hs~MGC:BC070146.1~uORF:IOH40806	617	54	563
B46R18C16	46-16-18	Hs~MGC:BC070146.1~uORF:IOH40806	656	60	596
B46R18C17	46-17-18	Hs~MGC:BC069185.1~uORF:IOH40766	807	182	625
B46R18C18	46-18-18	Hs~MGC:BC069185.1~uORF:IOH40766	658	64	594
B46R18C19	46-19-18	Hs~MGC:NM_152338.1~uORF:IOH22692	549	53	496
B46R18C20	46-20-18	Hs~MGC:NM_152338.1~uORF:IOH22692	488	57	431
B46R18C21	46-21-18	Hs~Ref:NM_020685.1~uORF:IOH13506	201	66	135
B46R18C22	46-22-18	Hs~Ref:NM_020685.1~uORF:IOH13506	243	114	129
B46R19C01	46-1-19	Hs~Ref:NM_134428.1~uORF:IOH12663	333	49	284
B46R19C02	46-2-19	Hs~Ref:NM_134428.1~uORF:IOH12663	444	49	395
B46R19C03	46-3-19	Hs~MGC:BC033985.1~uORF:IOH25855	520	47	473
B46R19C04	46-4-19	Hs~MGC:BC033985.1~uORF:IOH25855	469	44	425
B46R19C05	46-5-19	Hs~MGC:BC008668.1~uORF:IOH9808	552	47	505
B46R19C06	46-6-19	Hs~MGC:BC008668.1~uORF:IOH9808	514	49	465
B46R19C07	46-7-19	Hs~Ref:NM_016932.2~uORF:IOH12464	312	53	259
B46R19C08	46-8-19	Hs~Ref:NM_016932.2~uORF:IOH12464	324	177	147
B46R19C09	46-9-19	Hs~Ref:NM_000387.2~uORF:IOH1973	118	51	67
B46R19C10	46-10-19	Hs~Ref:NM_000387.2~uORF:IOH1973	401	134	267
B46R19C11	46-11-19	Hs~Ref:NM_001296.3~uORF:IOH10320	510	54	456
B46R19C12	46-12-19	Hs~Ref:NM_001296.3~uORF:IOH10320	318	68	250
B46R19C13	46-13-19	Hs~MGC:BC056240.1~uORF:IOH29466	205	46	159
B46R19C14	46-14-19	Hs~MGC:BC056240.1~uORF:IOH29466	195	48	147
B46R19C15	46-15-19	Hs~Ref:NM_007026.1~uORF:IOH21130	4172	55	4117
B46R19C16	46-16-19	Hs~Ref:NM_007026.1~uORF:IOH21130	4129	55	4074
B46R19C17	46-17-19	Hs~Ref:NM_004811.1~uORF:IOH13601	255	188	67
B46R19C18	46-18-19	Hs~Ref:NM_004811.1~uORF:IOH13601	213	54	159
B46R19C19	46-19-19	Hs~MGC:NM_181468.1~uORF:IOH3908	205	51	154
B46R19C20	46-20-19	Hs~MGC:NM_181468.1~uORF:IOH3908	300	144	156
B46R19C21	46-21-19	Hs~MGC:BC095488.1~uORF:IOH63166	297	139	158
B46R19C22	46-22-19	Hs~MGC:BC095488.1~uORF:IOH63166	469	106	363
B46R20C01	46-1-20	Hs~Ref:NM_015868.2~uORF:IOH59079	232	44	188
B46R20C02	46-2-20	Hs~Ref:NM_015868.2~uORF:IOH59079	42	42	0
B46R20C03	46-3-20	Hs~Ref:NM_130389.2~uORF:IOH59768	39	39	0
B46R20C04	46-4-20	Hs~Ref:NM_130389.2~uORF:IOH59768	38	38	0
B46R20C05	46-5-20	Hs~Ref:NM_000535.3~uORF:IOH52903	42	42	0
B46R20C06	46-6-20	Hs~Ref:NM_000535.3~uORF:IOH52903	112	39	73
B46R20C07	46-7-20	Hs~Ref:NM_002491.1~uORF:IOH10805	402	86	316
B46R20C08	46-8-20	Hs~Ref:NM_002491.1~uORF:IOH10805	732	117	615
B46R20C09	46-9-20	Hs~MGC:BC018113.1~uORF:IOH11302	242	59	183
B46R20C10	46-10-20	Hs~MGC:BC018113.1~uORF:IOH11302	300	48	252
B46R20C11	46-11-20	Hs~Ref:NM_021114.1~uORF:IOH56004	129	67	62
B46R20C12	46-12-20	Hs~Ref:NM_021114.1~uORF:IOH56004	132	49	83
B46R20C13	46-13-20	Hs~Ref:NM_004297.1~uORF:IOH27303	246	50	196
B46R20C14	46-14-20	Hs~Ref:NM_004297.1~uORF:IOH27303	86	55	31
B46R20C15	46-15-20	Hs~Ref:NM_012071.2~uORF:IOH12532	183	95	88
B46R20C16	46-16-20	Hs~Ref:NM_012071.2~uORF:IOH12532	137	60	77
B46R20C17	46-17-20	Hs~Ref:NM_005564.2~uORF:IOH23265	155	56	99
B46R20C18	46-18-20	Hs~Ref:NM_005564.2~uORF:IOH23265	149	55	94
B46R20C19	46-19-20	Hs~Ref:NM_013370.2~uORF:IOH36682	2377	47	2330
B46R20C20	46-20-20	Hs~Ref:NM_013370.2~uORF:IOH36682	1884	48	1836
B46R20C21	46-21-20	Hs~Ref:NM_176782.1~uORF:IOH12326	188	104	84
B46R20C22	46-22-20	Hs~Ref:NM_176782.1~uORF:IOH12326	477	138	339
B46R21C01	46-1-21	Hs~Ref:NM_003763.3~uORF:IOH14337	301	46	255
B46R21C02	46-2-21	Hs~Ref:NM_003763.3~uORF:IOH14337	301	63	238
B46R21C03	46-3-21	Hs~Ref:NM_017528.2~uORF:IOH40629	562	42	520
B46R21C04	46-4-21	Hs~Ref:NM_017528.2~uORF:IOH40629	577	42	535
B46R21C05	46-5-21	Hs~Ref:NM_021825.3~uORF:IOH13871	257	59	198
B46R21C06	46-6-21	Hs~Ref:NM_021825.3~uORF:IOH13871	265	97	168
B46R21C07	46-7-21	Hs~Ref:NM_006647.1~uORF:IOH28017	1493	57	1436
B46R21C08	46-8-21	Hs~Ref:NM_006647.1~uORF:IOH28017	1485	53	1432
B46R21C09	46-9-21	Hs~Ref:Q14956-2~CAT_11305-H08H-25	39	42	-3
B46R21C10	46-10-21	Hs~Ref:Q14956-2~CAT_11305-H08H-25	45	40	5
B46R21C11	46-11-21	Internal_1007209	42	41	1
B46R21C12	46-12-21	Internal_1007209	48	46	2
B46R21C13	46-13-21	Hs~Ref:NP_620426.2~CAT_11843-H08H-25	45	44	1
B46R21C14	46-14-21	Hs~Ref:NP_620426.2~CAT_11843-H08H-25	361	43	318
B46R21C15	46-15-21	Internal_1007209	58	42	16
B46R21C16	46-16-21	Internal_1007209	492	48	444
B46R21C17	46-17-21	Hs~Ref:NP_004354.2~CAT_11077-H08H-25	246	55	191
B46R21C18	46-18-21	Hs~Ref:NP_004354.2~CAT_11077-H08H-25	50	52	-2
B46R21C19	46-19-21	Internal_1007209	41	44	-3
B46R21C20	46-20-21	Internal_1007209	42	41	1
B46R21C21	46-21-21	Internal_1007209	44	42	2
B46R21C22	46-22-21	Internal_1007209	231	41	190
B46R22C01	46-1-22	ERa~N/A	1656	44	1612
B46R22C02	46-2-22	ERa~N/A	1737	45	1692
B46R22C03	46-3-22	PKCeta~N/A	403	42	361
B46R22C04	46-4-22	PKCeta~N/A	380	40	340
B46R22C05	46-5-22	Calmodulin~N/A	63	40	23
B46R22C06	46-6-22	Calmodulin~N/A	126	42	84
B46R22C07	46-7-22	V5control5~N/A	371	40	331
B46R22C08	46-8-22	V5control5~N/A	310	40	270
B46R22C09	46-9-22	V5control4~N/A	122	39	83
B46R22C10	46-10-22	V5control4~N/A	129	38	91
B46R22C11	46-11-22	V5control3~N/A	73	39	34
B46R22C12	46-12-22	V5control3~N/A	71	45	26
B46R22C13	46-13-22	V5control2~N/A	180	45	135
B46R22C14	46-14-22	V5control2~N/A	89	45	44
B46R22C15	46-15-22	V5control1~N/A	97	46	51
B46R22C16	46-16-22	V5control1~N/A	91	51	40
B46R22C17	46-17-22	CMK2A~N/A	88	60	28
B46R22C18	46-18-22	CMK2A~N/A	416	53	363
B46R22C19	46-19-22	ERa~N/A	1756	44	1712
B46R22C20	46-20-22	ERa~N/A	1383	42	1341
B46R22C21	46-21-22	AlexaAntiMouseAb~N/A	8761	42	8719
B46R22C22	46-22-22	AlexaAntiMouseAb~N/A	9813	43	9770
B47R01C01	47-1-1	AlexaAntiMouseAb~N/A	38601	41	38560
B47R01C02	47-2-1	AlexaAntiMouseAb~N/A	31541	43	31498
B47R01C03	47-3-1	ERa~N/A	1741	42	1699
B47R01C04	47-4-1	ERa~N/A	1735	41	1694
B47R01C05	47-5-1	HumanIgG1~N/A	1003	40	963
B47R01C06	47-6-1	HumanIgG1~N/A	1009	40	969
B47R01C07	47-7-1	HumanIgG2~N/A	2913	40	2873
B47R01C08	47-8-1	HumanIgG2~N/A	2763	41	2722
B47R01C09	47-9-1	HumanIgG3~N/A	13187	41	13146
B47R01C10	47-10-1	HumanIgG3~N/A	12965	45	12920
B47R01C11	47-11-1	HumanIgG4~N/A	35673	48	35625
B47R01C12	47-12-1	HumanIgG4~N/A	33425	47	33378
B47R01C13	47-13-1	BiotinAb~N/A	194	44	150
B47R01C14	47-14-1	BiotinAb~N/A	170	44	126
B47R01C15	47-15-1	RanBP2deltaFG~N/A	263	188	75
B47R01C16	47-16-1	RanBP2deltaFG~N/A	67	79	-12
B47R01C17	47-17-1	hMDM2~N/A	209	59	150
B47R01C18	47-18-1	hMDM2~N/A	785	193	592
B47R01C19	47-19-1	PKCeta~N/A	392	47	345
B47R01C20	47-20-1	PKCeta~N/A	512	76	436
B47R01C21	47-21-1	AlexaAntiMouseAb~N/A	31529	45	31484
B47R01C22	47-22-1	AlexaAntiMouseAb~N/A	31159	46	31113
B47R02C01	47-1-2	PKCeta~N/A	915	42	873
B47R02C02	47-2-2	PKCeta~N/A	927	43	884
B47R02C03	47-3-2	Buffer	377	43	334
B47R02C04	47-4-2	Buffer	382	45	337
B47R02C05	47-5-2	HumanIgA~N/A	19171	43	19128
B47R02C06	47-6-2	HumanIgA~N/A	18855	44	18811
B47R02C07	47-7-2	Buffer	134	46	88
B47R02C08	47-8-2	Buffer	125	48	77
B47R02C09	47-9-2	BSA~N/A	12409	43	12366
B47R02C10	47-10-2	BSA~N/A	12533	43	12490
B47R02C11	47-11-2	Hs~Ref:NM_178557.2~uORF:IOH42501	175	44	131
B47R02C12	47-12-2	Hs~Ref:NM_178557.2~uORF:IOH42501	214	56	158
B47R02C13	47-13-2	Hs~Ref:NM_130390.1~uORF:IOH42237	203	45	158
B47R02C14	47-14-2	Hs~Ref:NM_130390.1~uORF:IOH42237	192	46	146
B47R02C15	47-15-2	Hs~Ref:NM_002122.3~uORF:IOH41004	223	59	164
B47R02C16	47-16-2	Hs~Ref:NM_002122.3~uORF:IOH41004	238	75	163
B47R02C17	47-17-2	Hs~Ref:XM_117451.4~uORF:IOH42239	1639	70	1569
B47R02C18	47-18-2	Hs~Ref:XM_117451.4~uORF:IOH42239	1654	51	1603
B47R02C19	47-19-2	Hs~Ref:XM_378564.2~uORF:IOH42973	567	51	516
B47R02C20	47-20-2	Hs~Ref:XM_378564.2~uORF:IOH42973	148	47	101
B47R02C21	47-21-2	Hs~Ref:NM_003093.1~uORF:IOH41465	5140	47	5093
B47R02C22	47-22-2	Hs~Ref:NM_003093.1~uORF:IOH41465	4780	48	4732
B47R03C01	47-1-3	Hs~MGC:NM_181509.1~uORF:IOH42908	240	103	137
B47R03C02	47-2-3	Hs~MGC:NM_181509.1~uORF:IOH42908	193	49	144
B47R03C03	47-3-3	Hs~Ref:NM_182775.1~uORF:IOH41510	284	60	224
B47R03C04	47-4-3	Hs~Ref:NM_182775.1~uORF:IOH41510	215	105	110
B47R03C05	47-5-3	Hs~MGC:BC028039.1~uORF:IOH11511	823	47	776
B47R03C06	47-6-3	Hs~MGC:BC028039.1~uORF:IOH11511	766	46	720
B47R03C07	47-7-3	Hs~Ref:NM_005274.1~uORF:IOH4556	441	52	389
B47R03C08	47-8-3	Hs~Ref:NM_005274.1~uORF:IOH4556	388	70	318
B47R03C09	47-9-3	Hs~MGC:BC002934.1~uORF:IOH5727	376	48	328
B47R03C10	47-10-3	Hs~MGC:BC002934.1~uORF:IOH5727	363	47	316
B47R03C11	47-11-3	Hs~Ref:NM_024312.1~uORF:IOH5325	207	51	156
B47R03C12	47-12-3	Hs~Ref:NM_024312.1~uORF:IOH5325	43	62	-19
B47R03C13	47-13-3	Hs~Ref:NM_013254.2~uORF:IOH21006	529	103	426
B47R03C14	47-14-3	Hs~Ref:NM_013254.2~uORF:IOH21006	350	48	302
B47R03C15	47-15-3	Hs~MGC:BC001716.1~uORF:IOH4447	710	577	133
B47R03C16	47-16-3	Hs~MGC:BC001716.1~uORF:IOH4447	619	83	536
B47R03C17	47-17-3	Hs~MGC:BC015091.2~uORF:IOH14751	347	74	273
B47R03C18	47-18-3	Hs~MGC:BC015091.2~uORF:IOH14751	262	61	201
B47R03C19	47-19-3	Hs~MGC:BC004885.1~uORF:IOH5650	357	52	305
B47R03C20	47-20-3	Hs~MGC:BC004885.1~uORF:IOH5650	551	54	497
B47R03C21	47-21-3	Hs~Ref:NM_032284.1~uORF:IOH4769	183	52	131
B47R03C22	47-22-3	Hs~Ref:NM_032284.1~uORF:IOH4769	65	73	-8
B47R04C01	47-1-4	Hs~MGC:BC001726.1~uORF:IOH4820	215	80	135
B47R04C02	47-2-4	Hs~MGC:BC001726.1~uORF:IOH4820	174	51	123
B47R04C03	47-3-4	Hs~MGC:BC007048.1~uORF:IOH7230	3185	51	3134
B47R04C04	47-4-4	Hs~MGC:BC007048.1~uORF:IOH7230	2807	47	2760
B47R04C05	47-5-4	Hs~MGC:BC003040.1~uORF:IOH5055	160	42	118
B47R04C06	47-6-4	Hs~MGC:BC003040.1~uORF:IOH5055	207	51	156
B47R04C07	47-7-4	Hs~MGC:NM_153326.1~uORF:IOH4326	685	43	642
B47R04C08	47-8-4	Hs~MGC:NM_153326.1~uORF:IOH4326	636	43	593
B47R04C09	47-9-4	Hs~Ref:NM_144628.1~uORF:IOH12982	187	45	142
B47R04C10	47-10-4	Hs~Ref:NM_144628.1~uORF:IOH12982	141	47	94
B47R04C11	47-11-4	Hs~MGC:BC007949.1~uORF:IOH6744	178	90	88
B47R04C12	47-12-4	Hs~MGC:BC007949.1~uORF:IOH6744	111	46	65
B47R04C13	47-13-4	Hs~MGC:BC011857.1~uORF:IOH14038	537	56	481
B47R04C14	47-14-4	Hs~MGC:BC011857.1~uORF:IOH14038	204	52	152
B47R04C15	47-15-4	Hs~Ref:NM_007065.2~uORF:IOH6219	192	56	136
B47R04C16	47-16-4	Hs~Ref:NM_007065.2~uORF:IOH6219	177	56	121
B47R04C17	47-17-4	Hs~MGC:BC001889.1~uORF:IOH4855	253	58	195
B47R04C18	47-18-4	Hs~MGC:BC001889.1~uORF:IOH4855	239	60	179
B47R04C19	47-19-4	Hs~Ref:NM_058179.1~uORF:IOH4946	471	55	416
B47R04C20	47-20-4	Hs~Ref:NM_058179.1~uORF:IOH4946	486	62	424
B47R04C21	47-21-4	Hs~Ref:NM_005659.1~uORF:IOH4744	2159	60	2099
B47R04C22	47-22-4	Hs~Ref:NM_005659.1~uORF:IOH4744	2006	56	1950
B47R05C01	47-1-5	Hs~Ref:NM_145212.1~uORF:IOH13804	55	40	15
B47R05C02	47-2-5	Hs~Ref:NM_145212.1~uORF:IOH13804	51	41	10
B47R05C03	47-3-5	Hs~Ref:NM_000458.1~uORF:IOH11258	433	42	391
B47R05C04	47-4-5	Hs~Ref:NM_000458.1~uORF:IOH11258	451	41	410
B47R05C05	47-5-5	Hs~MGC:BC026213.1~uORF:IOH11042	868	42	826
B47R05C06	47-6-5	Hs~MGC:BC026213.1~uORF:IOH11042	878	42	836
B47R05C07	47-7-5	Hs~Ref:NM_145299.1~uORF:IOH11298	422	41	381
B47R05C08	47-8-5	Hs~Ref:NM_145299.1~uORF:IOH11298	423	43	380
B47R05C09	47-9-5	Hs~MGC:BC019598.1~uORF:IOH10613	383	77	306
B47R05C10	47-10-5	Hs~MGC:BC019598.1~uORF:IOH10613	567	135	432
B47R05C11	47-11-5	Hs~Ref:NM_007246.2~uORF:IOH10632	325	50	275
B47R05C12	47-12-5	Hs~Ref:NM_007246.2~uORF:IOH10632	359	45	314
B47R05C13	47-13-5	Hs~Ref:NM_138454.1~uORF:IOH12871	108	52	56
B47R05C14	47-14-5	Hs~Ref:NM_138454.1~uORF:IOH12871	209	58	151
B47R05C15	47-15-5	Hs~MGC:BC022459.1~uORF:IOH11064	249	49	200
B47R05C16	47-16-5	Hs~MGC:BC022459.1~uORF:IOH11064	234	47	187
B47R05C17	47-17-5	Hs~Ref:NM_022476.1~uORF:IOH3844	1596	51	1545
B47R05C18	47-18-5	Hs~Ref:NM_022476.1~uORF:IOH3844	1479	56	1423
B47R05C19	47-19-5	Hs~MGC:BC014131.1~uORF:IOH12938	49	54	-5
B47R05C20	47-20-5	Hs~MGC:BC014131.1~uORF:IOH12938	299	49	250
B47R05C21	47-21-5	Hs~MGC:BC012842.1~uORF:IOH10512	247	46	201
B47R05C22	47-22-5	Hs~MGC:BC012842.1~uORF:IOH10512	228	46	182
B47R06C01	47-1-6	Hs~MGC:BC025761.1~uORF:IOH11223	578	53	525
B47R06C02	47-2-6	Hs~MGC:BC025761.1~uORF:IOH11223	624	45	579
B47R06C03	47-3-6	Hs~Ref:NM_173843.1~uORF:IOH45793	147	44	103
B47R06C04	47-4-6	Hs~Ref:NM_173843.1~uORF:IOH45793	139	42	97
B47R06C05	47-5-6	Hs~Ref:NM_203379.1~uORF:IOH45817	199	124	75
B47R06C06	47-6-6	Hs~Ref:NM_203379.1~uORF:IOH45817	217	46	171
B47R06C07	47-7-6	Hs~Ref:NM_017819.1~uORF:IOH45746	842	43	799
B47R06C08	47-8-6	Hs~Ref:NM_017819.1~uORF:IOH45746	856	45	811
B47R06C09	47-9-6	Hs~Ref:NM_198938.1~uORF:IOH45795	172	116	56
B47R06C10	47-10-6	Hs~Ref:NM_198938.1~uORF:IOH45795	170	135	35
B47R06C11	47-11-6	Hs~Ref:NM_138419.1~uORF:IOH22975	1057	53	1004
B47R06C12	47-12-6	Hs~Ref:NM_138419.1~uORF:IOH22975	982	44	938
B47R06C13	47-13-6	Hs~Ref:NM_016532.2~uORF:IOH4433	467	46	421
B47R06C14	47-14-6	Hs~Ref:NM_016532.2~uORF:IOH4433	473	48	425
B47R06C15	47-15-6	Hs~Ref:NM_002461.1~uORF:IOH4651	508	50	458
B47R06C16	47-16-6	Hs~Ref:NM_002461.1~uORF:IOH4651	560	254	306
B47R06C17	47-17-6	Hs~Ref:NM_024062.2~uORF:IOH2945	475	51	424
B47R06C18	47-18-6	Hs~Ref:NM_024062.2~uORF:IOH2945	458	65	393
B47R06C19	47-19-6	Hs~Ref:NM_022337.1~uORF:IOH10104	199	49	150
B47R06C20	47-20-6	Hs~Ref:NM_022337.1~uORF:IOH10104	178	44	134
B47R06C21	47-21-6	Hs~Ref:NM_004283.2~uORF:IOH10511	181	79	102
B47R06C22	47-22-6	Hs~Ref:NM_004283.2~uORF:IOH10511	98	63	35
B47R07C01	47-1-7	Hs~Ref:NM_001667.1~uORF:IOH1753	214	49	165
B47R07C02	47-2-7	Hs~Ref:NM_001667.1~uORF:IOH1753	806	58	748
B47R07C03	47-3-7	Hs~MGC:BC036076.1~uORF:IOH27281	61	53	8
B47R07C04	47-4-7	Hs~MGC:BC036076.1~uORF:IOH27281	108	42	66
B47R07C05	47-5-7	Hs~Ref:NM_001239.2~uORF:IOH7258	209	43	166
B47R07C06	47-6-7	Hs~Ref:NM_001239.2~uORF:IOH7258	388	123	265
B47R07C07	47-7-7	Hs~MGC:BC005298.1~uORF:IOH7271	244	76	168
B47R07C08	47-8-7	Hs~MGC:BC005298.1~uORF:IOH7271	388	47	341
B47R07C09	47-9-7	Hs~MGC:BC005371.1~uORF:IOH7357	252	161	91
B47R07C10	47-10-7	Hs~MGC:BC005371.1~uORF:IOH7357	312	56	256
B47R07C11	47-11-7	Hs~Ref:NM_005391.1~uORF:IOH10145	172	90	82
B47R07C12	47-12-7	Hs~Ref:NM_005391.1~uORF:IOH10145	134	45	89
B47R07C13	47-13-7	Hs~MGC:BC016987.1~uORF:IOH11787	507	45	462
B47R07C14	47-14-7	Hs~MGC:BC016987.1~uORF:IOH11787	476	45	431
B47R07C15	47-15-7	Hs~Ref:NM_004451.3~uORF:IOH39702	352	51	301
B47R07C16	47-16-7	Hs~Ref:NM_004451.3~uORF:IOH39702	304	55	249
B47R07C17	47-17-7	Hs~MGC:BC028040.1~uORF:IOH11532	3165	148	3017
B47R07C18	47-18-7	Hs~MGC:BC028040.1~uORF:IOH11532	404	144	260
B47R07C19	47-19-7	Hs~MGC:BC019823.1~uORF:IOH11439	194	56	138
B47R07C20	47-20-7	Hs~MGC:BC019823.1~uORF:IOH11439	46	56	-10
B47R07C21	47-21-7	Hs~Ref:NM_002752.3~N/A	425	52	373
B47R07C22	47-22-7	Hs~Ref:NM_002752.3~N/A	377	52	325
B47R08C01	47-1-8	Hs~Ref:NM_007314.1~N/A	512	47	465
B47R08C02	47-2-8	Hs~Ref:NM_007314.1~N/A	550	61	489
B47R08C03	47-3-8	Hs~Ref:NM_004441.2~N/A	729	53	676
B47R08C04	47-4-8	Hs~Ref:NM_004441.2~N/A	738	47	691
B47R08C05	47-5-8	Hs~Ref:NM_000142.2~N/A	430	186	244
B47R08C06	47-6-8	Hs~Ref:NM_000142.2~N/A	397	46	351
B47R08C07	47-7-8	Hs~MGC:BC010876.1~uORF:IOH9862	526	47	479
B47R08C08	47-8-8	Hs~MGC:BC010876.1~uORF:IOH9862	499	47	452
B47R08C09	47-9-8	Hs~MGC:NM_194279.1~uORF:IOH27677	465	52	413
B47R08C10	47-10-8	Hs~MGC:NM_194279.1~uORF:IOH27677	408	72	336
B47R08C11	47-11-8	Hs~MGC:BC036094.1~uORF:IOH27258	488	59	429
B47R08C12	47-12-8	Hs~MGC:BC036094.1~uORF:IOH27258	465	56	409
B47R08C13	47-13-8	Hs~MGC:BC035568.1~uORF:IOH27552	404	55	349
B47R08C14	47-14-8	Hs~MGC:BC035568.1~uORF:IOH27552	402	51	351
B47R08C15	47-15-8	Hs~MGC:BC015818.1~uORF:IOH14254	1015	51	964
B47R08C16	47-16-8	Hs~MGC:BC015818.1~uORF:IOH14254	988	53	935
B47R08C17	47-17-8	Hs~MGC:NM_020319.1~uORF:IOH27320	749	129	620
B47R08C18	47-18-8	Hs~MGC:NM_020319.1~uORF:IOH27320	777	128	649
B47R08C19	47-19-8	Hs~MGC:BC036246.1~uORF:IOH27524	932	64	868
B47R08C20	47-20-8	Hs~MGC:BC036246.1~uORF:IOH27524	932	52	880
B47R08C21	47-21-8	Hs~MGC:BC021906.1~uORF:IOH25790	1053	52	1001
B47R08C22	47-22-8	Hs~MGC:BC021906.1~uORF:IOH25790	960	49	911
B47R09C01	47-1-9	Hs~Ref:NM_152770.1~uORF:IOH22874	632	44	588
B47R09C02	47-2-9	Hs~Ref:NM_152770.1~uORF:IOH22874	965	61	904
B47R09C03	47-3-9	Hs~MGC:BC034821.1~uORF:IOH22860	127	47	80
B47R09C04	47-4-9	Hs~MGC:BC034821.1~uORF:IOH22860	141	46	95
B47R09C05	47-5-9	Hs~Ref:NM_144638.1~uORF:IOH10667	391	55	336
B47R09C06	47-6-9	Hs~Ref:NM_144638.1~uORF:IOH10667	466	51	415
B47R09C07	47-7-9	Hs~MGC:BC016853.1~uORF:IOH10348	468	53	415
B47R09C08	47-8-9	Hs~MGC:BC016853.1~uORF:IOH10348	474	53	421
B47R09C09	47-9-9	Hs~MGC:BC000770.1~uORF:IOH4688	1335	52	1283
B47R09C10	47-10-9	Hs~MGC:BC000770.1~uORF:IOH4688	1229	51	1178
B47R09C11	47-11-9	Hs~Ref:NM_020317.2~uORF:IOH4823	3218	49	3169
B47R09C12	47-12-9	Hs~Ref:NM_020317.2~uORF:IOH4823	3153	49	3104
B47R09C13	47-13-9	Hs~MGC:BC003573.1~uORF:IOH4891	321	111	210
B47R09C14	47-14-9	Hs~MGC:BC003573.1~uORF:IOH4891	336	64	272
B47R09C15	47-15-9	Hs~Ref:NM_006163.1~uORF:IOH6673	328	48	280
B47R09C16	47-16-9	Hs~Ref:NM_006163.1~uORF:IOH6673	297	171	126
B47R09C17	47-17-9	Hs~MGC:BC002385.2~uORF:IOH46075	165	43	122
B47R09C18	47-18-9	Hs~MGC:BC002385.2~uORF:IOH46075	192	44	148
B47R09C19	47-19-9	Hs~MGC:BC005871.2~uORF:IOH46098	407	58	349
B47R09C20	47-20-9	Hs~MGC:BC005871.2~uORF:IOH46098	623	452	171
B47R09C21	47-21-9	Hs~MGC:BC021245.2~uORF:IOH46078	62	61	1
B47R09C22	47-22-9	Hs~MGC:BC021245.2~uORF:IOH46078	52	54	-2
B47R10C01	47-1-10	Hs~MGC:BC012183.1~uORF:IOH46141	262	59	203
B47R10C02	47-2-10	Hs~MGC:BC012183.1~uORF:IOH46141	287	61	226
B47R10C03	47-3-10	Hs~Ref:NM_144676.1~uORF:IOH13348	80	54	26
B47R10C04	47-4-10	Hs~Ref:NM_144676.1~uORF:IOH13348	54	58	-4
B47R10C05	47-5-10	Hs~Ref:NM_053283.1~uORF:IOH40723	164	129	35
B47R10C06	47-6-10	Hs~Ref:NM_053283.1~uORF:IOH40723	165	55	110
B47R10C07	47-7-10	Hs~MGC:BC008744.2~uORF:IOH40663	1469	63	1406
B47R10C08	47-8-10	Hs~MGC:BC008744.2~uORF:IOH40663	1320	54	1266
B47R10C09	47-9-10	Hs~Ref:NM_080621.3~uORF:IOH40705	350	46	304
B47R10C10	47-10-10	Hs~Ref:NM_080621.3~uORF:IOH40705	334	40	294
B47R10C11	47-11-10	GST1	42	39	3
B47R10C12	47-12-10	GST1	42	40	2
B47R10C13	47-13-10	GST2	42	41	1
B47R10C14	47-14-10	GST2	44	43	1
B47R10C15	47-15-10	GST3	42	42	0
B47R10C16	47-16-10	GST3	44	42	2
B47R10C17	47-17-10	GST4	70	41	29
B47R10C18	47-18-10	GST4	61	41	20
B47R10C19	47-19-10	Anti-HumanIgA1~N/A	7242	44	7198
B47R10C20	47-20-10	Anti-HumanIgA1~N/A	7085	45	7040
B47R10C21	47-21-10	Anti-HumanIgA2~N/A	13697	47	13650
B47R10C22	47-22-10	Anti-HumanIgA2~N/A	14437	47	14390
B47R11C01	47-1-11	AlexaAntiMouseAb~N/A	21082	48	21034
B47R11C02	47-2-11	AlexaAntiMouseAb~N/A	22832	50	22782
B47R11C03	47-3-11	MAPKAP~N/A	125	45	80
B47R11C04	47-4-11	MAPKAP~N/A	124	45	79
B47R11C05	47-5-11	Buffer	169	48	121
B47R11C06	47-6-11	Buffer	176	48	128
B47R11C07	47-7-11	BSA~N/A	9851	71	9780
B47R11C08	47-8-11	BSA~N/A	8686	62	8624
B47R11C09	47-9-11	Anti-HumanIgG1~N/A	1417	44	1373
B47R11C10	47-10-11	Anti-HumanIgG1~N/A	1487	40	1447
B47R11C11	47-11-11	Anti-HumanIgG2~N/A	2681	42	2639
B47R11C12	47-12-11	Anti-HumanIgG2~N/A	2844	43	2801
B47R11C13	47-13-11	Anti-HumanIgG3~N/A	4623	45	4578
B47R11C14	47-14-11	Anti-HumanIgG3~N/A	5088	46	5042
B47R11C15	47-15-11	Anti-HumanIgG4~N/A	10058	45	10013
B47R11C16	47-16-11	Anti-HumanIgG4~N/A	10127	43	10084
B47R11C17	47-17-11	AntiBiotinAb~N/A	11018	42	10976
B47R11C18	47-18-11	AntiBiotinAb~N/A	11209	42	11167
B47R11C19	47-19-11	Buffer	48	42	6
B47R11C20	47-20-11	Buffer	49	41	8
B47R11C21	47-21-11	Hs~MGC:BC053667.1~uORF:IOH29009	436	48	388
B47R11C22	47-22-11	Hs~MGC:BC053667.1~uORF:IOH29009	154	45	109
B47R12C01	47-1-12	Hs~MGC:BC035573.1~uORF:IOH27592	247	50	197
B47R12C02	47-2-12	Hs~MGC:BC035573.1~uORF:IOH27592	241	42	199
B47R12C03	47-3-12	Hs~MGC:BC001234.1~uORF:IOH3198	40	41	-1
B47R12C04	47-4-12	Hs~MGC:BC001234.1~uORF:IOH3198	38	41	-3
B47R12C05	47-5-12	Hs~Ref:NM_013330.3~uORF:IOH7339	682	139	543
B47R12C06	47-6-12	Hs~Ref:NM_013330.3~uORF:IOH7339	320	63	257
B47R12C07	47-7-12	Hs~MGC:BC031827.1~uORF:IOH22190	291	78	213
B47R12C08	47-8-12	Hs~MGC:BC031827.1~uORF:IOH22190	310	91	219
B47R12C09	47-9-12	Hs~MGC:BC020867.1~uORF:IOH12282	953	62	891
B47R12C10	47-10-12	Hs~MGC:BC020867.1~uORF:IOH12282	1349	54	1295
B47R12C11	47-11-12	Hs~MGC:BC006370.2~uORF:IOH6467	658	56	602
B47R12C12	47-12-12	Hs~MGC:BC006370.2~uORF:IOH6467	601	51	550
B47R12C13	47-13-12	Hs~Ref:NM_000281.1~uORF:IOH6468	1395	46	1349
B47R12C14	47-14-12	Hs~Ref:NM_000281.1~uORF:IOH6468	1308	46	1262
B47R12C15	47-15-12	Hs~Ref:NM_016954.2~uORF:IOH46151	853	43	810
B47R12C16	47-16-12	Hs~Ref:NM_016954.2~uORF:IOH46151	794	43	751
B47R12C17	47-17-12	Hs~MGC:BC001946.1~uORF:IOH46145	1858	43	1815
B47R12C18	47-18-12	Hs~MGC:BC001946.1~uORF:IOH46145	1787	44	1743
B47R12C19	47-19-12	Hs~MGC:BC006206.2~uORF:IOH46182	1003	43	960
B47R12C20	47-20-12	Hs~MGC:BC006206.2~uORF:IOH46182	972	43	929
B47R12C21	47-21-12	Hs~Ref:NM_023083.1~uORF:IOH29699	878	45	833
B47R12C22	47-22-12	Hs~Ref:NM_023083.1~uORF:IOH29699	1031	45	986
B47R13C01	47-1-13	Hs~MGC:BC000226.1~uORF:IOH4362	204	42	162
B47R13C02	47-2-13	Hs~MGC:BC000226.1~uORF:IOH4362	229	41	188
B47R13C03	47-3-13	Hs~MGC:NM_152516.1~uORF:IOH23070	269	42	227
B47R13C04	47-4-13	Hs~MGC:NM_152516.1~uORF:IOH23070	273	45	228
B47R13C05	47-5-13	Hs~MGC:BC006233.1~uORF:IOH6288	162	96	66
B47R13C06	47-6-13	Hs~MGC:BC006233.1~uORF:IOH6288	82	49	33
B47R13C07	47-7-13	Hs~Ref:NM_001526.2~uORF:IOH29555	752	50	702
B47R13C08	47-8-13	Hs~Ref:NM_001526.2~uORF:IOH29555	132	54	78
B47R13C09	47-9-13	Hs~Ref:NM_023932.1~uORF:IOH4371	205	52	153
B47R13C10	47-10-13	Hs~Ref:NM_023932.1~uORF:IOH4371	167	55	112
B47R13C11	47-11-13	Hs~MGC:BC006839.1~uORF:IOH3171	130	72	58
B47R13C12	47-12-13	Hs~MGC:BC006839.1~uORF:IOH3171	45	57	-12
B47R13C13	47-13-13	Hs~MGC:BC001788.1~uORF:IOH4396	522	48	474
B47R13C14	47-14-13	Hs~MGC:BC001788.1~uORF:IOH4396	444	45	399
B47R13C15	47-15-13	Hs~MGC:BC000876.1~uORF:IOH3233	558	43	515
B47R13C16	47-16-13	Hs~MGC:BC000876.1~uORF:IOH3233	608	43	565
B47R13C17	47-17-13	Hs~Ref:NM_145266.1~uORF:IOH13512	216	44	172
B47R13C18	47-18-13	Hs~Ref:NM_145266.1~uORF:IOH13512	314	54	260
B47R13C19	47-19-13	Hs~Ref:NM_006667.2~uORF:IOH1787	491	44	447
B47R13C20	47-20-13	Hs~Ref:NM_006667.2~uORF:IOH1787	499	44	455
B47R13C21	47-21-13	Hs~MGC:BC018441.1~uORF:IOH10768	356	45	311
B47R13C22	47-22-13	Hs~MGC:BC018441.1~uORF:IOH10768	392	111	281
B47R14C01	47-1-14	Hs~MGC:BC018519.1~uORF:IOH10796	271	43	228
B47R14C02	47-2-14	Hs~MGC:BC018519.1~uORF:IOH10796	224	43	181
B47R14C03	47-3-14	Hs~Ref:NM_001868.1~uORF:IOH53980	254	43	211
B47R14C04	47-4-14	Hs~Ref:NM_001868.1~uORF:IOH53980	240	44	196
B47R14C05	47-5-14	Hs~Ref:NM_006404.3~uORF:IOH53863	151	45	106
B47R14C06	47-6-14	Hs~Ref:NM_006404.3~uORF:IOH53863	251	46	205
B47R14C07	47-7-14	Hs~Ref:NM_020634.1~uORF:IOH53947	399	43	356
B47R14C08	47-8-14	Hs~Ref:NM_020634.1~uORF:IOH53947	567	49	518
B47R14C09	47-9-14	Hs~Ref:NM_004079.3~uORF:IOH53925	113	86	27
B47R14C10	47-10-14	Hs~Ref:NM_004079.3~uORF:IOH53925	145	49	96
B47R14C11	47-11-14	Hs~MGC:BC039654.1~uORF:IOH29351	115	54	61
B47R14C12	47-12-14	Hs~MGC:BC039654.1~uORF:IOH29351	172	55	117
B47R14C13	47-13-14	Hs~Ref:NM_005206.2~uORF:IOH1805	345	55	290
B47R14C14	47-14-14	Hs~Ref:NM_005206.2~uORF:IOH1805	345	48	297
B47R14C15	47-15-14	Hs~MGC:BC021992.1~uORF:IOH13921	303	44	259
B47R14C16	47-16-14	Hs~MGC:BC021992.1~uORF:IOH13921	296	44	252
B47R14C17	47-17-14	Hs~MGC:BC000043.1~uORF:IOH4765	388	44	344
B47R14C18	47-18-14	Hs~MGC:BC000043.1~uORF:IOH4765	415	44	371
B47R14C19	47-19-14	Hs~MGC:BC034994.1~uORF:IOH62088	519	43	476
B47R14C20	47-20-14	Hs~MGC:BC034994.1~uORF:IOH62088	535	45	490
B47R14C21	47-21-14	Hs~MGC:BC035030.1~uORF:IOH62115	391	46	345
B47R14C22	47-22-14	Hs~MGC:BC035030.1~uORF:IOH62115	381	46	335
B47R15C01	47-1-15	Hs~MGC:BC032865.1~uORF:IOH62118	219	43	176
B47R15C02	47-2-15	Hs~MGC:BC032865.1~uORF:IOH62118	374	92	282
B47R15C03	47-3-15	Hs~MGC:BC093644.1~uORF:IOH61966	320	46	274
B47R15C04	47-4-15	Hs~MGC:BC093644.1~uORF:IOH61966	298	45	253
B47R15C05	47-5-15	Hs~MGC:BC042333.1~uORF:IOH28769	125	78	47
B47R15C06	47-6-15	Hs~MGC:BC042333.1~uORF:IOH28769	84	42	42
B47R15C07	47-7-15	Hs~MGC:BC053343.1~uORF:IOH28926	198	72	126
B47R15C08	47-8-15	Hs~MGC:BC053343.1~uORF:IOH28926	250	51	199
B47R15C09	47-9-15	Hs~MGC:BC014051.1~uORF:IOH14549	316	51	265
B47R15C10	47-10-15	Hs~MGC:BC014051.1~uORF:IOH14549	245	53	192
B47R15C11	47-11-15	Hs~MGC:BC010032.1~uORF:IOH14597	125	58	67
B47R15C12	47-12-15	Hs~MGC:BC010032.1~uORF:IOH14597	200	66	134
B47R15C13	47-13-15	Hs~IVGN:PM_2130~Ext:proteinase-3_IV~N/A	63	62	1
B47R15C14	47-14-15	Hs~IVGN:PM_2130~Ext:proteinase-3_IV~N/A	51	54	-3
B47R15C15	47-15-15	Hs~Ref:NM_004755.2~CAT:PV3681	215	67	148
B47R15C16	47-16-15	Hs~Ref:NM_004755.2~CAT:PV3681	145	44	101
B47R15C17	47-17-15	Hs~Ref:NM_001278.2~CAT:PV4310	393	44	349
B47R15C18	47-18-15	Hs~Ref:NM_001278.2~CAT:PV4310	399	45	354
B47R15C19	47-19-15	Hs~Ref:NM_002019.1~CAT:PV3666	413	45	368
B47R15C20	47-20-15	Hs~Ref:NM_002019.1~CAT:PV3666	417	46	371
B47R15C21	47-21-15	Hs~Ref:NM_001699.3~CAT:PV3971	840	44	796
B47R15C22	47-22-15	Hs~Ref:NM_001699.3~CAT:PV3971	818	43	775
B47R16C01	47-1-16	Hs~Ref:NM_002011.3~CAT:P3054	77	39	38
B47R16C02	47-2-16	Hs~Ref:NM_002011.3~CAT:P3054	70	42	28
B47R16C03	47-3-16	Hs~Ref:NM_002759.1~CAT:PV4821	204	43	161
B47R16C04	47-4-16	Hs~Ref:NM_002759.1~CAT:PV4821	220	43	177
B47R16C05	47-5-16	Hs~Ref:NM_005036.2~CAT:PV4692	146	44	102
B47R16C06	47-6-16	Hs~Ref:NM_005036.2~CAT:PV4692	93	42	51
B47R16C07	47-7-16	Hs~Ref:NM_139016.2~uORF:IOH27635	4807	49	4758
B47R16C08	47-8-16	Hs~Ref:NM_139016.2~uORF:IOH27635	4755	52	4703
B47R16C09	47-9-16	Hs~Ref:NM_173822.1~uORF:IOH27491	715	49	666
B47R16C10	47-10-16	Hs~Ref:NM_173822.1~uORF:IOH27491	667	57	610
B47R16C11	47-11-16	Hs~MGC:BC050434.1~uORF:IOH26685	793	62	731
B47R16C12	47-12-16	Hs~MGC:BC050434.1~uORF:IOH26685	788	60	728
B47R16C13	47-13-16	Hs~Ref:NM_003403.3~uORF:IOH27684	451	58	393
B47R16C14	47-14-16	Hs~Ref:NM_003403.3~uORF:IOH27684	410	52	358
B47R16C15	47-15-16	Hs~MGC:BC007315.1~uORF:IOH5888	89	57	32
B47R16C16	47-16-16	Hs~MGC:BC007315.1~uORF:IOH5888	51	44	7
B47R16C17	47-17-16	Hs~MGC:BC035194.2~uORF:IOH28718	1000	66	934
B47R16C18	47-18-16	Hs~MGC:BC035194.2~uORF:IOH28718	1245	81	1164
B47R16C19	47-19-16	Hs~MGC:BC053629.1~uORF:IOH29041	1704	89	1615
B47R16C20	47-20-16	Hs~MGC:BC053629.1~uORF:IOH29041	1306	69	1237
B47R16C21	47-21-16	Hs~Ref:NM_001414.1~uORF:IOH29608	368	50	318
B47R16C22	47-22-16	Hs~Ref:NM_001414.1~uORF:IOH29608	312	46	266
B47R17C01	47-1-17	Hs~MGC:BC067444.1~uORF:IOH62528	249	40	209
B47R17C02	47-2-17	Hs~MGC:BC067444.1~uORF:IOH62528	259	45	214
B47R17C03	47-3-17	Hs~MGC:BC069323.1~uORF:IOH61861	200	71	129
B47R17C04	47-4-17	Hs~MGC:BC069323.1~uORF:IOH61861	107	63	44
B47R17C05	47-5-17	Hs~MGC:BC067539.1~uORF:IOH61827	366	50	316
B47R17C06	47-6-17	Hs~MGC:BC067539.1~uORF:IOH61827	105	45	60
B47R17C07	47-7-17	Hs~MGC:BC031057.1~uORF:IOH61614	273	64	209
B47R17C08	47-8-17	Hs~MGC:BC031057.1~uORF:IOH61614	313	125	188
B47R17C09	47-9-17	Hs~Ref:NM_017583.2~uORF:IOH12577	499	61	438
B47R17C10	47-10-17	Hs~Ref:NM_017583.2~uORF:IOH12577	517	66	451
B47R17C11	47-11-17	Hs~MGC:BC016866.1~uORF:IOH10396	503	63	440
B47R17C12	47-12-17	Hs~MGC:BC016866.1~uORF:IOH10396	475	59	416
B47R17C13	47-13-17	Hs~Ref:NM_023930.1~uORF:IOH3701	1238	52	1186
B47R17C14	47-14-17	Hs~Ref:NM_023930.1~uORF:IOH3701	1233	48	1185
B47R17C15	47-15-17	Hs~Ref:NM_024958.1~uORF:IOH3105	214	47	167
B47R17C16	47-16-17	Hs~Ref:NM_024958.1~uORF:IOH3105	146	49	97
B47R17C17	47-17-17	Hs~Ref:NM_182631.1~uORF:IOH28980	867	125	742
B47R17C18	47-18-17	Hs~Ref:NM_182631.1~uORF:IOH28980	754	132	622
B47R17C19	47-19-17	Hs~Ref:NM_017573.2~uORF:IOH27381	117	157	-40
B47R17C20	47-20-17	Hs~Ref:NM_017573.2~uORF:IOH27381	352	109	243
B47R17C21	47-21-17	Hs~MGC:BC038983.1~uORF:IOH26136	347	52	295
B47R17C22	47-22-17	Hs~MGC:BC038983.1~uORF:IOH26136	269	61	208
B47R18C01	47-1-18	Hs~MGC:BC036884.1~uORF:IOH25943	296	43	253
B47R18C02	47-2-18	Hs~MGC:BC036884.1~uORF:IOH25943	245	42	203
B47R18C03	47-3-18	Hs~Ref:NM_006274.2~uORF:IOH11962	405	51	354
B47R18C04	47-4-18	Hs~Ref:NM_006274.2~uORF:IOH11962	358	53	305
B47R18C05	47-5-18	Hs~Ref:NM_007284.1~uORF:IOH5114	330	53	277
B47R18C06	47-6-18	Hs~Ref:NM_007284.1~uORF:IOH5114	273	48	225
B47R18C07	47-7-18	Hs~MGC:BC013959.1~uORF:IOH14481	521	45	476
B47R18C08	47-8-18	Hs~MGC:BC013959.1~uORF:IOH14481	506	49	457
B47R18C09	47-9-18	Hs~Ref:NM_024516.1~uORF:IOH5156	254	142	112
B47R18C10	47-10-18	Hs~Ref:NM_024516.1~uORF:IOH5156	263	101	162
B47R18C11	47-11-18	Hs~Ref:NM_004458.1~uORF:IOH28633	1420	79	1341
B47R18C12	47-12-18	Hs~Ref:NM_004458.1~uORF:IOH28633	1380	59	1321
B47R18C13	47-13-18	Hs~Ref:NM_138424.1~uORF:IOH9715	285	60	225
B47R18C14	47-14-18	Hs~Ref:NM_138424.1~uORF:IOH9715	240	43	197
B47R18C15	47-15-18	Hs~MGC:BC050548.1~uORF:IOH26914	301	42	259
B47R18C16	47-16-18	Hs~MGC:BC050548.1~uORF:IOH26914	336	62	274
B47R18C17	47-17-18	Hs~MGC:BC057768.1~uORF:IOH29152	1078	121	957
B47R18C18	47-18-18	Hs~MGC:BC057768.1~uORF:IOH29152	232	141	91
B47R18C19	47-19-18	Hs~Ref:NM_006755.1~uORF:IOH2052	86	85	1
B47R18C20	47-20-18	Hs~Ref:NM_006755.1~uORF:IOH2052	44	50	-6
B47R18C21	47-21-18	Hs~Ref:NM_001071.1~uORF:IOH4024	354	58	296
B47R18C22	47-22-18	Hs~Ref:NM_001071.1~uORF:IOH4024	347	92	255
B47R19C01	47-1-19	Hs~MGC:BC015749.1~uORF:IOH13588	38	39	-1
B47R19C02	47-2-19	Hs~MGC:BC015749.1~uORF:IOH13588	39	40	-1
B47R19C03	47-3-19	Hs~MGC:BC011461.1~uORF:IOH11995	410	48	362
B47R19C04	47-4-19	Hs~MGC:BC011461.1~uORF:IOH11995	415	52	363
B47R19C05	47-5-19	Hs~MGC:BC029046.1~uORF:IOH27332	471	49	422
B47R19C06	47-6-19	Hs~MGC:BC029046.1~uORF:IOH27332	448	43	405
B47R19C07	47-7-19	Hs~MGC:BC012528.2~uORF:IOH22912	306	42	264
B47R19C08	47-8-19	Hs~MGC:BC012528.2~uORF:IOH22912	298	43	255
B47R19C09	47-9-19	Hs~MGC:BC032477.1~uORF:IOH21714	417	63	354
B47R19C10	47-10-19	Hs~MGC:BC032477.1~uORF:IOH21714	451	80	371
B47R19C11	47-11-19	Hs~MGC:BC024245.2~uORF:IOH22398	436	81	355
B47R19C12	47-12-19	Hs~MGC:BC024245.2~uORF:IOH22398	360	56	304
B47R19C13	47-13-19	Hs~MGC:BC029608.1~uORF:IOH21623	77	46	31
B47R19C14	47-14-19	Hs~MGC:BC029608.1~uORF:IOH21623	70	43	27
B47R19C15	47-15-19	Hs~Ref:NM_152397.1~uORF:IOH21608	178	62	116
B47R19C16	47-16-19	Hs~Ref:NM_152397.1~uORF:IOH21608	109	47	62
B47R19C17	47-17-19	Hs~Ref:NM_012088.2~uORF:IOH13028	672	74	598
B47R19C18	47-18-19	Hs~Ref:NM_012088.2~uORF:IOH13028	348	187	161
B47R19C19	47-19-19	Hs~Ref:NM_032747.1~uORF:IOH7454	439	53	386
B47R19C20	47-20-19	Hs~Ref:NM_032747.1~uORF:IOH7454	420	47	373
B47R19C21	47-21-19	Hs~MGC:NM_022085.3~uORF:IOH28133	280	55	225
B47R19C22	47-22-19	Hs~MGC:NM_022085.3~uORF:IOH28133	146	62	84
B47R20C01	47-1-20	Hs~Ref:NM_138998.1~uORF:IOH21408	668	49	619
B47R20C02	47-2-20	Hs~Ref:NM_138998.1~uORF:IOH21408	299	46	253
B47R20C03	47-3-20	Hs~MGC:BC002752.1~uORF:IOH5351	1030	46	984
B47R20C04	47-4-20	Hs~MGC:BC002752.1~uORF:IOH5351	1044	44	1000
B47R20C05	47-5-20	Hs~MGC:BC004277.1~uORF:IOH5499	55	42	13
B47R20C06	47-6-20	Hs~MGC:BC004277.1~uORF:IOH5499	122	42	80
B47R20C07	47-7-20	Hs~MGC:NM_152788.2~uORF:IOH11108	239	41	198
B47R20C08	47-8-20	Hs~MGC:NM_152788.2~uORF:IOH11108	243	41	202
B47R20C09	47-9-20	Hs~Ref:NM_032042.2~uORF:IOH11050	658	57	601
B47R20C10	47-10-20	Hs~Ref:NM_032042.2~uORF:IOH11050	621	78	543
B47R20C11	47-11-20	Hs~Ref:NM_012391.1~uORF:IOH12673	236	110	126
B47R20C12	47-12-20	Hs~Ref:NM_012391.1~uORF:IOH12673	238	66	172
B47R20C13	47-13-20	Hs~Ref:NM_025061.2~uORF:IOH10684	280	44	236
B47R20C14	47-14-20	Hs~Ref:NM_025061.2~uORF:IOH10684	239	41	198
B47R20C15	47-15-20	Hs~MGC:NM_022733.1~uORF:IOH12182	271	104	167
B47R20C16	47-16-20	Hs~MGC:NM_022733.1~uORF:IOH12182	237	85	152
B47R20C17	47-17-20	Hs~MGC:BC015914.1~uORF:IOH12385	142	42	100
B47R20C18	47-18-20	Hs~MGC:BC015914.1~uORF:IOH12385	130	46	84
B47R20C19	47-19-20	Hs~Ref:NM_022555.3~uORF:IOH3310	231	72	159
B47R20C20	47-20-20	Hs~Ref:NM_022555.3~uORF:IOH3310	119	42	77
B47R20C21	47-21-20	Hs~Ref:NM_005318.2~uORF:IOH2970	322	137	185
B47R20C22	47-22-20	Hs~Ref:NM_005318.2~uORF:IOH2970	338	107	231
B47R21C01	47-1-21	Hs~MGC:BC058914.1~uORF:IOH29123	179	49	130
B47R21C02	47-2-21	Hs~MGC:BC058914.1~uORF:IOH29123	202	81	121
B47R21C03	47-3-21	Hs~MGC:BC016944.1~uORF:IOH10312	298	55	243
B47R21C04	47-4-21	Hs~MGC:BC016944.1~uORF:IOH10312	295	42	253
B47R21C05	47-5-21	Hs~MGC:BC060876.1~uORF:IOH29249	103	39	64
B47R21C06	47-6-21	Hs~MGC:BC060876.1~uORF:IOH29249	142	54	88
B47R21C07	47-7-21	Hs~MGC:BC058938.1~uORF:IOH29053	1749	42	1707
B47R21C08	47-8-21	Hs~MGC:BC058938.1~uORF:IOH29053	1808	43	1765
B47R21C09	47-9-21	Hs~Ref:NP_001035147.1~CAT_10352-H08H-25	1672	61	1611
B47R21C10	47-10-21	Hs~Ref:NP_001035147.1~CAT_10352-H08H-25	1293	63	1230
B47R21C11	47-11-21	Internal_1007209	1657	54	1603
B47R21C12	47-12-21	Internal_1007209	1654	43	1611
B47R21C13	47-13-21	Hs~Ref:NP_000869.1~CAT_10696-H02H-25	39	40	-1
B47R21C14	47-14-21	Hs~Ref:NP_000869.1~CAT_10696-H02H-25	39	38	1
B47R21C15	47-15-21	Internal_1007209	42	38	4
B47R21C16	47-16-21	Internal_1007209	43	39	4
B47R21C17	47-17-21	Hs~Ref:NP_001233.1~CAT_10039-H03H-25	4445	42	4403
B47R21C18	47-18-21	Hs~Ref:NP_001233.1~CAT_10039-H03H-25	64	40	24
B47R21C19	47-19-21	Internal_1007209	1155	40	1115
B47R21C20	47-20-21	Internal_1007209	1095	41	1054
B47R21C21	47-21-21	Hs~IVGN:anti-hu-IgM~CAT_627500~N/A	7820	43	7777
B47R21C22	47-22-21	Hs~IVGN:anti-hu-IgM~CAT_627500~N/A	7732	44	7688
B47R22C01	47-1-22	ERa~N/A	2337	47	2290
B47R22C02	47-2-22	ERa~N/A	2762	41	2721
B47R22C03	47-3-22	PKCeta~N/A	439	41	398
B47R22C04	47-4-22	PKCeta~N/A	400	40	360
B47R22C05	47-5-22	Calmodulin~N/A	444	38	406
B47R22C06	47-6-22	Calmodulin~N/A	482	39	443
B47R22C07	47-7-22	V5control5~N/A	4401	42	4359
B47R22C08	47-8-22	V5control5~N/A	4069	43	4026
B47R22C09	47-9-22	V5control4~N/A	115	42	73
B47R22C10	47-10-22	V5control4~N/A	174	61	113
B47R22C11	47-11-22	V5control3~N/A	171	50	121
B47R22C12	47-12-22	V5control3~N/A	94	40	54
B47R22C13	47-13-22	V5control2~N/A	106	47	59
B47R22C14	47-14-22	V5control2~N/A	69	39	30
B47R22C15	47-15-22	V5control1~N/A	140	42	98
B47R22C16	47-16-22	V5control1~N/A	125	59	66
B47R22C17	47-17-22	CMK2A~N/A	391	40	351
B47R22C18	47-18-22	CMK2A~N/A	352	40	312
B47R22C19	47-19-22	ERa~N/A	2059	39	2020
B47R22C20	47-20-22	ERa~N/A	2094	39	2055
B47R22C21	47-21-22	AlexaAntiMouseAb~N/A	8394	40	8354
B47R22C22	47-22-22	AlexaAntiMouseAb~N/A	9035	41	8994
B48R01C01	48-1-1	AlexaAntiMouseAb~N/A	34219	42	34177
B48R01C02	48-2-1	AlexaAntiMouseAb~N/A	32747	49	32698
B48R01C03	48-3-1	ERa~N/A	1547	47	1500
B48R01C04	48-4-1	ERa~N/A	1420	44	1376
B48R01C05	48-5-1	HumanIgG1~N/A	718	42	676
B48R01C06	48-6-1	HumanIgG1~N/A	949	42	907
B48R01C07	48-7-1	HumanIgG2~N/A	1830	41	1789
B48R01C08	48-8-1	HumanIgG2~N/A	2369	43	2326
B48R01C09	48-9-1	HumanIgG3~N/A	9576	47	9529
B48R01C10	48-10-1	HumanIgG3~N/A	11778	51	11727
B48R01C11	48-11-1	HumanIgG4~N/A	27310	48	27262
B48R01C12	48-12-1	HumanIgG4~N/A	32205	48	32157
B48R01C13	48-13-1	BiotinAb~N/A	203	46	157
B48R01C14	48-14-1	BiotinAb~N/A	187	45	142
B48R01C15	48-15-1	RanBP2deltaFG~N/A	315	46	269
B48R01C16	48-16-1	RanBP2deltaFG~N/A	304	63	241
B48R01C17	48-17-1	hMDM2~N/A	555	50	505
B48R01C18	48-18-1	hMDM2~N/A	3102	66	3036
B48R01C19	48-19-1	PKCeta~N/A	1288	72	1216
B48R01C20	48-20-1	PKCeta~N/A	767	93	674
B48R01C21	48-21-1	AlexaAntiMouseAb~N/A	32275	55	32220
B48R01C22	48-22-1	AlexaAntiMouseAb~N/A	29100	49	29051
B48R02C01	48-1-2	PKCeta~N/A	957	43	914
B48R02C02	48-2-2	PKCeta~N/A	1211	46	1165
B48R02C03	48-3-2	Buffer	1492	48	1444
B48R02C04	48-4-2	Buffer	1569	46	1523
B48R02C05	48-5-2	HumanIgA~N/A	17935	46	17889
B48R02C06	48-6-2	HumanIgA~N/A	18414	44	18370
B48R02C07	48-7-2	Buffer	92	43	49
B48R02C08	48-8-2	Buffer	88	43	45
B48R02C09	48-9-2	BSA~N/A	10684	47	10637
B48R02C10	48-10-2	BSA~N/A	10766	49	10717
B48R02C11	48-11-2	Hs~Ref:NM_012407.1~uORF:IOH12174	150	46	104
B48R02C12	48-12-2	Hs~Ref:NM_012407.1~uORF:IOH12174	156	45	111
B48R02C13	48-13-2	Hs~MGC:NM_033082.1~uORF:IOH7469	49	44	5
B48R02C14	48-14-2	Hs~MGC:NM_033082.1~uORF:IOH7469	41	44	-3
B48R02C15	48-15-2	Hs~MGC:BC025276.1~uORF:IOH14043	876	46	830
B48R02C16	48-16-2	Hs~MGC:BC025276.1~uORF:IOH14043	266	62	204
B48R02C17	48-17-2	Hs~MGC:BC025279.1~uORF:IOH14049	83	418	-335
B48R02C18	48-18-2	Hs~MGC:BC025279.1~uORF:IOH14049	1964	145	1819
B48R02C19	48-19-2	Hs~MGC:BC031044.1~uORF:IOH22543	3436	200	3236
B48R02C20	48-20-2	Hs~MGC:BC031044.1~uORF:IOH22543	2896	284	2612
B48R02C21	48-21-2	Hs~MGC:BC033842.1~uORF:IOH21761	520	71	449
B48R02C22	48-22-2	Hs~MGC:BC033842.1~uORF:IOH21761	481	57	424
B48R03C01	48-1-3	Hs~MGC:BC029920.1~uORF:IOH22865	1070	46	1024
B48R03C02	48-2-3	Hs~MGC:BC029920.1~uORF:IOH22865	1033	47	986
B48R03C03	48-3-3	Hs~MGC:BC029541.1~uORF:IOH22564	420	47	373
B48R03C04	48-4-3	Hs~MGC:BC029541.1~uORF:IOH22564	396	50	346
B48R03C05	48-5-3	Hs~Ref:NM_138707.1~uORF:IOH40983	452	46	406
B48R03C06	48-6-3	Hs~Ref:NM_138707.1~uORF:IOH40983	439	43	396
B48R03C07	48-7-3	Hs~Ref:NM_207047.1~uORF:IOH44493	567	43	524
B48R03C08	48-8-3	Hs~Ref:NM_207047.1~uORF:IOH44493	518	44	474
B48R03C09	48-9-3	Hs~Ref:NM_002147.2~uORF:IOH40956	503	46	457
B48R03C10	48-10-3	Hs~Ref:NM_002147.2~uORF:IOH40956	440	50	390
B48R03C11	48-11-3	Hs~Ref:NM_004296.3~uORF:IOH41050	368	62	306
B48R03C12	48-12-3	Hs~Ref:NM_004296.3~uORF:IOH41050	422	115	307
B48R03C13	48-13-3	Hs~Ref:NM_194271.1~uORF:IOH41584	47	51	-4
B48R03C14	48-14-3	Hs~Ref:NM_194271.1~uORF:IOH41584	48	51	-3
B48R03C15	48-15-3	Hs~Ref:NM_018114.4~uORF:IOH45463	99	58	41
B48R03C16	48-16-3	Hs~Ref:NM_018114.4~uORF:IOH45463	66	58	8
B48R03C17	48-17-3	Hs~Ref:NM_003616.2~uORF:IOH44332	126	71	55
B48R03C18	48-18-3	Hs~Ref:NM_003616.2~uORF:IOH44332	903	170	733
B48R03C19	48-19-3	Hs~Ref:NM_031303.1~uORF:IOH45470	317	154	163
B48R03C20	48-20-3	Hs~Ref:NM_031303.1~uORF:IOH45470	107	77	30
B48R03C21	48-21-3	Hs~Ref:NM_032809.2~uORF:IOH10281	354	68	286
B48R03C22	48-22-3	Hs~Ref:NM_032809.2~uORF:IOH10281	134	72	62
B48R04C01	48-1-4	Hs~Ref:NM_080678.1~uORF:IOH10298	417	269	148
B48R04C02	48-2-4	Hs~Ref:NM_080678.1~uORF:IOH10298	318	184	134
B48R04C03	48-3-4	Hs~Ref:NM_138800.1~uORF:IOH10304	200	58	142
B48R04C04	48-4-4	Hs~Ref:NM_138800.1~uORF:IOH10304	86	61	25
B48R04C05	48-5-4	Hs~MGC:BC016934.1~uORF:IOH10340	364	49	315
B48R04C06	48-6-4	Hs~MGC:BC016934.1~uORF:IOH10340	348	46	302
B48R04C07	48-7-4	Hs~Ref:NM_001760.2~uORF:IOH14467	377	43	334
B48R04C08	48-8-4	Hs~Ref:NM_001760.2~uORF:IOH14467	360	44	316
B48R04C09	48-9-4	Hs~Ref:NM_145286.1~uORF:IOH10802	389	46	343
B48R04C10	48-10-4	Hs~Ref:NM_145286.1~uORF:IOH10802	437	46	391
B48R04C11	48-11-4	Hs~Ref:NM_001154.2~uORF:IOH5099	177	47	130
B48R04C12	48-12-4	Hs~Ref:NM_001154.2~uORF:IOH5099	240	85	155
B48R04C13	48-13-4	Hs~MGC:BC028083.1~uORF:IOH11382	174	50	124
B48R04C14	48-14-4	Hs~MGC:BC028083.1~uORF:IOH11382	71	61	10
B48R04C15	48-15-4	Hs~Ref:NM_005135.1~uORF:IOH38670	170	57	113
B48R04C16	48-16-4	Hs~Ref:NM_005135.1~uORF:IOH38670	133	58	75
B48R04C17	48-17-4	Hs~Ref:NM_007360.1~uORF:IOH26288	139	61	78
B48R04C18	48-18-4	Hs~Ref:NM_007360.1~uORF:IOH26288	163	66	97
B48R04C19	48-19-4	Hs~Ref:NM_031305.1~uORF:IOH38124	706	357	349
B48R04C20	48-20-4	Hs~Ref:NM_031305.1~uORF:IOH38124	388	57	331
B48R04C21	48-21-4	Hs~Ref:NM_000411.4~uORF:IOH29186	843	57	786
B48R04C22	48-22-4	Hs~Ref:NM_000411.4~uORF:IOH29186	863	60	803
B48R05C01	48-1-5	Hs~Ref:NM_016073.2~uORF:IOH10649	1068	50	1018
B48R05C02	48-2-5	Hs~Ref:NM_016073.2~uORF:IOH10649	1107	57	1050
B48R05C03	48-3-5	Hs~Ref:NM_021639.2~uORF:IOH10045	3123	59	3064
B48R05C04	48-4-5	Hs~Ref:NM_021639.2~uORF:IOH10045	2980	67	2913
B48R05C05	48-5-5	Hs~Ref:NM_031299.2~uORF:IOH4043	394	62	332
B48R05C06	48-6-5	Hs~Ref:NM_031299.2~uORF:IOH4043	390	59	331
B48R05C07	48-7-5	Hs~MGC:BC003512.1~uORF:IOH5479	397	54	343
B48R05C08	48-8-5	Hs~MGC:BC003512.1~uORF:IOH5479	386	63	323
B48R05C09	48-9-5	Hs~Ref:NM_003384.1~N/A	441	48	393
B48R05C10	48-10-5	Hs~Ref:NM_003384.1~N/A	417	45	372
B48R05C11	48-11-5	Hs~Ref:NM_013257.2~N/A	455	47	408
B48R05C12	48-12-5	Hs~Ref:NM_013257.2~N/A	420	45	375
B48R05C13	48-13-5	Hs~Ref:NM_003188.2~N/A	573	192	381
B48R05C14	48-14-5	Hs~Ref:NM_003188.2~N/A	322	49	273
B48R05C15	48-15-5	Hs~Ref:NM_021133.1~N/A	581	49	532
B48R05C16	48-16-5	Hs~Ref:NM_021133.1~N/A	57	67	-10
B48R05C17	48-17-5	Hs~MGC:BC070109.1~uORF:IOH40086	806	65	741
B48R05C18	48-18-5	Hs~MGC:BC070109.1~uORF:IOH40086	1149	787	362
B48R05C19	48-19-5	Hs~Ref:NM_001009993.1~uORF:IOH40129	1072	72	1000
B48R05C20	48-20-5	Hs~Ref:NM_001009993.1~uORF:IOH40129	875	423	452
B48R05C21	48-21-5	Hs~Ref:NM_144990.2~uORF:IOH40187	1527	57	1470
B48R05C22	48-22-5	Hs~Ref:NM_144990.2~uORF:IOH40187	1451	52	1399
B48R06C01	48-1-6	Hs~Ref:NM_001234.3~uORF:IOH40258	672	43	629
B48R06C02	48-2-6	Hs~Ref:NM_001234.3~uORF:IOH40258	662	45	617
B48R06C03	48-3-6	Hs~MGC:BC031695.1~uORF:IOH21499	268	52	216
B48R06C04	48-4-6	Hs~MGC:BC031695.1~uORF:IOH21499	239	64	175
B48R06C05	48-5-6	Hs~MGC:BC012997.2~uORF:IOH12554	1641	72	1569
B48R06C06	48-6-6	Hs~MGC:BC012997.2~uORF:IOH12554	1602	70	1532
B48R06C07	48-7-6	Hs~Ref:NM_024591.1~uORF:IOH13020	888	76	812
B48R06C08	48-8-6	Hs~Ref:NM_024591.1~uORF:IOH13020	820	75	745
B48R06C09	48-9-6	Hs~Ref:NM_032117.1~uORF:IOH23109	558	51	507
B48R06C10	48-10-6	Hs~Ref:NM_032117.1~uORF:IOH23109	550	44	506
B48R06C11	48-11-6	Hs~Ref:NM_053049.2~uORF:IOH54667	333	44	289
B48R06C12	48-12-6	Hs~Ref:NM_053049.2~uORF:IOH54667	376	42	334
B48R06C13	48-13-6	Hs~Ref:NM_007226.1~uORF:IOH59414	215	50	165
B48R06C14	48-14-6	Hs~Ref:NM_007226.1~uORF:IOH59414	47	57	-10
B48R06C15	48-15-6	Hs~Ref:NM_001013705.1~uORF:IOH54674	1142	610	532
B48R06C16	48-16-6	Hs~Ref:NM_001013705.1~uORF:IOH54674	660	51	609
B48R06C17	48-17-6	Hs~Ref:NM_025104.2~uORF:IOH59472	411	49	362
B48R06C18	48-18-6	Hs~Ref:NM_025104.2~uORF:IOH59472	343	51	292
B48R06C19	48-19-6	Hs~Ref:NM_001259.5~uORF:IOH28111	1561	94	1467
B48R06C20	48-20-6	Hs~Ref:NM_001259.5~uORF:IOH28111	870	161	709
B48R06C21	48-21-6	Hs~MGC:BC031520.1~uORF:IOH22122	98	78	20
B48R06C22	48-22-6	Hs~MGC:BC031520.1~uORF:IOH22122	45	68	-23
B48R07C01	48-1-7	Hs~MGC:BC051374.1~uORF:IOH28132	387	46	341
B48R07C02	48-2-7	Hs~MGC:BC051374.1~uORF:IOH28132	537	100	437
B48R07C03	48-3-7	Hs~MGC:BC047420.1~uORF:IOH26512	253	48	205
B48R07C04	48-4-7	Hs~MGC:BC047420.1~uORF:IOH26512	243	52	191
B48R07C05	48-5-7	Hs~Ref:NM_002853.2~uORF:IOH3151	1745	57	1688
B48R07C06	48-6-7	Hs~Ref:NM_002853.2~uORF:IOH3151	1738	56	1682
B48R07C07	48-7-7	Hs~Ref:NM_020145.1~uORF:IOH14380	2051	55	1996
B48R07C08	48-8-7	Hs~Ref:NM_020145.1~uORF:IOH14380	2210	57	2153
B48R07C09	48-9-7	Hs~Ref:NM_004143.2~uORF:IOH5542	571	47	524
B48R07C10	48-10-7	Hs~Ref:NM_004143.2~uORF:IOH5542	546	44	502
B48R07C11	48-11-7	Hs~MGC:BC001798.1~uORF:IOH4437	307	45	262
B48R07C12	48-12-7	Hs~MGC:BC001798.1~uORF:IOH4437	298	43	255
B48R07C13	48-13-7	Hs~Ref:NM_006256.1~N/A	682	43	639
B48R07C14	48-14-7	Hs~Ref:NM_006256.1~N/A	669	47	622
B48R07C15	48-15-7	Hs~Ref:NM_002755.2~N/A	774	53	721
B48R07C16	48-16-7	Hs~Ref:NM_002755.2~N/A	324	71	253
B48R07C17	48-17-7	Hs~Ref:NM_004336.1~N/A	112	61	51
B48R07C18	48-18-7	Hs~Ref:NM_004336.1~N/A	58	67	-9
B48R07C19	48-19-7	Hs~Ref:NM_002595.1~N/A	832	148	684
B48R07C20	48-20-7	Hs~Ref:NM_002595.1~N/A	1889	60	1829
B48R07C21	48-21-7	Hs~Ref:NM_001759.2~uORF:IOH13739	459	49	410
B48R07C22	48-22-7	Hs~Ref:NM_001759.2~uORF:IOH13739	412	46	366
B48R08C01	48-1-8	Hs~MGC:BC009368.2~uORF:IOH13824	103	53	50
B48R08C02	48-2-8	Hs~MGC:BC009368.2~uORF:IOH13824	510	46	464
B48R08C03	48-3-8	Hs~MGC:BC009395.2~uORF:IOH13852	424	45	379
B48R08C04	48-4-8	Hs~MGC:BC009395.2~uORF:IOH13852	643	290	353
B48R08C05	48-5-8	Hs~Ref:NM_020236.2~uORF:IOH13751	598	51	547
B48R08C06	48-6-8	Hs~Ref:NM_020236.2~uORF:IOH13751	570	53	517
B48R08C07	48-7-8	Hs~MGC:BC008730.2~uORF:IOH5942	385	54	331
B48R08C08	48-8-8	Hs~MGC:BC008730.2~uORF:IOH5942	303	58	245
B48R08C09	48-9-8	Hs~MGC:BC020256.1~uORF:IOH12255	503	44	459
B48R08C10	48-10-8	Hs~MGC:BC020256.1~uORF:IOH12255	460	43	417
B48R08C11	48-11-8	Hs~MGC:BC033091.1~uORF:IOH23281	317	46	271
B48R08C12	48-12-8	Hs~MGC:BC033091.1~uORF:IOH23281	356	43	313
B48R08C13	48-13-8	Hs~Ref:NM_000341.2~uORF:IOH12262	427	43	384
B48R08C14	48-14-8	Hs~Ref:NM_000341.2~uORF:IOH12262	439	43	396
B48R08C15	48-15-8	Hs~MGC:BC000769.1~uORF:IOH3832	461	46	415
B48R08C16	48-16-8	Hs~MGC:BC000769.1~uORF:IOH3832	546	110	436
B48R08C17	48-17-8	Hs~Ref:NM_018070.2~uORF:IOH4968	439	66	373
B48R08C18	48-18-8	Hs~Ref:NM_018070.2~uORF:IOH4968	368	66	302
B48R08C19	48-19-8	Hs~MGC:NM_177966.3~uORF:IOH26825	278	79	199
B48R08C20	48-20-8	Hs~MGC:NM_177966.3~uORF:IOH26825	979	70	909
B48R08C21	48-21-8	Hs~MGC:BC001778.1~uORF:IOH4907	403	53	350
B48R08C22	48-22-8	Hs~MGC:BC001778.1~uORF:IOH4907	41	58	-17
B48R09C01	48-1-9	Hs~Ref:NM_005764.3~uORF:IOH58947	258	48	210
B48R09C02	48-2-9	Hs~Ref:NM_005764.3~uORF:IOH58947	255	50	205
B48R09C03	48-3-9	Hs~Ref:NM_000219.2~uORF:IOH54610	58	54	4
B48R09C04	48-4-9	Hs~Ref:NM_000219.2~uORF:IOH54610	68	62	6
B48R09C05	48-5-9	Hs~Ref:NM_005511.1~uORF:IOH58949	432	50	382
B48R09C06	48-6-9	Hs~Ref:NM_005511.1~uORF:IOH58949	434	55	379
B48R09C07	48-7-9	Hs~Ref:NM_005717.2~uORF:IOH59937	241	53	188
B48R09C08	48-8-9	Hs~Ref:NM_005717.2~uORF:IOH59937	309	51	258
B48R09C09	48-9-9	Hs~Ref:NM_145113.1~uORF:IOH58594	207	56	151
B48R09C10	48-10-9	Hs~Ref:NM_145113.1~uORF:IOH58594	230	48	182
B48R09C11	48-11-9	Hs~Ref:NM_002806.2~uORF:IOH57053	271	46	225
B48R09C12	48-12-9	Hs~Ref:NM_002806.2~uORF:IOH57053	232	55	177
B48R09C13	48-13-9	Hs~Ref:NM_006032.2~uORF:IOH55460	655	43	612
B48R09C14	48-14-9	Hs~Ref:NM_006032.2~uORF:IOH55460	643	43	600
B48R09C15	48-15-9	Hs~MGC:BC007035.1~uORF:IOH57050	325	44	281
B48R09C16	48-16-9	Hs~MGC:BC007035.1~uORF:IOH57050	329	192	137
B48R09C17	48-17-9	Hs~MGC:BC000284.1~uORF:IOH4482	386	57	329
B48R09C18	48-18-9	Hs~MGC:BC000284.1~uORF:IOH4482	45	150	-105
B48R09C19	48-19-9	Hs~MGC:BC004359.1~uORF:IOH6052	122	63	59
B48R09C20	48-20-9	Hs~MGC:BC004359.1~uORF:IOH6052	1218	104	1114
B48R09C21	48-21-9	Hs~Ref:NM_018454.4~uORF:IOH3087	985	64	921
B48R09C22	48-22-9	Hs~Ref:NM_018454.4~uORF:IOH3087	605	47	558
B48R10C01	48-1-10	Hs~Ref:NM_001449.2~uORF:IOH13860	9905	45	9860
B48R10C02	48-2-10	Hs~Ref:NM_001449.2~uORF:IOH13860	8053	47	8006
B48R10C03	48-3-10	Hs~Ref:NM_024411.1~uORF:IOH11247	636	47	589
B48R10C04	48-4-10	Hs~Ref:NM_024411.1~uORF:IOH11247	1093	404	689
B48R10C05	48-5-10	Hs~MGC:BC025990.1~uORF:IOH11070	848	57	791
B48R10C06	48-6-10	Hs~MGC:BC025990.1~uORF:IOH11070	647	53	594
B48R10C07	48-7-10	Hs~MGC:BC008912.2~uORF:IOH7034	521	54	467
B48R10C08	48-8-10	Hs~MGC:BC008912.2~uORF:IOH7034	478	44	434
B48R10C09	48-9-10	Hs~MGC:BC013966.2~uORF:IOH12372	5588	46	5542
B48R10C10	48-10-10	Hs~MGC:BC013966.2~uORF:IOH12372	5211	47	5164
B48R10C11	48-11-10	GST1	43	43	0
B48R10C12	48-12-10	GST1	42	41	1
B48R10C13	48-13-10	GST2	49	43	6
B48R10C14	48-14-10	GST2	42	42	0
B48R10C15	48-15-10	GST3	44	42	2
B48R10C16	48-16-10	GST3	44	43	1
B48R10C17	48-17-10	GST4	55	42	13
B48R10C18	48-18-10	GST4	57	44	13
B48R10C19	48-19-10	Anti-HumanIgA1~N/A	6326	48	6278
B48R10C20	48-20-10	Anti-HumanIgA1~N/A	7360	64	7296
B48R10C21	48-21-10	Anti-HumanIgA2~N/A	14902	71	14831
B48R10C22	48-22-10	Anti-HumanIgA2~N/A	13465	50	13415
B48R11C01	48-1-11	AlexaAntiMouseAb~N/A	23302	45	23257
B48R11C02	48-2-11	AlexaAntiMouseAb~N/A	21014	44	20970
B48R11C03	48-3-11	MAPKAP~N/A	92	42	50
B48R11C04	48-4-11	MAPKAP~N/A	93	43	50
B48R11C05	48-5-11	Buffer	145	53	92
B48R11C06	48-6-11	Buffer	149	46	103
B48R11C07	48-7-11	BSA~N/A	8913	49	8864
B48R11C08	48-8-11	BSA~N/A	8854	44	8810
B48R11C09	48-9-11	Anti-HumanIgG1~N/A	1426	42	1384
B48R11C10	48-10-11	Anti-HumanIgG1~N/A	1691	42	1649
B48R11C11	48-11-11	Anti-HumanIgG2~N/A	2521	42	2479
B48R11C12	48-12-11	Anti-HumanIgG2~N/A	2589	41	2548
B48R11C13	48-13-11	Anti-HumanIgG3~N/A	3989	42	3947
B48R11C14	48-14-11	Anti-HumanIgG3~N/A	4961	43	4918
B48R11C15	48-15-11	Anti-HumanIgG4~N/A	8050	43	8007
B48R11C16	48-16-11	Anti-HumanIgG4~N/A	8544	44	8500
B48R11C17	48-17-11	AntiBiotinAb~N/A	10288	44	10244
B48R11C18	48-18-11	AntiBiotinAb~N/A	10702	43	10659
B48R11C19	48-19-11	Buffer	47	51	-4
B48R11C20	48-20-11	Buffer	47	55	-8
B48R11C21	48-21-11	Hs~MGC:BC005914.1~uORF:IOH7475	659	70	589
B48R11C22	48-22-11	Hs~MGC:BC005914.1~uORF:IOH7475	602	52	550
B48R12C01	48-1-12	Hs~MGC:BC001088.1~uORF:IOH3839	1531	45	1486
B48R12C02	48-2-12	Hs~MGC:BC001088.1~uORF:IOH3839	1417	46	1371
B48R12C03	48-3-12	Hs~Ref:NM_003491.1~uORF:IOH3480	605	211	394
B48R12C04	48-4-12	Hs~Ref:NM_003491.1~uORF:IOH3480	345	44	301
B48R12C05	48-5-12	Hs~Ref:NM_001014.2~uORF:IOH4063	2937	44	2893
B48R12C06	48-6-12	Hs~Ref:NM_001014.2~uORF:IOH4063	2748	44	2704
B48R12C07	48-7-12	Hs~MGC:BC038838.1~uORF:IOH28760	1828	45	1783
B48R12C08	48-8-12	Hs~MGC:BC038838.1~uORF:IOH28760	1664	44	1620
B48R12C09	48-9-12	Hs~MGC:BC012761.1~uORF:IOH14564	495	42	453
B48R12C10	48-10-12	Hs~MGC:BC012761.1~uORF:IOH14564	457	43	414
B48R12C11	48-11-12	Hs~MGC:BC056259.1~uORF:IOH29452	306	47	259
B48R12C12	48-12-12	Hs~MGC:BC056259.1~uORF:IOH29452	253	44	209
B48R12C13	48-13-12	Hs~Ref:NM_013254.2~N/A	611	44	567
B48R12C14	48-14-12	Hs~Ref:NM_013254.2~N/A	472	44	428
B48R12C15	48-15-12	Hs~Ref:NM_018370.1~uORF:IOH21486	469	46	423
B48R12C16	48-16-12	Hs~Ref:NM_018370.1~uORF:IOH21486	362	46	316
B48R12C17	48-17-12	Hs~MGC:BC014264.2~uORF:IOH14605	446	51	395
B48R12C18	48-18-12	Hs~MGC:BC014264.2~uORF:IOH14605	530	50	480
B48R12C19	48-19-12	Hs~Ref:NM_032691.1~uORF:IOH5629	479	54	425
B48R12C20	48-20-12	Hs~Ref:NM_032691.1~uORF:IOH5629	372	53	319
B48R12C21	48-21-12	Hs~Ref:NM_021168.2~uORF:IOH40188	285	63	222
B48R12C22	48-22-12	Hs~Ref:NM_021168.2~uORF:IOH40188	77	79	-2
B48R13C01	48-1-13	Hs~MGC:NM_138501.3~uORF:IOH4169	372	45	327
B48R13C02	48-2-13	Hs~MGC:NM_138501.3~uORF:IOH4169	366	44	322
B48R13C03	48-3-13	Hs~MGC:BC000989.2~uORF:IOH2897	216	47	169
B48R13C04	48-4-13	Hs~MGC:BC000989.2~uORF:IOH2897	118	62	56
B48R13C05	48-5-13	Hs~Ref:NM_145283.1~uORF:IOH10752	192	44	148
B48R13C06	48-6-13	Hs~Ref:NM_145283.1~uORF:IOH10752	193	44	149
B48R13C07	48-7-13	Hs~Ref:NM_015871.2~uORF:IOH4113	838	47	791
B48R13C08	48-8-13	Hs~Ref:NM_015871.2~uORF:IOH4113	783	46	737
B48R13C09	48-9-13	Hs~MGC:BC021256.2~uORF:IOH29344	419	43	376
B48R13C10	48-10-13	Hs~MGC:BC021256.2~uORF:IOH29344	391	42	349
B48R13C11	48-11-13	Hs~MGC:BC034702.1~uORF:IOH28627	559	45	514
B48R13C12	48-12-13	Hs~MGC:BC034702.1~uORF:IOH28627	523	44	479
B48R13C13	48-13-13	Hs~MGC:BC050425.1~uORF:IOH28857	281	44	237
B48R13C14	48-14-13	Hs~MGC:BC050425.1~uORF:IOH28857	103	46	57
B48R13C15	48-15-13	Hs~MGC:BC035348.1~uORF:IOH28673	391	99	292
B48R13C16	48-16-13	Hs~MGC:BC035348.1~uORF:IOH28673	107	47	60
B48R13C17	48-17-13	Hs~Ref:NM_022786.1~uORF:IOH13057	362	185	177
B48R13C18	48-18-13	Hs~Ref:NM_022786.1~uORF:IOH13057	219	119	100
B48R13C19	48-19-13	Hs~MGC:BC053660.1~uORF:IOH28993	335	58	277
B48R13C20	48-20-13	Hs~MGC:BC053660.1~uORF:IOH28993	230	52	178
B48R13C21	48-21-13	Hs~Ref:NM_018910.2~uORF:IOH29741	644	57	587
B48R13C22	48-22-13	Hs~Ref:NM_018910.2~uORF:IOH29741	776	54	722
B48R14C01	48-1-14	Hs~MGC:BC006811.1~uORF:IOH3174	192	44	148
B48R14C02	48-2-14	Hs~MGC:BC006811.1~uORF:IOH3174	180	43	137
B48R14C03	48-3-14	Hs~Ref:NM_032324.1~uORF:IOH6602	635	50	585
B48R14C04	48-4-14	Hs~Ref:NM_032324.1~uORF:IOH6602	578	181	397
B48R14C05	48-5-14	Hs~Ref:NM_016000.2~uORF:IOH14202	289	46	243
B48R14C06	48-6-14	Hs~Ref:NM_016000.2~uORF:IOH14202	282	44	238
B48R14C07	48-7-14	Hs~Ref:NM_018394.1~uORF:IOH22907	568	247	321
B48R14C08	48-8-14	Hs~Ref:NM_018394.1~uORF:IOH22907	443	52	391
B48R14C09	48-9-14	Hs~MGC:NM_015014.1~uORF:IOH23193	351	43	308
B48R14C10	48-10-14	Hs~MGC:NM_015014.1~uORF:IOH23193	351	43	308
B48R14C11	48-11-14	Hs~Ref:NM_000405.3~uORF:IOH59020	202	86	116
B48R14C12	48-12-14	Hs~Ref:NM_000405.3~uORF:IOH59020	87	46	41
B48R14C13	48-13-14	Hs~MGC:BC028129.1~uORF:IOH11339	132	46	86
B48R14C14	48-14-14	Hs~MGC:BC028129.1~uORF:IOH11339	119	45	74
B48R14C15	48-15-14	Hs~Ref:NM_001001568.1~uORF:IOH53504	397	55	342
B48R14C16	48-16-14	Hs~Ref:NM_001001568.1~uORF:IOH53504	247	44	203
B48R14C17	48-17-14	Hs~Ref:NM_003480.2~uORF:IOH58997	246	45	201
B48R14C18	48-18-14	Hs~Ref:NM_003480.2~uORF:IOH58997	229	68	161
B48R14C19	48-19-14	Hs~Ref:NM_017897.1~uORF:IOH3173	519	46	473
B48R14C20	48-20-14	Hs~Ref:NM_017897.1~uORF:IOH3173	525	45	480
B48R14C21	48-21-14	Hs~Ref:NM_203350.1~uORF:IOH36832	1106	49	1057
B48R14C22	48-22-14	Hs~Ref:NM_203350.1~uORF:IOH36832	1180	51	1129
B48R15C01	48-1-15	Hs~MGC:BC028218.1~uORF:IOH11616	55	44	11
B48R15C02	48-2-15	Hs~MGC:BC028218.1~uORF:IOH11616	524	47	477
B48R15C03	48-3-15	Hs~MGC:BC016673.1~uORF:IOH11748	614	46	568
B48R15C04	48-4-15	Hs~MGC:BC016673.1~uORF:IOH11748	427	45	382
B48R15C05	48-5-15	Hs~MGC:BC057806.1~uORF:IOH29150	199	43	156
B48R15C06	48-6-15	Hs~MGC:BC057806.1~uORF:IOH29150	208	43	165
B48R15C07	48-7-15	Hs~MGC:BC048217.1~uORF:IOH26167	326	45	281
B48R15C08	48-8-15	Hs~MGC:BC048217.1~uORF:IOH26167	301	45	256
B48R15C09	48-9-15	Hs~MGC:BC060765.1~uORF:IOH29157	464	107	357
B48R15C10	48-10-15	Hs~MGC:BC060765.1~uORF:IOH29157	355	44	311
B48R15C11	48-11-15	Hs~Ref:NM_004457.3~uORF:IOH26199	367	45	322
B48R15C12	48-12-15	Hs~Ref:NM_004457.3~uORF:IOH26199	364	45	319
B48R15C13	48-13-15	Hs~N/A:NM_001014431.1~CAT:P2999	241	44	197
B48R15C14	48-14-15	Hs~N/A:NM_001014431.1~CAT:P2999	56	43	13
B48R15C15	48-15-15	Hs~Ref:NM_004935.1~CAT:PV3000	266	90	176
B48R15C16	48-16-15	Hs~Ref:NM_004935.1~CAT:PV3000	104	43	61
B48R15C17	48-17-15	Hs~Ref:NM_005232.1~CAT:PV3841	631	47	584
B48R15C18	48-18-15	Hs~Ref:NM_005232.1~CAT:PV3841	564	43	521
B48R15C19	48-19-15	Hs~Ref:NM_005157.2~CAT:PV3866	673	44	629
B48R15C20	48-20-15	Hs~Ref:NM_005157.2~CAT:PV3866	673	43	630
B48R15C21	48-21-15	Hs~MGC:NM_001079.3~CAT:P2782	228	45	183
B48R15C22	48-22-15	Hs~MGC:NM_001079.3~CAT:P2782	211	61	150
B48R16C01	48-1-16	Hs~Ref:NM_005409.3~CAT_PHC1695	1269	45	1224
B48R16C02	48-2-16	Hs~Ref:NM_005409.3~CAT_PHC1695	1782	43	1739
B48R16C03	48-3-16	Hs~Ref:NM_001261.2~CAT:PV4335	212	42	170
B48R16C04	48-4-16	Hs~Ref:NM_001261.2~CAT:PV4335	211	43	168
B48R16C05	48-5-16	Hs~Ref:NM_020922.2~CAT:PV4342	93	43	50
B48R16C06	48-6-16	Hs~Ref:NM_020922.2~CAT:PV4342	90	42	48
B48R16C07	48-7-16	Hs~Ref:NM_020553.2~uORF:IOH58663	266	149	117
B48R16C08	48-8-16	Hs~Ref:NM_020553.2~uORF:IOH58663	240	49	191
B48R16C09	48-9-16	Hs~Ref:NM_001008234.1~uORF:IOH58628	930	51	879
B48R16C10	48-10-16	Hs~Ref:NM_001008234.1~uORF:IOH58628	869	46	823
B48R16C11	48-11-16	Hs~Ref:NM_001002876.1~uORF:IOH58604	338	44	294
B48R16C12	48-12-16	Hs~Ref:NM_001002876.1~uORF:IOH58604	351	45	306
B48R16C13	48-13-16	Hs~Ref:NM_006925.2~uORF:IOH58606	550	42	508
B48R16C14	48-14-16	Hs~Ref:NM_006925.2~uORF:IOH58606	533	41	492
B48R16C15	48-15-16	Hs~Ref:NM_003959.1~uORF:IOH60041	935	42	893
B48R16C16	48-16-16	Hs~Ref:NM_003959.1~uORF:IOH60041	937	42	895
B48R16C17	48-17-16	Hs~Ref:NM_003151.2~uORF:IOH56108	478	43	435
B48R16C18	48-18-16	Hs~Ref:NM_003151.2~uORF:IOH56108	473	42	431
B48R16C19	48-19-16	Hs~Ref:NM_001015878.1~uORF:IOH60102	153	44	109
B48R16C20	48-20-16	Hs~Ref:NM_001015878.1~uORF:IOH60102	149	54	95
B48R16C21	48-21-16	Hs~Ref:NM_173558.2~uORF:IOH57227	834	51	783
B48R16C22	48-22-16	Hs~Ref:NM_173558.2~uORF:IOH57227	809	68	741
B48R17C01	48-1-17	Hs~Ref:NM_002883.2~uORF:IOH13287	642	49	593
B48R17C02	48-2-17	Hs~Ref:NM_002883.2~uORF:IOH13287	722	54	668
B48R17C03	48-3-17	Hs~MGC:BC026060.2~uORF:IOH12294	686	177	509
B48R17C04	48-4-17	Hs~MGC:BC026060.2~uORF:IOH12294	482	48	434
B48R17C05	48-5-17	Hs~Ref:NM_018294.3~uORF:IOH5944	986	48	938
B48R17C06	48-6-17	Hs~Ref:NM_018294.3~uORF:IOH5944	861	45	816
B48R17C07	48-7-17	Hs~MGC:BC000337.2~uORF:IOH3577	825	50	775
B48R17C08	48-8-17	Hs~MGC:BC000337.2~uORF:IOH3577	889	53	836
B48R17C09	48-9-17	Hs~MGC:BC012611.1~uORF:IOH13711	143	48	95
B48R17C10	48-10-17	Hs~MGC:BC012611.1~uORF:IOH13711	119	44	75
B48R17C11	48-11-17	Hs~Ref:NM_017811.2~uORF:IOH5652	180	43	137
B48R17C12	48-12-17	Hs~Ref:NM_017811.2~uORF:IOH5652	269	115	154
B48R17C13	48-13-17	Hs~Ref:NM_006769.2~uORF:IOH4472	203	73	130
B48R17C14	48-14-17	Hs~Ref:NM_006769.2~uORF:IOH4472	199	71	128
B48R17C15	48-15-17	Hs~Ref:NM_024041.1~uORF:IOH4477	413	41	372
B48R17C16	48-16-17	Hs~Ref:NM_024041.1~uORF:IOH4477	417	42	375
B48R17C17	48-17-17	Hs~Ref:NM_018607.4~uORF:IOH6302	344	47	297
B48R17C18	48-18-17	Hs~Ref:NM_018607.4~uORF:IOH6302	244	43	201
B48R17C19	48-19-17	Hs~MGC:NM_178840.2~uORF:IOH23046	363	47	316
B48R17C20	48-20-17	Hs~MGC:NM_178840.2~uORF:IOH23046	370	50	320
B48R17C21	48-21-17	Hs~MGC:BC000522.1~uORF:IOH3622	595	50	545
B48R17C22	48-22-17	Hs~MGC:BC000522.1~uORF:IOH3622	480	48	432
B48R18C01	48-1-18	Hs~Ref:NM_004528.2~uORF:IOH7518	641	244	397
B48R18C02	48-2-18	Hs~Ref:NM_004528.2~uORF:IOH7518	57	90	-33
B48R18C03	48-3-18	Hs~MGC:BC000827.1~uORF:IOH3112	308	53	255
B48R18C04	48-4-18	Hs~MGC:BC000827.1~uORF:IOH3112	289	46	243
B48R18C05	48-5-18	Hs~Ref:NM_006189.1~uORF:IOH35144	162	46	116
B48R18C06	48-6-18	Hs~Ref:NM_006189.1~uORF:IOH35144	162	44	118
B48R18C07	48-7-18	Hs~Ref:NM_024969.2~uORF:IOH35988	896	45	851
B48R18C08	48-8-18	Hs~Ref:NM_024969.2~uORF:IOH35988	885	48	837
B48R18C09	48-9-18	Hs~Ref:NM_152595.3~uORF:IOH35990	1032	52	980
B48R18C10	48-10-18	Hs~Ref:NM_152595.3~uORF:IOH35990	1004	126	878
B48R18C11	48-11-18	Hs~Ref:NM_023936.1~uORF:IOH4498	1203	48	1155
B48R18C12	48-12-18	Hs~Ref:NM_023936.1~uORF:IOH4498	1075	45	1030
B48R18C13	48-13-18	Hs~MGC:BC063127.1~uORF:IOH40747	667	44	623
B48R18C14	48-14-18	Hs~MGC:BC063127.1~uORF:IOH40747	649	46	603
B48R18C15	48-15-18	Hs~Ref:NM_207365.1~uORF:IOH40762	494	45	449
B48R18C16	48-16-18	Hs~Ref:NM_207365.1~uORF:IOH40762	501	45	456
B48R18C17	48-17-18	Hs~Ref:NM_014468.2~uORF:IOH36691	1926	45	1881
B48R18C18	48-18-18	Hs~Ref:NM_014468.2~uORF:IOH36691	1960	46	1914
B48R18C19	48-19-18	Hs~MGC:NM_153220.1~uORF:IOH22700	398	51	347
B48R18C20	48-20-18	Hs~MGC:NM_153220.1~uORF:IOH22700	359	64	295
B48R18C21	48-21-18	Hs~MGC:BC032246.1~uORF:IOH21524	444	132	312
B48R18C22	48-22-18	Hs~MGC:BC032246.1~uORF:IOH21524	234	45	189
B48R19C01	48-1-19	Hs~MGC:BC032325.1~uORF:IOH21628	634	49	585
B48R19C02	48-2-19	Hs~MGC:BC032325.1~uORF:IOH21628	571	72	499
B48R19C03	48-3-19	Hs~MGC:BC031966.1~uORF:IOH27672	302	89	213
B48R19C04	48-4-19	Hs~MGC:BC031966.1~uORF:IOH27672	205	47	158
B48R19C05	48-5-19	Hs~MGC:BC018764.1~uORF:IOH13523	841	313	528
B48R19C06	48-6-19	Hs~MGC:BC018764.1~uORF:IOH13523	642	51	591
B48R19C07	48-7-19	Hs~MGC:BC022325.1~uORF:IOH12465	604	51	553
B48R19C08	48-8-19	Hs~MGC:BC022325.1~uORF:IOH12465	879	52	827
B48R19C09	48-9-19	Hs~Ref:NM_001494.2~uORF:IOH4622	595	48	547
B48R19C10	48-10-19	Hs~Ref:NM_001494.2~uORF:IOH4622	585	51	534
B48R19C11	48-11-19	Hs~MGC:BC031281.1~uORF:IOH21611	259	49	210
B48R19C12	48-12-19	Hs~MGC:BC031281.1~uORF:IOH21611	237	55	182
B48R19C13	48-13-19	Hs~MGC:BC053351.1~uORF:IOH28952	188	47	141
B48R19C14	48-14-19	Hs~MGC:BC053351.1~uORF:IOH28952	209	146	63
B48R19C15	48-15-19	Hs~MGC:BC013572.1~uORF:IOH9852	280	140	140
B48R19C16	48-16-19	Hs~MGC:BC013572.1~uORF:IOH9852	228	81	147
B48R19C17	48-17-19	Hs~Ref:NM_031407.1~uORF:IOH1984	286	49	237
B48R19C18	48-18-19	Hs~Ref:NM_031407.1~uORF:IOH1984	65	57	8
B48R19C19	48-19-19	Hs~Ref:NM_018049.1~uORF:IOH3886	83	54	29
B48R19C20	48-20-19	Hs~Ref:NM_018049.1~uORF:IOH3886	272	51	221
B48R19C21	48-21-19	Hs~MGC:BC070263.1~uORF:IOH62878	244	51	193
B48R19C22	48-22-19	Hs~MGC:BC070263.1~uORF:IOH62878	233	49	184
B48R20C01	48-1-20	Hs~Ref:NM_000201.1~uORF:IOH59116	41	44	-3
B48R20C02	48-2-20	Hs~Ref:NM_000201.1~uORF:IOH59116	39	44	-5
B48R20C03	48-3-20	Hs~Ref:NM_014465.2~uORF:IOH54963	92	42	50
B48R20C04	48-4-20	Hs~Ref:NM_014465.2~uORF:IOH54963	40	41	-1
B48R20C05	48-5-20	Hs~Ref:NM_001018160.1~uORF:IOH59099	138	44	94
B48R20C06	48-6-20	Hs~Ref:NM_001018160.1~uORF:IOH59099	43	49	-6
B48R20C07	48-7-20	Hs~Ref:NM_015423.2~uORF:IOH11246	322	50	272
B48R20C08	48-8-20	Hs~Ref:NM_015423.2~uORF:IOH11246	171	73	98
B48R20C09	48-9-20	Hs~Ref:NM_024048.2~uORF:IOH27955	93	45	48
B48R20C10	48-10-20	Hs~Ref:NM_024048.2~uORF:IOH27955	87	45	42
B48R20C11	48-11-20	Hs~MGC:BC036080.1~uORF:IOH27250	202	45	157
B48R20C12	48-12-20	Hs~MGC:BC036080.1~uORF:IOH27250	188	43	145
B48R20C13	48-13-20	Hs~MGC:BC026342.1~uORF:IOH22235	147	42	105
B48R20C14	48-14-20	Hs~MGC:BC026342.1~uORF:IOH22235	206	47	159
B48R20C15	48-15-20	Hs~Ref:NM_014507.2~uORF:IOH23196	238	45	193
B48R20C16	48-16-20	Hs~Ref:NM_014507.2~uORF:IOH23196	146	49	97
B48R20C17	48-17-20	Hs~Ref:NM_152304.1~uORF:IOH23234	249	47	202
B48R20C18	48-18-20	Hs~Ref:NM_152304.1~uORF:IOH23234	230	136	94
B48R20C19	48-19-20	Hs~Ref:NM_078480.1~uORF:IOH41165	1460	46	1414
B48R20C20	48-20-20	Hs~Ref:NM_078480.1~uORF:IOH41165	1435	44	1391
B48R20C21	48-21-20	Hs~Ref:NM_016169.2~uORF:IOH13097	532	47	485
B48R20C22	48-22-20	Hs~Ref:NM_016169.2~uORF:IOH13097	517	49	468
B48R21C01	48-1-21	Hs~Ref:NM_020762.1~uORF:IOH29044	1085	43	1042
B48R21C02	48-2-21	Hs~Ref:NM_020762.1~uORF:IOH29044	1064	46	1018
B48R21C03	48-3-21	Hs~MGC:BC001502.2~uORF:IOH13611	126	45	81
B48R21C04	48-4-21	Hs~MGC:BC001502.2~uORF:IOH13611	137	43	94
B48R21C05	48-5-21	Hs~Ref:NM_003752.3~uORF:IOH11958	768	47	721
B48R21C06	48-6-21	Hs~Ref:NM_003752.3~uORF:IOH11958	703	78	625
B48R21C07	48-7-21	Hs~Ref:NM_173160.2~uORF:IOH29427	45	60	-15
B48R21C08	48-8-21	Hs~Ref:NM_173160.2~uORF:IOH29427	178	45	133
B48R21C09	48-9-21	Hs~Ref:Q9HBE5-1~CAT_11483-H08H-25	43	44	-1
B48R21C10	48-10-21	Hs~Ref:Q9HBE5-1~CAT_11483-H08H-25	309	44	265
B48R21C11	48-11-21	Internal_1007209	50	44	6
B48R21C12	48-12-21	Internal_1007209	383	43	340
B48R21C13	48-13-21	Hs~Ref:NP_001203.1~CAT_11874-H08E-25	43	41	2
B48R21C14	48-14-21	Hs~Ref:NP_001203.1~CAT_11874-H08E-25	39	40	-1
B48R21C15	48-15-21	Internal_1007209	92	45	47
B48R21C16	48-16-21	Internal_1007209	56	42	14
B48R21C17	48-17-21	Hs~Ref:NP_061838.1~CAT_11084-H08H-25	42	40	2
B48R21C18	48-18-21	Hs~Ref:NP_061838.1~CAT_11084-H08H-25	40	41	-1
B48R21C19	48-19-21	Internal_1007209	47	42	5
B48R21C20	48-20-21	Internal_1007209	43	41	2
B48R21C21	48-21-21	Internal_1007209	47	41	6
B48R21C22	48-22-21	Internal_1007209	41	41	0
B48R22C01	48-1-22	ERa~N/A	2516	39	2477
B48R22C02	48-2-22	ERa~N/A	2568	40	2528
B48R22C03	48-3-22	PKCeta~N/A	59	44	15
B48R22C04	48-4-22	PKCeta~N/A	162	41	121
B48R22C05	48-5-22	Calmodulin~N/A	62	42	20
B48R22C06	48-6-22	Calmodulin~N/A	137	45	92
B48R22C07	48-7-22	V5control5~N/A	106	48	58
B48R22C08	48-8-22	V5control5~N/A	100	47	53
B48R22C09	48-9-22	V5control4~N/A	261	57	204
B48R22C10	48-10-22	V5control4~N/A	84	46	38
B48R22C11	48-11-22	V5control3~N/A	62	45	17
B48R22C12	48-12-22	V5control3~N/A	64	43	21
B48R22C13	48-13-22	V5control2~N/A	273	53	220
B48R22C14	48-14-22	V5control2~N/A	56	41	15
B48R22C15	48-15-22	V5control1~N/A	50	40	10
B48R22C16	48-16-22	V5control1~N/A	50	39	11
B48R22C17	48-17-22	CMK2A~N/A	293	40	253
B48R22C18	48-18-22	CMK2A~N/A	307	40	267
B48R22C19	48-19-22	ERa~N/A	1966	41	1925
B48R22C20	48-20-22	ERa~N/A	1865	42	1823
B48R22C21	48-21-22	AlexaAntiMouseAb~N/A	8307	42	8265
B48R22C22	48-22-22	AlexaAntiMouseAb~N/A	8602	41	8561
